縣市,鄉鎮市區,村里,valid_ticket,agree_ticket,disagree_ticket,invalid_ticket,vote_ticket,votable_population,population,vote_to_votable,agree_to_votable
臺北市,松山區,莊敬里,2011,1119,892,21,2032,4467,0,45.49,25.05
臺北市,松山區,東榮里,3395,1778,1617,19,3414,6468,0,52.78,27.49
臺北市,松山區,三民里,2933,1693,1240,16,2949,5723,0,51.53,29.58
臺北市,松山區,新益里,1996,1066,930,9,2005,3881,0,51.66,27.47
臺北市,松山區,富錦里,2168,1197,971,21,2189,4281,0,51.13,27.96
臺北市,松山區,新東里,2049,1134,915,18,2067,4135,0,49.99,27.42
臺北市,松山區,富泰里,1883,1167,716,17,1900,3884,0,48.92,30.05
臺北市,松山區,介壽里,1787,930,857,18,1805,3540,0,50.99,26.27
臺北市,松山區,精忠里,1784,997,787,10,1794,3553,0,50.49,28.06
臺北市,松山區,東光里,3042,1741,1301,19,3061,6051,0,50.59,28.77
臺北市,松山區,龍田里,4277,2847,1430,24,4301,8377,0,51.34,33.99
臺北市,松山區,東昌里,1170,599,571,11,1181,2184,0,54.08,27.43
臺北市,松山區,東勢里,1778,924,854,9,1787,3518,0,50.8,26.26
臺北市,松山區,中華里,2639,1493,1146,29,2668,5140,0,51.91,29.05
臺北市,松山區,民有里,3785,1903,1882,30,3815,7351,0,51.9,25.89
臺北市,松山區,民福里,2827,1684,1143,25,2852,5381,0,53.0,31.3
臺北市,松山區,慈祐里,2742,1312,1430,20,2762,7162,0,38.56,18.32
臺北市,松山區,安平里,3314,1714,1600,33,3347,7230,0,46.29,23.71
臺北市,松山區,鵬程里,2273,1423,850,22,2295,4616,0,49.72,30.83
臺北市,松山區,自強里,3970,2992,978,49,4019,7730,0,51.99,38.71
臺北市,松山區,吉祥里,3376,1838,1538,21,3397,6959,0,48.81,26.41
臺北市,松山區,新聚里,3083,1570,1513,33,3116,6657,0,46.81,23.58
臺北市,松山區,復盛里,2636,1522,1114,24,2660,5286,0,50.32,28.79
臺北市,松山區,中正里,3468,1765,1703,23,3491,7611,0,45.87,23.19
臺北市,松山區,中崙里,1567,830,737,23,1590,3317,0,47.93,25.02
臺北市,松山區,美仁里,1407,684,723,15,1422,2882,0,49.34,23.73
臺北市,松山區,吉仁里,1484,767,717,6,1490,3234,0,46.07,23.72
臺北市,松山區,敦化里,2881,1494,1387,31,2912,5590,0,52.09,26.73
臺北市,松山區,復源里,1332,769,563,10,1342,2642,0,50.79,29.11
臺北市,松山區,復建里,1809,1026,783,14,1823,3714,0,49.08,27.63
臺北市,松山區,復勢里,2508,1263,1245,22,2530,5206,0,48.6,24.26
臺北市,松山區,福成里,1056,548,508,9,1065,2147,0,49.6,25.52
臺北市,松山區,松基里,1466,744,722,11,1477,3047,0,48.47,24.42
臺北市,松山區,合計,79896,44533,35363,662,80558,162964,196890,49.43,27.33
臺北市,信義區,西村里,2109,1489,620,19,2128,4958,0,42.92,30.03
臺北市,信義區,正和里,1967,1226,741,14,1981,3767,0,52.59,32.55
臺北市,信義區,興隆里,1004,619,385,15,1019,2224,0,45.82,27.83
臺北市,信義區,中興里,1296,750,546,9,1305,2903,0,44.95,25.84
臺北市,信義區,新仁里,1340,817,523,8,1348,2732,0,49.34,29.9
臺北市,信義區,興雅里,2175,1213,962,27,2202,4753,0,46.33,25.52
臺北市,信義區,敦厚里,1987,1123,864,15,2002,4357,0,45.95,25.77
臺北市,信義區,廣居里,3059,1780,1279,22,3081,6335,0,48.63,28.1
臺北市,信義區,安康里,3911,2186,1725,33,3944,8511,0,46.34,25.68
臺北市,信義區,六藝里,1417,727,690,15,1432,3102,0,46.16,23.44
臺北市,信義區,雅祥里,2018,1025,993,22,2040,4266,0,47.82,24.03
臺北市,信義區,五常里,1481,805,676,7,1488,3106,0,47.91,25.92
臺北市,信義區,五全里,1945,917,1028,16,1961,4081,0,48.05,22.47
臺北市,信義區,永吉里,1416,589,827,6,1422,3370,0,42.2,17.48
臺北市,信義區,長春里,1556,802,754,18,1574,3629,0,43.37,22.1
臺北市,信義區,四育里,2322,1135,1187,27,2349,4754,0,49.41,23.87
臺北市,信義區,四維里,2119,1236,883,25,2144,4535,0,47.28,27.25
臺北市,信義區,永春里,1914,986,928,33,1947,4223,0,46.1,23.35
臺北市,信義區,富台里,1723,1104,619,22,1745,3723,0,46.87,29.65
臺北市,信義區,國業里,2834,1609,1225,12,2846,6147,0,46.3,26.18
臺北市,信義區,松隆里,873,483,390,6,879,1924,0,45.69,25.1
臺北市,信義區,松友里,2531,1420,1111,15,2546,5536,0,45.99,25.65
臺北市,信義區,松光里,1953,997,956,12,1965,4245,0,46.29,23.49
臺北市,信義區,中坡里,1872,992,880,17,1889,3791,0,49.83,26.17
臺北市,信義區,中行里,3058,1532,1526,27,3085,6724,0,45.88,22.78
臺北市,信義區,大道里,2464,1240,1224,24,2488,5177,0,48.06,23.95
臺北市,信義區,大仁里,1513,803,710,15,1528,3445,0,44.35,23.31
臺北市,信義區,景新里,2045,1235,810,17,2062,4324,0,47.69,28.56
臺北市,信義區,惠安里,2548,1524,1024,19,2567,5572,0,46.07,27.35
臺北市,信義區,三張里,3541,2101,1440,34,3575,7503,0,47.65,28.0
臺北市,信義區,三犁里,2010,1201,809,21,2031,4453,0,45.61,26.97
臺北市,信義區,六合里,2667,1682,985,23,2690,5784,0,46.51,29.08
臺北市,信義區,泰和里,2740,1577,1163,17,2757,6519,0,42.29,24.19
臺北市,信義區,景聯里,1916,1108,808,14,1930,3961,0,48.73,27.97
臺北市,信義區,景勤里,1479,876,603,9,1488,3292,0,45.2,26.61
臺北市,信義區,雙和里,2939,1753,1186,15,2954,6033,0,48.96,29.06
臺北市,信義區,嘉興里,1322,728,594,15,1337,2713,0,49.28,26.83
臺北市,信義區,黎順里,1557,919,638,11,1568,3427,0,45.75,26.82
臺北市,信義區,黎平里,2915,1707,1208,32,2947,5973,0,49.34,28.58
臺北市,信義區,黎忠里,1992,1175,817,14,2006,4141,0,48.44,28.37
臺北市,信義區,黎安里,731,487,244,18,749,1734,0,43.19,28.09
臺北市,信義區,合計,84259,47678,36581,740,84999,181747,210936,46.77,26.23
臺北市,大安區,德安里,2295,1438,857,13,2308,4632,0,49.83,31.04
臺北市,大安區,仁慈里,2174,1162,1012,11,2185,4304,0,50.77,27.0
臺北市,大安區,和安里,2632,1558,1074,14,2646,5471,0,48.36,28.48
臺北市,大安區,民炤里,3233,1758,1475,19,3252,6608,0,49.21,26.6
臺北市,大安區,仁愛里,1914,1032,882,13,1927,4212,0,45.75,24.5
臺北市,大安區,義村里,2463,1655,808,15,2478,4707,0,52.64,35.16
臺北市,大安區,民輝里,2717,1488,1229,18,2735,5704,0,47.95,26.09
臺北市,大安區,昌隆里,1357,696,661,12,1369,2713,0,50.46,25.65
臺北市,大安區,誠安里,1668,876,792,17,1685,3427,0,49.17,25.56
臺北市,大安區,光武里,2847,1589,1258,25,2872,6211,0,46.24,25.58
臺北市,大安區,龍坡里,2355,1378,977,22,2377,4608,0,51.58,29.9
臺北市,大安區,龍泉里,1910,1036,874,17,1927,4046,0,47.63,25.61
臺北市,大安區,古風里,1792,1001,791,16,1808,3495,0,51.73,28.64
臺北市,大安區,古莊里,2899,1634,1265,13,2912,6074,0,47.94,26.9
臺北市,大安區,龍安里,2437,1331,1106,22,2459,6710,0,36.65,19.84
臺北市,大安區,錦安里,2355,1367,988,17,2372,4806,0,49.35,28.44
臺北市,大安區,福住里,2372,1284,1088,23,2395,5061,0,47.32,25.37
臺北市,大安區,永康里,1433,833,600,8,1441,2977,0,48.4,27.98
臺北市,大安區,光明里,1472,831,641,14,1486,2987,0,49.75,27.82
臺北市,大安區,錦泰里,1495,921,574,17,1512,3004,0,50.33,30.66
臺北市,大安區,錦華里,2361,1403,958,18,2379,4627,0,51.42,30.32
臺北市,大安區,龍圖里,2698,1583,1115,26,2724,5613,0,48.53,28.2
臺北市,大安區,新龍里,2891,1982,909,26,2917,5527,0,52.78,35.86
臺北市,大安區,龍陣里,1473,841,632,12,1485,2947,0,50.39,28.54
臺北市,大安區,龍雲里,1991,1099,892,24,2015,3937,0,51.18,27.91
臺北市,大安區,龍生里,2760,1630,1130,22,2782,5409,0,51.43,30.13
臺北市,大安區,住安里,1878,1108,770,14,1892,4245,0,44.57,26.1
臺北市,大安區,義安里,2074,1235,839,11,2085,4455,0,46.8,27.72
臺北市,大安區,通化里,2481,1256,1225,23,2504,5249,0,47.7,23.93
臺北市,大安區,通安里,2185,1224,961,25,2210,4590,0,48.15,26.67
臺北市,大安區,臨江里,1629,917,712,21,1650,3527,0,46.78,26.0
臺北市,大安區,法治里,1870,1163,707,16,1886,3732,0,50.54,31.16
臺北市,大安區,全安里,1786,1066,720,18,1804,3699,0,48.77,28.82
臺北市,大安區,群賢里,2400,1480,920,24,2424,4899,0,49.48,30.21
臺北市,大安區,群英里,3140,2270,870,21,3161,5848,0,54.05,38.82
臺北市,大安區,虎嘯里,1554,885,669,8,1562,3137,0,49.79,28.21
臺北市,大安區,臥龍里,875,535,340,8,883,1729,0,51.07,30.94
臺北市,大安區,龍淵里,3683,2094,1589,28,3711,7435,0,49.91,28.16
臺北市,大安區,龍門里,1845,1002,843,15,1860,3529,0,52.71,28.39
臺北市,大安區,大學里,3641,2104,1537,35,3676,6961,0,52.81,30.23
臺北市,大安區,芳和里,2334,1375,959,25,2359,4904,0,48.1,28.04
臺北市,大安區,黎元里,2090,1179,911,29,2119,4683,0,45.25,25.18
臺北市,大安區,黎孝里,3199,1822,1377,35,3234,6467,0,50.01,28.17
臺北市,大安區,黎和里,1874,1166,708,21,1895,3938,0,48.12,29.61
臺北市,大安區,建安里,1822,1044,778,10,1832,4048,0,45.26,25.79
臺北市,大安區,建倫里,2265,1247,1018,24,2289,5023,0,45.57,24.83
臺北市,大安區,敦安里,2361,1310,1051,14,2375,5100,0,46.57,25.69
臺北市,大安區,正聲里,1766,1039,727,15,1781,3818,0,46.65,27.21
臺北市,大安區,敦煌里,2343,1290,1053,19,2362,4922,0,47.99,26.21
臺北市,大安區,華聲里,1577,920,657,10,1587,3473,0,45.7,26.49
臺北市,大安區,車層里,2446,1326,1120,12,2458,5221,0,47.08,25.4
臺北市,大安區,光信里,3058,1742,1316,38,3096,6249,0,49.54,27.88
臺北市,大安區,學府里,963,581,382,16,979,2171,0,45.09,26.76
臺北市,大安區,合計,117133,67786,49347,989,118122,242869,296546,48.64,27.91
臺北市,中山區,正守里,1268,623,645,14,1282,2806,0,45.69,22.2
臺北市,中山區,正義里,1849,944,905,13,1862,4541,0,41.0,20.79
臺北市,中山區,正得里,1376,699,677,11,1387,3136,0,44.23,22.29
臺北市,中山區,民安里,1827,876,951,10,1837,3798,0,48.37,23.06
臺北市,中山區,康樂里,1007,538,469,7,1014,2307,0,43.95,23.32
臺北市,中山區,中山里,2497,1236,1261,21,2518,5902,0,42.66,20.94
臺北市,中山區,聚盛里,1459,783,676,14,1473,3728,0,39.51,21.0
臺北市,中山區,集英里,2721,1223,1498,15,2736,5936,0,46.09,20.6
臺北市,中山區,聚葉里,1488,703,785,10,1498,3471,0,43.16,20.25
臺北市,中山區,恆安里,1778,884,894,16,1794,4310,0,41.62,20.51
臺北市,中山區,晴光里,1940,1032,908,19,1959,4704,0,41.65,21.94
臺北市,中山區,圓山里,1556,736,820,8,1564,3587,0,43.6,20.52
臺北市,中山區,劍潭里,1550,1190,360,23,1573,3095,0,50.82,38.45
臺北市,中山區,大直里,3700,2130,1570,31,3731,7456,0,50.04,28.57
臺北市,中山區,成功里,2483,1303,1180,22,2505,5305,0,47.22,24.56
臺北市,中山區,永安里,3822,2060,1762,29,3851,7732,0,49.81,26.64
臺北市,中山區,大佳里,413,146,267,3,416,904,0,46.02,16.15
臺北市,中山區,新喜里,1948,868,1080,14,1962,4399,0,44.6,19.73
臺北市,中山區,新庄里,1997,928,1069,20,2017,4267,0,47.27,21.75
臺北市,中山區,新福里,2107,888,1219,18,2125,4414,0,48.14,20.12
臺北市,中山區,松江里,2557,1178,1379,29,2586,5384,0,48.03,21.88
臺北市,中山區,新生里,1849,853,996,20,1869,4061,0,46.02,21.0
臺北市,中山區,中庄里,1953,860,1093,19,1972,4318,0,45.67,19.92
臺北市,中山區,行政里,2331,1171,1160,23,2354,6616,0,35.58,17.7
臺北市,中山區,行仁里,3075,1400,1675,21,3096,6794,0,45.57,20.61
臺北市,中山區,行孝里,1585,697,888,16,1601,3692,0,43.36,18.88
臺北市,中山區,下埤里,3076,1430,1646,26,3102,6421,0,48.31,22.27
臺北市,中山區,江寧里,2846,1444,1402,25,2871,5828,0,49.26,24.78
臺北市,中山區,江山里,3107,1438,1669,21,3128,6371,0,49.1,22.57
臺北市,中山區,中吉里,2267,963,1304,16,2283,4719,0,48.38,20.41
臺北市,中山區,中原里,2193,992,1201,10,2203,4380,0,50.3,22.65
臺北市,中山區,興亞里,2159,1037,1122,12,2171,4589,0,47.31,22.6
臺北市,中山區,中央里,1466,726,740,6,1472,3031,0,48.56,23.95
臺北市,中山區,朱馥里,2070,1085,985,19,2089,4892,0,42.7,22.18
臺北市,中山區,龍洲里,2238,1539,699,19,2257,4278,0,52.76,35.97
臺北市,中山區,朱園里,1863,881,982,12,1875,3885,0,48.26,22.68
臺北市,中山區,埤頭里,1310,695,615,11,1321,2772,0,47.66,25.07
臺北市,中山區,朱崙里,1208,576,632,12,1220,2553,0,47.79,22.56
臺北市,中山區,力行里,2489,1196,1293,21,2510,5215,0,48.13,22.93
臺北市,中山區,復華里,1932,1131,801,26,1958,4000,0,48.95,28.28
臺北市,中山區,金泰里,2882,1588,1294,35,2917,6417,0,45.46,24.75
臺北市,中山區,北安里,1080,655,425,9,1089,2179,0,49.98,30.06
臺北市,中山區,合計,86322,43325,42997,726,87048,188193,219840,46.25,23.02
臺北市,中正區,水源里,1194,613,581,12,1206,2569,0,46.94,23.86
臺北市,中正區,富水里,895,609,286,5,900,2107,0,42.71,28.9
臺北市,中正區,文盛里,1111,600,511,9,1120,2181,0,51.35,27.51
臺北市,中正區,林興里,1890,1146,744,16,1906,4011,0,47.52,28.57
臺北市,中正區,河堤里,1943,1158,785,14,1957,3802,0,51.47,30.46
臺北市,中正區,頂東里,2684,1465,1219,24,2708,5155,0,52.53,28.42
臺北市,中正區,網溪里,2491,1368,1123,16,2507,4893,0,51.24,27.96
臺北市,中正區,板溪里,1305,751,554,8,1313,2775,0,47.32,27.06
臺北市,中正區,螢圃里,2365,1343,1022,21,2386,4773,0,49.99,28.14
臺北市,中正區,螢雪里,1764,1005,759,14,1778,3653,0,48.67,27.51
臺北市,中正區,永功里,2464,1299,1165,30,2494,5214,0,47.83,24.91
臺北市,中正區,永昌里,1985,1117,868,13,1998,4177,0,47.83,26.74
臺北市,中正區,龍興里,1334,714,620,8,1342,2906,0,46.18,24.57
臺北市,中正區,忠勤里,2331,1357,974,29,2360,5486,0,43.02,24.74
臺北市,中正區,廈安里,1590,827,763,11,1601,3475,0,46.07,23.8
臺北市,中正區,愛國里,1232,658,574,8,1240,2583,0,48.01,25.47
臺北市,中正區,南門里,1120,684,436,11,1131,2153,0,52.53,31.77
臺北市,中正區,龍光里,1352,807,545,10,1362,2662,0,51.16,30.32
臺北市,中正區,南福里,4413,2499,1914,28,4441,8918,0,49.8,28.02
臺北市,中正區,龍福里,2024,1101,923,22,2046,4216,0,48.53,26.11
臺北市,中正區,新營里,3279,2037,1242,23,3302,6851,0,48.2,29.73
臺北市,中正區,建國里,564,333,231,3,567,1240,0,45.73,26.85
臺北市,中正區,光復里,1408,751,657,6,1414,3153,0,44.85,23.82
臺北市,中正區,黎明里,1072,590,482,9,1081,2719,0,39.76,21.7
臺北市,中正區,梅花里,1287,658,629,11,1298,2626,0,49.43,25.06
臺北市,中正區,幸福里,1909,1065,844,16,1925,4871,0,39.52,21.86
臺北市,中正區,幸市里,1930,1009,921,11,1941,3689,0,52.62,27.35
臺北市,中正區,東門里,1504,909,595,16,1520,3113,0,48.83,29.2
臺北市,中正區,文北里,2300,1263,1037,16,2316,4517,0,51.27,27.96
臺北市,中正區,文祥里,3074,1688,1386,27,3101,6282,0,49.36,26.87
臺北市,中正區,三愛里,3389,1843,1546,31,3420,6997,0,48.88,26.34
臺北市,中正區,合計,59203,33267,25936,478,59681,123767,153172,48.22,26.88
臺北市,大同區,玉泉里,1142,499,643,7,1149,2534,0,45.34,19.69
臺北市,大同區,建明里,1217,517,700,13,1230,2790,0,44.09,18.53
臺北市,大同區,建功里,1742,754,988,14,1756,3999,0,43.91,18.85
臺北市,大同區,建泰里,1422,578,844,27,1449,3039,0,47.68,19.02
臺北市,大同區,永樂里,2041,823,1218,12,2053,4399,0,46.67,18.71
臺北市,大同區,朝陽里,1801,810,991,12,1813,3812,0,47.56,21.25
臺北市,大同區,星明里,2182,983,1199,15,2197,4940,0,44.47,19.9
臺北市,大同區,光能里,1952,846,1106,10,1962,4161,0,47.15,20.33
臺北市,大同區,大有里,1814,694,1120,17,1831,3943,0,46.44,17.6
臺北市,大同區,延平里,1593,703,890,10,1603,3592,0,44.63,19.57
臺北市,大同區,雙連里,3423,1494,1929,31,3454,7671,0,45.03,19.48
臺北市,大同區,南芳里,1542,645,897,9,1551,3376,0,45.94,19.11
臺北市,大同區,民權里,2478,1122,1356,25,2503,5223,0,47.92,21.48
臺北市,大同區,景星里,983,387,596,8,991,2231,0,44.42,17.35
臺北市,大同區,隆和里,1414,572,842,9,1423,2898,0,49.1,19.74
臺北市,大同區,蓬萊里,1948,870,1078,20,1968,4213,0,46.71,20.65
臺北市,大同區,國順里,997,374,623,9,1006,2305,0,43.64,16.23
臺北市,大同區,國慶里,1904,830,1074,13,1917,3894,0,49.23,21.31
臺北市,大同區,揚雅里,1425,551,874,9,1434,4063,0,35.29,13.56
臺北市,大同區,斯文里,1808,732,1076,15,1823,4057,0,44.93,18.04
臺北市,大同區,鄰江里,2601,1042,1559,16,2617,5537,0,47.26,18.82
臺北市,大同區,至聖里,3184,1361,1823,23,3207,6748,0,47.53,20.17
臺北市,大同區,老師里,2157,866,1291,16,2173,4953,0,43.87,17.48
臺北市,大同區,重慶里,2688,1283,1405,11,2699,5666,0,47.64,22.64
臺北市,大同區,保安里,1860,755,1105,15,1875,3771,0,49.72,20.02
臺北市,大同區,合計,47318,20091,27227,366,47684,103815,122719,45.93,19.35
臺北市,萬華區,福星里,1956,1087,869,21,1977,4638,0,42.63,23.44
臺北市,萬華區,萬壽里,1119,592,527,15,1134,2831,0,40.06,20.91
臺北市,萬華區,西門里,1343,731,612,10,1353,3187,0,42.45,22.94
臺北市,萬華區,新起里,2699,1354,1345,37,2736,5920,0,46.22,22.87
臺北市,萬華區,菜園里,2512,1149,1363,18,2530,5356,0,47.24,21.45
臺北市,萬華區,青山里,2258,1056,1202,14,2272,5124,0,44.34,20.61
臺北市,萬華區,富民里,1965,834,1131,25,1990,4299,0,46.29,19.4
臺北市,萬華區,福音里,1566,704,862,10,1576,3366,0,46.82,20.92
臺北市,萬華區,仁德里,2025,1006,1019,14,2039,4094,0,49.8,24.57
臺北市,萬華區,富福里,1916,852,1064,20,1936,5354,0,36.16,15.91
臺北市,萬華區,頂碩里,2820,1249,1571,24,2844,6064,0,46.9,20.6
臺北市,萬華區,雙園里,1771,825,946,21,1792,3864,0,46.38,21.35
臺北市,萬華區,新忠里,1527,1178,349,14,1541,2993,0,51.49,39.36
臺北市,萬華區,新和里,3759,2774,985,50,3809,7108,0,53.59,39.03
臺北市,萬華區,糖廍里,2195,1000,1195,26,2221,4679,0,47.47,21.37
臺北市,萬華區,和平里,2481,969,1512,28,2509,5752,0,43.62,16.85
臺北市,萬華區,綠堤里,1514,773,741,15,1529,3698,0,41.35,20.9
臺北市,萬華區,華江里,3195,1493,1702,23,3218,7226,0,44.53,20.66
臺北市,萬華區,柳鄉里,1898,799,1099,19,1917,4403,0,43.54,18.15
臺北市,萬華區,日善里,1450,650,800,13,1463,3103,0,47.15,20.95
臺北市,萬華區,新安里,2221,1355,866,22,2243,5228,0,42.9,25.92
臺北市,萬華區,忠德里,1753,771,982,10,1763,3813,0,46.24,20.22
臺北市,萬華區,孝德里,1308,520,788,16,1324,2802,0,47.25,18.56
臺北市,萬華區,和德里,2294,1010,1284,24,2318,5570,0,41.62,18.13
臺北市,萬華區,錦德里,2098,967,1131,20,2118,4714,0,44.93,20.51
臺北市,萬華區,全德里,1690,824,866,17,1707,3631,0,47.01,22.69
臺北市,萬華區,保德里,1336,633,703,10,1346,2752,0,48.91,23.0
臺北市,萬華區,銘德里,1771,792,979,15,1786,3985,0,44.82,19.87
臺北市,萬華區,榮德里,1482,661,821,21,1503,3075,0,48.88,21.5
臺北市,萬華區,壽德里,1944,946,998,19,1963,4233,0,46.37,22.35
臺北市,萬華區,興德里,1739,756,983,20,1759,3911,0,44.98,19.33
臺北市,萬華區,華中里,2449,1095,1354,23,2472,5226,0,47.3,20.95
臺北市,萬華區,日祥里,2557,1632,925,27,2584,5167,0,50.01,31.59
臺北市,萬華區,忠貞里,1958,1322,636,22,1980,4179,0,47.38,31.63
臺北市,萬華區,凌霄里,1459,935,524,25,1484,3097,0,47.92,30.19
臺北市,萬華區,騰雲里,1340,848,492,13,1353,2636,0,51.33,32.17
臺北市,萬華區,合計,71368,36142,35226,721,72089,157078,179485,45.89,23.01
臺北市,文山區,景行里,2895,1584,1311,19,2914,6344,0,45.93,24.97
臺北市,文山區,景東里,2827,1820,1007,13,2840,5987,0,47.44,30.4
臺北市,文山區,景美里,2060,1173,887,9,2069,4219,0,49.04,27.8
臺北市,文山區,景慶里,2632,1521,1111,25,2657,5431,0,48.92,28.01
臺北市,文山區,景仁里,2344,1430,914,23,2367,4675,0,50.63,30.59
臺北市,文山區,景華里,2367,1474,893,18,2385,4768,0,50.02,30.91
臺北市,文山區,萬有里,2322,1402,920,17,2339,4621,0,50.62,30.34
臺北市,文山區,萬祥里,1864,1060,804,20,1884,3814,0,49.4,27.79
臺北市,文山區,萬隆里,3016,1880,1136,23,3039,6067,0,50.09,30.99
臺北市,文山區,萬年里,2244,1321,923,30,2274,4515,0,50.37,29.26
臺北市,文山區,萬和里,1438,1022,416,20,1458,2826,0,51.59,36.16
臺北市,文山區,萬盛里,1941,1175,766,16,1957,3978,0,49.2,29.54
臺北市,文山區,興豐里,2120,1319,801,33,2153,4213,0,51.1,31.31
臺北市,文山區,興光里,1458,908,550,16,1474,3144,0,46.88,28.88
臺北市,文山區,興家里,3106,2022,1084,25,3131,6323,0,49.52,31.98
臺北市,文山區,興得里,2405,1523,882,25,2430,5161,0,47.08,29.51
臺北市,文山區,興業里,2265,1518,747,19,2284,4630,0,49.33,32.79
臺北市,文山區,興安里,2896,1880,1016,22,2918,5698,0,51.21,32.99
臺北市,文山區,興福里,2297,1322,975,15,2312,4637,0,49.86,28.51
臺北市,文山區,興旺里,3245,2156,1089,31,3276,7009,0,46.74,30.76
臺北市,文山區,興泰里,1732,1069,663,19,1751,3527,0,49.65,30.31
臺北市,文山區,興昌里,2719,1714,1005,18,2737,5643,0,48.5,30.37
臺北市,文山區,試院里,2911,1935,976,28,2939,5797,0,50.7,33.38
臺北市,文山區,華興里,3793,2422,1371,41,3834,7631,0,50.24,31.74
臺北市,文山區,明義里,1532,946,586,20,1552,3738,0,41.52,25.31
臺北市,文山區,明興里,2797,1765,1032,18,2815,5826,0,48.32,30.3
臺北市,文山區,木柵里,3839,2563,1276,39,3878,7776,0,49.87,32.96
臺北市,文山區,木新里,3456,1974,1482,32,3488,8867,0,39.34,22.26
臺北市,文山區,順興里,2982,1769,1213,23,3005,6234,0,48.2,28.38
臺北市,文山區,樟林里,3279,2105,1174,32,3311,7099,0,46.64,29.65
臺北市,文山區,樟新里,2295,1478,817,17,2312,4662,0,49.59,31.7
臺北市,文山區,樟腳里,2248,1348,900,18,2266,4648,0,48.75,29.0
臺北市,文山區,萬芳里,3206,2045,1161,21,3227,6704,0,48.14,30.5
臺北市,文山區,博嘉里,2360,1414,946,16,2376,5050,0,47.05,28.0
臺北市,文山區,萬興里,3503,2089,1414,32,3535,7045,0,50.18,29.65
臺北市,文山區,指南里,1529,852,677,16,1545,3435,0,44.98,24.8
臺北市,文山區,老泉里,346,146,200,3,349,778,0,44.86,18.77
臺北市,文山區,忠順里,1895,1276,619,19,1914,3647,0,52.48,34.99
臺北市,文山區,萬美里,2819,1757,1062,23,2842,6271,0,45.32,28.02
臺北市,文山區,政大里,3014,1849,1165,28,3042,6269,0,48.52,29.49
臺北市,文山區,樟文里,2451,1449,1002,29,2480,5223,0,47.48,27.74
臺北市,文山區,興邦里,2147,1508,639,15,2162,4301,0,50.27,35.06
臺北市,文山區,樟樹里,1911,1105,806,10,1921,3996,0,48.07,27.65
臺北市,文山區,合計,106506,66088,40418,936,107442,222227,264975,48.35,29.74
臺北市,南港區,南港里,2175,1165,1010,8,2183,5637,0,38.73,20.67
臺北市,南港區,中南里,1238,597,641,8,1246,3127,0,39.85,19.09
臺北市,南港區,新富里,1477,742,735,11,1488,3300,0,45.09,22.48
臺北市,南港區,三重里,2702,1489,1213,17,2719,6452,0,42.14,23.08
臺北市,南港區,東新里,2593,1353,1240,16,2609,6152,0,42.41,21.99
臺北市,南港區,新光里,1457,824,633,6,1463,3170,0,46.15,25.99
臺北市,南港區,東明里,2305,1340,965,27,2332,4785,0,48.74,28.0
臺北市,南港區,西新里,1782,789,993,20,1802,4037,0,44.64,19.54
臺北市,南港區,玉成里,1854,917,937,18,1872,4075,0,45.94,22.5
臺北市,南港區,合成里,2697,1423,1274,25,2722,5716,0,47.62,24.9
臺北市,南港區,成福里,3046,1847,1199,20,3066,6413,0,47.81,28.8
臺北市,南港區,萬福里,1894,1095,799,10,1904,3623,0,52.55,30.22
臺北市,南港區,鴻福里,1860,998,862,11,1871,3885,0,48.16,25.69
臺北市,南港區,百福里,1998,1019,979,18,2016,4544,0,44.37,22.43
臺北市,南港區,聯成里,2007,1112,895,17,2024,4274,0,47.36,26.02
臺北市,南港區,舊莊里,3011,1547,1464,29,3040,7580,0,40.11,20.41
臺北市,南港區,中研里,3574,1888,1686,39,3613,7890,0,45.79,23.93
臺北市,南港區,九如里,2390,1447,943,21,2411,5386,0,44.76,26.87
臺北市,南港區,仁福里,2361,1497,864,18,2379,4777,0,49.8,31.34
臺北市,南港區,重陽里,2106,1238,868,13,2119,4541,0,46.66,27.26
臺北市,南港區,合計,44527,24327,20200,352,44879,99364,117188,45.17,24.48
臺北市,內湖區,西湖里,2890,1474,1416,25,2915,6163,0,47.3,23.92
臺北市,內湖區,西康里,3972,2242,1730,39,4011,8190,0,48.97,27.37
臺北市,內湖區,西安里,2752,1514,1238,28,2780,5644,0,49.26,26.82
臺北市,內湖區,港墘里,2467,1325,1142,14,2481,5115,0,48.5,25.9
臺北市,內湖區,港都里,2130,1106,1024,12,2142,4642,0,46.14,23.83
臺北市,內湖區,港富里,3754,2041,1713,37,3791,7960,0,47.63,25.64
臺北市,內湖區,港華里,3550,1901,1649,32,3582,7644,0,46.86,24.87
臺北市,內湖區,內湖里,2605,1477,1128,18,2623,5561,0,47.17,26.56
臺北市,內湖區,湖濱里,3668,2220,1448,23,3691,7099,0,51.99,31.27
臺北市,內湖區,紫星里,3329,1729,1600,31,3360,6865,0,48.94,25.19
臺北市,內湖區,大湖里,2214,1238,976,17,2231,4641,0,48.07,26.68
臺北市,內湖區,金龍里,2130,1175,955,14,2144,4647,0,46.14,25.29
臺北市,內湖區,金瑞里,2845,1516,1329,26,2871,5790,0,49.59,26.18
臺北市,內湖區,碧山里,2905,1625,1280,24,2929,6061,0,48.33,26.81
臺北市,內湖區,紫雲里,2359,1464,895,22,2381,4880,0,48.79,30.0
臺北市,內湖區,清白里,3534,2015,1519,26,3560,7269,0,48.98,27.72
臺北市,內湖區,葫洲里,2682,1615,1067,27,2709,5983,0,45.28,26.99
臺北市,內湖區,紫陽里,3378,1836,1542,35,3413,7104,0,48.04,25.84
臺北市,內湖區,瑞陽里,3414,2201,1213,36,3450,6596,0,52.3,33.37
臺北市,內湖區,瑞光里,1945,1227,718,18,1963,3925,0,50.01,31.26
臺北市,內湖區,五分里,3427,1813,1614,29,3456,8758,0,39.46,20.7
臺北市,內湖區,東湖里,2957,1591,1366,19,2976,6861,0,43.38,23.19
臺北市,內湖區,樂康里,2898,1549,1349,25,2923,6927,0,42.2,22.36
臺北市,內湖區,內溝里,1796,985,811,14,1810,4037,0,44.84,24.4
臺北市,內湖區,週美里,3312,1659,1653,28,3340,7466,0,44.74,22.22
臺北市,內湖區,行善里,2942,1527,1415,27,2969,6099,0,48.68,25.04
臺北市,內湖區,石潭里,1448,796,652,7,1455,3369,0,43.19,23.63
臺北市,內湖區,湖興里,2737,1508,1229,17,2754,7424,0,37.1,20.31
臺北市,內湖區,湖元里,2109,1084,1025,17,2126,4537,0,46.86,23.89
臺北市,內湖區,安湖里,2867,1527,1340,26,2893,6387,0,45.3,23.91
臺北市,內湖區,秀湖里,2584,1530,1054,31,2615,5366,0,48.73,28.51
臺北市,內湖區,安泰里,1956,1083,873,11,1967,4591,0,42.84,23.59
臺北市,內湖區,金湖里,3787,2193,1594,40,3827,8128,0,47.08,26.98
臺北市,內湖區,康寧里,3345,1934,1411,22,3367,7322,0,45.98,26.41
臺北市,內湖區,明湖里,1988,1050,938,15,2003,4501,0,44.5,23.33
臺北市,內湖區,蘆洲里,391,168,223,5,396,1126,0,35.17,14.92
臺北市,內湖區,麗山里,2291,1106,1185,16,2307,4994,0,46.2,22.15
臺北市,內湖區,寶湖里,3693,2180,1513,33,3726,7959,0,46.81,27.39
臺北市,內湖區,南湖里,2144,1270,874,24,2168,4674,0,46.38,27.17
臺北市,內湖區,合計,107195,59494,47701,910,108105,232305,279598,46.54,25.61
臺北市,士林區,仁勇里,1545,647,898,16,1561,3285,0,47.52,19.7
臺北市,士林區,義信里,1231,646,585,16,1247,2736,0,45.58,23.61
臺北市,士林區,福林里,1133,568,565,17,1150,2482,0,46.33,22.88
臺北市,士林區,福德里,1835,974,861,13,1848,5079,0,36.39,19.18
臺北市,士林區,福志里,3375,1791,1584,24,3399,6507,0,52.24,27.52
臺北市,士林區,舊佳里,2593,1246,1347,24,2617,5295,0,49.42,23.53
臺北市,士林區,福佳里,3185,1530,1655,26,3211,6549,0,49.03,23.36
臺北市,士林區,後港里,2954,1257,1697,20,2974,6846,0,43.44,18.36
臺北市,士林區,福中里,2641,1144,1497,16,2657,5673,0,46.84,20.17
臺北市,士林區,前港里,1735,729,1006,15,1750,3851,0,45.44,18.93
臺北市,士林區,百齡里,2782,1195,1587,24,2806,5841,0,48.04,20.46
臺北市,士林區,承德里,2187,1118,1069,15,2202,4783,0,46.04,23.37
臺北市,士林區,福華里,2256,1020,1236,22,2278,5342,0,42.64,19.09
臺北市,士林區,明勝里,1987,948,1039,17,2004,4156,0,48.22,22.81
臺北市,士林區,福順里,2168,863,1305,26,2194,4679,0,46.89,18.44
臺北市,士林區,富光里,2240,895,1345,22,2262,5082,0,44.51,17.61
臺北市,士林區,葫蘆里,2899,1336,1563,32,2931,6264,0,46.79,21.33
臺北市,士林區,葫東里,1606,681,925,8,1614,3514,0,45.93,19.38
臺北市,士林區,社子里,2429,951,1478,15,2444,5517,0,44.3,17.24
臺北市,士林區,社新里,3260,1269,1991,30,3290,7737,0,42.52,16.4
臺北市,士林區,社園里,2767,1011,1756,25,2792,6210,0,44.96,16.28
臺北市,士林區,永倫里,2676,1023,1653,33,2709,6117,0,44.29,16.72
臺北市,士林區,福安里,1901,481,1420,15,1916,4416,0,43.39,10.89
臺北市,士林區,富洲里,2265,651,1614,26,2291,5424,0,42.24,12.0
臺北市,士林區,岩山里,1338,736,602,7,1345,2895,0,46.46,25.42
臺北市,士林區,名山里,3098,1616,1482,24,3122,6048,0,51.62,26.72
臺北市,士林區,德行里,1864,908,956,13,1877,3773,0,49.75,24.07
臺北市,士林區,德華里,2292,1071,1221,12,2304,4821,0,47.79,22.22
臺北市,士林區,聖山里,2136,1196,940,17,2153,4319,0,49.85,27.69
臺北市,士林區,忠誠里,2250,1400,850,23,2273,4739,0,47.96,29.54
臺北市,士林區,芝山里,3157,1578,1579,31,3188,6439,0,49.51,24.51
臺北市,士林區,東山里,2094,1192,902,26,2120,4371,0,48.5,27.27
臺北市,士林區,三玉里,2347,1189,1158,17,2364,4881,0,48.43,24.36
臺北市,士林區,蘭雅里,3431,1702,1729,35,3466,7425,0,46.68,22.92
臺北市,士林區,蘭興里,2681,1306,1375,18,2699,5452,0,49.5,23.95
臺北市,士林區,天福里,2419,1247,1172,29,2448,5286,0,46.31,23.59
臺北市,士林區,天祿里,2118,990,1128,9,2127,4413,0,48.2,22.43
臺北市,士林區,天壽里,2071,1040,1031,14,2085,4299,0,48.5,24.19
臺北市,士林區,天和里,3002,1550,1452,33,3035,6370,0,47.65,24.33
臺北市,士林區,天山里,2795,1477,1318,34,2829,5880,0,48.11,25.12
臺北市,士林區,天玉里,3533,1792,1741,30,3563,7345,0,48.51,24.4
臺北市,士林區,天母里,2687,1418,1269,25,2712,5559,0,48.79,25.51
臺北市,士林區,永福里,520,202,318,5,525,1083,0,48.48,18.65
臺北市,士林區,公館里,497,168,329,7,504,1228,0,41.04,13.68
臺北市,士林區,新安里,794,318,476,8,802,1668,0,48.08,19.06
臺北市,士林區,陽明里,1105,519,586,21,1126,2666,0,42.24,19.47
臺北市,士林區,菁山里,559,244,315,3,562,1421,0,39.55,17.17
臺北市,士林區,平等里,548,154,394,7,555,1306,0,42.5,11.79
臺北市,士林區,溪山里,567,239,328,5,572,1328,0,43.07,18.0
臺北市,士林區,翠山里,1198,796,402,11,1209,2345,0,51.56,33.94
臺北市,士林區,臨溪里,1162,606,556,7,1169,2508,0,46.61,24.16
臺北市,士林區,合計,107913,50628,57285,968,108881,233253,274056,46.68,21.71
臺北市,北投區,建民里,1843,838,1005,16,1859,3704,0,50.19,22.62
臺北市,北投區,文林里,1701,755,946,14,1715,3685,0,46.54,20.49
臺北市,北投區,石牌里,2138,976,1162,17,2155,4492,0,47.97,21.73
臺北市,北投區,福興里,2882,1413,1469,36,2918,5935,0,49.17,23.81
臺北市,北投區,榮光里,2601,1324,1277,25,2626,6019,0,43.63,22.0
臺北市,北投區,榮華里,3128,1573,1555,17,3145,6221,0,50.55,25.29
臺北市,北投區,裕民里,3047,1538,1509,26,3073,6632,0,46.34,23.19
臺北市,北投區,振華里,2986,1557,1429,18,3004,6389,0,47.02,24.37
臺北市,北投區,永和里,3715,1816,1899,25,3740,7885,0,47.43,23.03
臺北市,北投區,永欣里,3250,1756,1494,31,3281,6840,0,47.97,25.67
臺北市,北投區,永明里,1985,1014,971,20,2005,4020,0,49.88,25.22
臺北市,北投區,東華里,1895,1051,844,15,1910,3773,0,50.62,27.86
臺北市,北投區,吉利里,2599,1422,1177,20,2619,5623,0,46.58,25.29
臺北市,北投區,吉慶里,2003,879,1124,13,2016,4216,0,47.82,20.85
臺北市,北投區,尊賢里,1840,777,1063,12,1852,3960,0,46.77,19.62
臺北市,北投區,立賢里,2095,1014,1081,14,2109,4612,0,45.73,21.99
臺北市,北投區,立農里,3619,1723,1896,33,3652,7578,0,48.19,22.74
臺北市,北投區,八仙里,2149,1048,1101,10,2159,4729,0,45.65,22.16
臺北市,北投區,洲美里,932,334,598,9,941,1949,0,48.28,17.14
臺北市,北投區,奇岩里,4446,2156,2290,33,4479,9427,0,47.51,22.87
臺北市,北投區,清江里,3371,1598,1773,40,3411,8533,0,39.97,18.73
臺北市,北投區,中央里,3076,1396,1680,27,3103,7167,0,43.3,19.48
臺北市,北投區,長安里,2202,1038,1164,27,2229,5324,0,41.87,19.5
臺北市,北投區,大同里,2166,918,1248,23,2189,4700,0,46.57,19.53
臺北市,北投區,溫泉里,2611,1246,1365,22,2633,5643,0,46.66,22.08
臺北市,北投區,林泉里,1020,553,467,7,1027,2679,0,38.34,20.64
臺北市,北投區,中心里,2351,1238,1113,20,2371,5695,0,41.63,21.74
臺北市,北投區,中庸里,1535,703,832,12,1547,3547,0,43.61,19.82
臺北市,北投區,開明里,2683,1398,1285,29,2712,5783,0,46.9,24.17
臺北市,北投區,中和里,2077,1063,1014,19,2096,4233,0,49.52,25.11
臺北市,北投區,智仁里,2254,1180,1074,14,2268,5189,0,43.71,22.74
臺北市,北投區,秀山里,1228,660,568,20,1248,2834,0,44.04,23.29
臺北市,北投區,文化里,1706,1154,552,13,1719,3518,0,48.86,32.8
臺北市,北投區,豐年里,1487,772,715,12,1499,3811,0,39.33,20.26
臺北市,北投區,稻香里,2062,1193,869,17,2079,4730,0,43.95,25.22
臺北市,北投區,桃源里,2391,1096,1295,21,2412,5227,0,46.15,20.97
臺北市,北投區,一德里,2739,1250,1489,17,2756,6316,0,43.64,19.79
臺北市,北投區,關渡里,4188,2068,2120,56,4244,9738,0,43.58,21.24
臺北市,北投區,泉源里,820,345,475,10,830,2119,0,39.17,16.28
臺北市,北投區,湖山里,580,265,315,9,589,1446,0,40.73,18.33
臺北市,北投區,大屯里,412,147,265,4,416,1087,0,38.27,13.52
臺北市,北投區,湖田里,316,143,173,3,319,826,0,38.62,17.31
臺北市,北投區,合計,94129,46388,47741,826,94955,207834,247333,45.69,22.32
臺北市,合計,合計,1005769,539747,466022,8674,1014443,2155416,2562738,47.06,25.04
新北市,板橋區,留侯里,702,391,311,3,705,1395,0,50.54,28.03
新北市,板橋區,流芳里,559,273,286,3,562,1228,0,45.77,22.23
新北市,板橋區,赤松里,420,207,213,3,423,838,0,50.48,24.7
新北市,板橋區,黃石里,466,190,276,6,472,1026,0,46.0,18.52
新北市,板橋區,挹秀里,831,497,334,4,835,1648,0,50.67,30.16
新北市,板橋區,湳興里,1910,940,970,20,1930,4525,0,42.65,20.77
新北市,板橋區,新興里,1140,553,587,11,1151,2846,0,40.44,19.43
新北市,板橋區,社後里,2471,1200,1271,20,2491,8998,0,27.68,13.34
新北市,板橋區,香社里,1726,768,958,20,1746,3907,0,44.69,19.66
新北市,板橋區,中正里,1875,877,998,14,1889,4691,0,40.27,18.7
新北市,板橋區,自強里,2340,1345,995,11,2351,4425,0,53.13,30.4
新北市,板橋區,自立里,1153,518,635,7,1160,2471,0,46.94,20.96
新北市,板橋區,光華里,1106,580,526,8,1114,2357,0,47.26,24.61
新北市,板橋區,國光里,1796,1271,525,12,1808,3349,0,53.99,37.95
新北市,板橋區,港尾里,1227,616,611,8,1235,2463,0,50.14,25.01
新北市,板橋區,金華里,1459,640,819,11,1470,3446,0,42.66,18.57
新北市,板橋區,港德里,1696,753,943,16,1712,4107,0,41.68,18.33
新北市,板橋區,民權里,1143,592,551,8,1151,2304,0,49.96,25.69
新北市,板橋區,建國里,1430,597,833,13,1443,3109,0,46.41,19.2
新北市,板橋區,漢生里,1799,912,887,12,1811,3542,0,51.13,25.75
新北市,板橋區,公舘里,1463,618,845,14,1477,3318,0,44.51,18.63
新北市,板橋區,新民里,1669,818,851,10,1679,3648,0,46.03,22.42
新北市,板橋區,幸福里,1408,612,796,8,1416,3487,0,40.61,17.55
新北市,板橋區,忠誠里,1867,1314,553,10,1877,3605,0,52.07,36.45
新北市,板橋區,百壽里,1031,483,548,12,1043,2364,0,44.12,20.43
新北市,板橋區,介壽里,1079,534,545,14,1093,2555,0,42.78,20.9
新北市,板橋區,新埔里,933,404,529,6,939,1865,0,50.35,21.66
新北市,板橋區,華江里,2818,1394,1424,21,2839,6159,0,46.1,22.63
新北市,板橋區,江翠里,1935,790,1145,8,1943,4582,0,42.41,17.24
新北市,板橋區,純翠里,1981,826,1155,14,1995,4774,0,41.79,17.3
新北市,板橋區,溪頭里,2428,1054,1374,16,2444,5675,0,43.07,18.57
新北市,板橋區,聯翠里,1454,742,712,13,1467,3287,0,44.63,22.57
新北市,板橋區,宏翠里,1990,962,1028,12,2002,4715,0,42.46,20.4
新北市,板橋區,仁翠里,1128,416,712,12,1140,2555,0,44.62,16.28
新北市,板橋區,新翠里,3171,1417,1754,18,3189,7107,0,44.87,19.94
新北市,板橋區,吉翠里,1502,601,901,10,1512,3275,0,46.17,18.35
新北市,板橋區,德翠里,2768,1404,1364,19,2787,6174,0,45.14,22.74
新北市,板橋區,滿翠里,1128,418,710,8,1136,2666,0,42.61,15.68
新北市,板橋區,明翠里,1827,791,1036,16,1843,4242,0,43.45,18.65
新北市,板橋區,松翠里,1296,543,753,12,1308,2962,0,44.16,18.33
新北市,板橋區,柏翠里,1776,807,969,20,1796,4168,0,43.09,19.36
新北市,板橋區,龍翠里,1907,830,1077,13,1920,4391,0,43.73,18.9
新北市,板橋區,華翠里,1430,615,815,14,1444,3044,0,47.44,20.2
新北市,板橋區,忠翠里,4155,2084,2071,36,4191,9043,0,46.35,23.05
新北市,板橋區,嵐翠里,920,355,565,8,928,2150,0,43.16,16.51
新北市,板橋區,文翠里,1563,709,854,8,1571,3515,0,44.69,20.17
新北市,板橋區,青翠里,1124,458,666,7,1131,2638,0,42.87,17.36
新北市,板橋區,懷翠里,2077,852,1225,18,2095,5414,0,38.7,15.74
新北市,板橋區,福翠里,535,262,273,4,539,1221,0,44.14,21.46
新北市,板橋區,港嘴里,2288,1014,1274,16,2304,5318,0,43.32,19.07
新北市,板橋區,振興里,1801,824,977,13,1814,3920,0,46.28,21.02
新北市,板橋區,振義里,1678,697,981,22,1700,3731,0,45.56,18.68
新北市,板橋區,光復里,1286,548,738,9,1295,2939,0,44.06,18.65
新北市,板橋區,埔墘里,2388,1073,1315,19,2407,5578,0,43.15,19.24
新北市,板橋區,長壽里,1192,516,676,10,1202,2572,0,46.73,20.06
新北市,板橋區,福壽里,1314,686,628,11,1325,2920,0,45.38,23.49
新北市,板橋區,海山里,2942,1419,1523,21,2963,6417,0,46.17,22.11
新北市,板橋區,九如里,1084,425,659,9,1093,2522,0,43.34,16.85
新北市,板橋區,玉光里,1886,852,1034,14,1900,4586,0,41.43,18.58
新北市,板橋區,光仁里,1127,519,608,10,1137,2444,0,46.52,21.24
新北市,板橋區,埤墘里,1797,799,998,9,1806,3765,0,47.97,21.22
新北市,板橋區,永安里,1328,548,780,9,1337,3069,0,43.56,17.86
新北市,板橋區,雙玉里,1581,685,896,13,1594,3525,0,45.22,19.43
新北市,板橋區,廣新里,1224,567,657,13,1237,3031,0,40.81,18.71
新北市,板橋區,深丘里,3228,1734,1494,23,3251,7123,0,45.64,24.34
新北市,板橋區,香丘里,1346,593,753,5,1351,3179,0,42.5,18.65
新北市,板橋區,西安里,1020,478,542,6,1026,2350,0,43.66,20.34
新北市,板橋區,東丘里,1765,727,1038,21,1786,3895,0,45.85,18.66
新北市,板橋區,長安里,1754,830,924,12,1766,3802,0,46.45,21.83
新北市,板橋區,福丘里,2005,1118,887,17,2022,4141,0,48.83,27.0
新北市,板橋區,福祿里,1462,821,641,14,1476,3382,0,43.64,24.28
新北市,板橋區,民族里,1758,865,893,18,1776,3878,0,45.8,22.31
新北市,板橋區,國泰里,1432,726,706,23,1455,3111,0,46.77,23.34
新北市,板橋區,福德里,2036,959,1077,11,2047,4371,0,46.83,21.94
新北市,板橋區,景星里,1291,658,633,11,1302,3021,0,43.1,21.78
新北市,板橋區,福星里,1512,741,771,5,1517,3064,0,49.51,24.18
新北市,板橋區,鄉雲里,1549,780,769,28,1577,3320,0,47.5,23.49
新北市,板橋區,廣德里,2627,1311,1316,23,2650,5909,0,44.85,22.19
新北市,板橋區,大豐里,1805,927,878,10,1815,4094,0,44.33,22.64
新北市,板橋區,重慶里,3121,1549,1572,25,3146,7469,0,42.12,20.74
新北市,板橋區,仁愛里,1235,721,514,12,1247,2702,0,46.15,26.68
新北市,板橋區,和平里,1402,821,581,13,1415,3281,0,43.13,25.02
新北市,板橋區,廣福里,1339,627,712,13,1352,3505,0,38.57,17.89
新北市,板橋區,華興里,1704,857,847,20,1724,3734,0,46.17,22.95
新北市,板橋區,華貴里,1040,481,559,9,1049,2257,0,46.48,21.31
新北市,板橋區,華德里,2453,1223,1230,20,2473,6150,0,40.21,19.89
新北市,板橋區,華東里,3357,1859,1498,15,3372,6979,0,48.32,26.64
新北市,板橋區,信義里,1597,789,808,16,1613,3812,0,42.31,20.7
新北市,板橋區,浮洲里,1354,538,816,12,1366,3334,0,40.97,16.14
新北市,板橋區,華中里,1917,793,1124,21,1938,4625,0,41.9,17.15
新北市,板橋區,僑中里,1438,611,827,6,1444,3700,0,39.03,16.51
新北市,板橋區,中山里,2503,1348,1155,22,2525,6074,0,41.57,22.19
新北市,板橋區,復興里,431,253,178,8,439,873,0,50.29,28.98
新北市,板橋區,大安里,1477,677,800,7,1484,3466,0,42.82,19.53
新北市,板橋區,福安里,2645,1460,1185,23,2668,6234,0,42.8,23.42
新北市,板橋區,聚安里,1780,759,1021,18,1798,4615,0,38.96,16.45
新北市,板橋區,龍安里,1067,445,622,20,1087,2464,0,44.12,18.06
新北市,板橋區,崑崙里,3332,1575,1757,36,3368,8523,0,39.52,18.48
新北市,板橋區,溪洲里,2015,912,1103,19,2034,5148,0,39.51,17.72
新北市,板橋區,溪北里,1292,613,679,15,1307,3079,0,42.45,19.91
新北市,板橋區,香雅里,1027,506,521,10,1037,2397,0,43.26,21.11
新北市,板橋區,新生里,1652,727,925,18,1670,3742,0,44.63,19.43
新北市,板橋區,文德里,1191,593,598,5,1196,2692,0,44.43,22.03
新北市,板橋區,文化里,1330,579,751,12,1342,2948,0,45.52,19.64
新北市,板橋區,新海里,1291,560,731,7,1298,3027,0,42.88,18.5
新北市,板橋區,莒光里,1134,479,655,8,1142,2449,0,46.63,19.56
新北市,板橋區,富貴里,1005,491,514,6,1011,2040,0,49.56,24.07
新北市,板橋區,正泰里,1225,557,668,12,1237,2595,0,47.67,21.46
新北市,板橋區,民生里,903,405,498,7,910,1940,0,46.91,20.88
新北市,板橋區,後埔里,1532,793,739,17,1549,3280,0,47.23,24.18
新北市,板橋區,華福里,821,414,407,8,829,1789,0,46.34,23.14
新北市,板橋區,堂春里,1476,688,788,16,1492,3718,0,40.13,18.5
新北市,板橋區,成和里,2167,1015,1152,23,2190,6055,0,36.17,16.76
新北市,板橋區,光榮里,1031,559,472,6,1037,2287,0,45.34,24.44
新北市,板橋區,民安里,836,426,410,3,839,1772,0,47.35,24.04
新北市,板橋區,陽明里,1123,480,643,11,1134,2400,0,47.25,20.0
新北市,板橋區,朝陽里,1236,472,764,11,1247,2973,0,41.94,15.88
新北市,板橋區,松柏里,952,421,531,17,969,2012,0,48.16,20.92
新北市,板橋區,文聖里,1496,598,898,15,1511,3479,0,43.43,17.19
新北市,板橋區,居仁里,1435,638,797,15,1450,3379,0,42.91,18.88
新北市,板橋區,莊敬里,1664,815,849,16,1680,3540,0,47.46,23.02
新北市,板橋區,東安里,826,350,476,11,837,2026,0,41.31,17.28
新北市,板橋區,五權里,1584,729,855,11,1595,3585,0,44.49,20.33
新北市,板橋區,溪福里,4710,2345,2365,36,4746,12217,0,38.85,19.19
新北市,板橋區,大觀里,1249,495,754,11,1260,3210,0,39.25,15.42
新北市,板橋區,歡園里,496,189,307,4,500,1091,0,45.83,17.32
新北市,板橋區,合計,203009,96508,106501,1682,204691,466918,555551,43.84,20.67
新北市,三重區,大有里,2041,855,1186,14,2055,4726,0,43.48,18.09
新北市,三重區,二重里,565,225,340,9,574,1436,0,39.97,15.67
新北市,三重區,頂崁里,963,357,606,6,969,2322,0,41.73,15.37
新北市,三重區,谷王里,445,266,179,3,448,904,0,49.56,29.42
新北市,三重區,中興里,1651,660,991,14,1665,3568,0,46.66,18.5
新北市,三重區,德厚里,175,58,117,3,178,351,0,50.71,16.52
新北市,三重區,成功里,2614,1253,1361,15,2629,5671,0,46.36,22.09
新北市,三重區,福祉里,2168,988,1180,16,2184,4889,0,44.67,20.21
新北市,三重區,福民里,1323,551,772,7,1330,3007,0,44.23,18.32
新北市,三重區,過田里,2493,1203,1290,27,2520,8822,0,28.56,13.64
新北市,三重區,錦田里,831,351,480,4,835,1860,0,44.89,18.87
新北市,三重區,重明里,1505,673,832,9,1514,3239,0,46.74,20.78
新北市,三重區,光田里,1892,852,1040,17,1909,3937,0,48.49,21.64
新北市,三重區,光陽里,2726,1211,1515,19,2745,5711,0,48.07,21.2
新北市,三重區,田心里,1542,642,900,11,1553,3667,0,42.35,17.51
新北市,三重區,福田里,1463,608,855,17,1480,3107,0,47.63,19.57
新北市,三重區,田中里,2425,909,1516,26,2451,5458,0,44.91,16.65
新北市,三重區,田安里,2418,1035,1383,23,2441,5517,0,44.25,18.76
新北市,三重區,三民里,1185,480,705,12,1197,2877,0,41.61,16.68
新北市,三重區,光明里,2794,1322,1472,20,2814,6525,0,43.13,20.26
新北市,三重區,光正里,1090,575,515,4,1094,2380,0,45.97,24.16
新北市,三重區,同安里,488,219,269,6,494,1288,0,38.35,17.0
新北市,三重區,同慶里,694,327,367,4,698,1582,0,44.12,20.67
新北市,三重區,菜寮里,899,393,506,6,905,1982,0,45.66,19.83
新北市,三重區,永春里,733,353,380,9,742,1664,0,44.59,21.21
新北市,三重區,中正里,595,270,325,6,601,1261,0,47.66,21.41
新北市,三重區,吉利里,536,253,283,5,541,1289,0,41.97,19.63
新北市,三重區,大同里,769,346,423,1,770,1819,0,42.33,19.02
新北市,三重區,中民里,504,243,261,3,507,1130,0,44.87,21.5
新北市,三重區,平和里,611,290,321,9,620,1363,0,45.49,21.28
新北市,三重區,大安里,634,335,299,6,640,1483,0,43.16,22.59
新北市,三重區,仁德里,723,305,418,7,730,1785,0,40.9,17.09
新北市,三重區,忠孝里,710,317,393,9,719,1629,0,44.14,19.46
新北市,三重區,仁義里,513,227,286,3,516,1175,0,43.91,19.32
新北市,三重區,光榮里,537,245,292,5,542,1315,0,41.22,18.63
新北市,三重區,光輝里,610,277,333,6,616,1391,0,44.28,19.91
新北市,三重區,福星里,558,274,284,0,558,1098,0,50.82,24.95
新北市,三重區,福利里,926,452,474,4,930,2035,0,45.7,22.21
新北市,三重區,清和里,1694,776,918,16,1710,3628,0,47.13,21.39
新北市,三重區,永興里,608,286,322,4,612,1275,0,48.0,22.43
新北市,三重區,中山里,1084,476,608,9,1093,2448,0,44.65,19.44
新北市,三重區,大園里,1003,414,589,8,1011,2453,0,41.21,16.88
新北市,三重區,國隆里,1141,576,565,8,1149,2406,0,47.76,23.94
新北市,三重區,重陽里,1317,580,737,14,1331,3178,0,41.88,18.25
新北市,三重區,民生里,1650,621,1029,12,1662,3797,0,43.77,16.36
新北市,三重區,重新里,645,233,412,7,652,1352,0,48.22,17.23
新北市,三重區,正德里,464,197,267,3,467,1030,0,45.34,19.13
新北市,三重區,正義里,773,324,449,9,782,1597,0,48.97,20.29
新北市,三重區,正安里,802,371,431,5,807,1771,0,45.57,20.95
新北市,三重區,自強里,698,272,426,5,703,1652,0,42.55,16.46
新北市,三重區,文化里,957,416,541,3,960,2007,0,47.83,20.73
新北市,三重區,中央里,686,268,418,5,691,1674,0,41.28,16.01
新北市,三重區,雙園里,397,204,193,2,399,855,0,46.67,23.86
新北市,三重區,錦通里,629,292,337,13,642,1344,0,47.77,21.73
新北市,三重區,錦安里,680,285,395,4,684,1672,0,40.91,17.05
新北市,三重區,長安里,822,349,473,5,827,1939,0,42.65,18.0
新北市,三重區,光華里,885,383,502,7,892,2070,0,43.09,18.5
新北市,三重區,長生里,348,140,208,5,353,813,0,43.42,17.22
新北市,三重區,開元里,653,295,358,17,670,1385,0,48.38,21.3
新北市,三重區,大德里,354,171,183,4,358,770,0,46.49,22.21
新北市,三重區,長元里,944,438,506,9,953,2229,0,42.75,19.65
新北市,三重區,長江里,818,341,477,10,828,1876,0,44.14,18.18
新北市,三重區,長泰里,846,360,486,10,856,2003,0,42.74,17.97
新北市,三重區,長福里,588,250,338,9,597,1436,0,41.57,17.41
新北市,三重區,介壽里,464,216,248,9,473,1039,0,45.52,20.79
新北市,三重區,萬壽里,818,395,423,11,829,1775,0,46.7,22.25
新北市,三重區,錦江里,802,324,478,11,813,2123,0,38.29,15.26
新北市,三重區,龍濱里,1270,549,721,7,1277,2926,0,43.64,18.76
新北市,三重區,龍門里,684,375,309,3,687,1678,0,40.94,22.35
新北市,三重區,秀江里,470,201,269,4,474,1136,0,41.73,17.69
新北市,三重區,奕壽里,723,291,432,6,729,1549,0,47.06,18.79
新北市,三重區,三安里,1003,437,566,8,1011,2410,0,41.95,18.13
新北市,三重區,福安里,1176,463,713,19,1195,2698,0,44.29,17.16
新北市,三重區,信安里,717,332,385,9,726,1802,0,40.29,18.42
新北市,三重區,安慶里,813,317,496,5,818,1889,0,43.3,16.78
新北市,三重區,幸福里,1785,733,1052,10,1795,4172,0,43.02,17.57
新北市,三重區,六合里,1460,614,846,11,1471,3336,0,44.09,18.41
新北市,三重區,六福里,2036,795,1241,19,2055,4936,0,41.63,16.11
新北市,三重區,順德里,890,374,516,12,902,2027,0,44.5,18.45
新北市,三重區,承德里,716,293,423,6,722,1631,0,44.27,17.96
新北市,三重區,瑞德里,933,393,540,14,947,2145,0,44.15,18.32
新北市,三重區,崇德里,1545,601,944,9,1554,3509,0,44.29,17.13
新北市,三重區,厚德里,1468,668,800,8,1476,3088,0,47.8,21.63
新北市,三重區,維德里,1173,487,686,12,1185,2545,0,46.56,19.14
新北市,三重區,尚德里,1121,465,656,8,1129,2674,0,42.22,17.39
新北市,三重區,培德里,1502,617,885,5,1507,3267,0,46.13,18.89
新北市,三重區,永德里,1810,704,1106,16,1826,4360,0,41.88,16.15
新北市,三重區,永盛里,1235,478,757,16,1251,2861,0,43.73,16.71
新北市,三重區,永福里,2049,826,1223,16,2065,4596,0,44.93,17.97
新北市,三重區,永清里,1903,676,1227,6,1909,4710,0,40.53,14.35
新北市,三重區,永安里,1513,611,902,13,1526,3553,0,42.95,17.2
新北市,三重區,永煇里,976,353,623,8,984,2263,0,43.48,15.6
新北市,三重區,溪美里,3386,1404,1982,33,3419,7625,0,44.84,18.41
新北市,三重區,福隆里,1620,652,968,14,1634,3940,0,41.47,16.55
新北市,三重區,五常里,1604,669,935,21,1625,3874,0,41.95,17.27
新北市,三重區,五福里,1350,569,781,11,1361,3407,0,39.95,16.7
新北市,三重區,仁忠里,1018,450,568,10,1028,2802,0,36.69,16.06
新北市,三重區,慈福里,860,296,564,9,869,1998,0,43.49,14.81
新北市,三重區,慈生里,933,367,566,10,943,2046,0,46.09,17.94
新北市,三重區,慈惠里,909,324,585,7,916,2029,0,45.15,15.97
新北市,三重區,慈愛里,1387,534,853,15,1402,3070,0,45.67,17.39
新北市,三重區,慈化里,929,377,552,8,937,2229,0,42.04,16.91
新北市,三重區,慈祐里,1828,733,1095,17,1845,4356,0,42.36,16.83
新北市,三重區,五華里,1928,746,1182,15,1943,4540,0,42.8,16.43
新北市,三重區,富貴里,2469,1178,1291,14,2483,5713,0,43.46,20.62
新北市,三重區,富華里,1143,495,648,12,1155,2882,0,40.08,17.18
新北市,三重區,富福里,685,275,410,1,686,1839,0,37.3,14.95
新北市,三重區,碧華里,3119,1502,1617,23,3142,7294,0,43.08,20.59
新北市,三重區,五谷里,819,361,458,6,825,1740,0,47.41,20.75
新北市,三重區,博愛里,1796,761,1035,11,1807,4013,0,45.03,18.96
新北市,三重區,福德里,1561,732,829,17,1578,3686,0,42.81,19.86
新北市,三重區,永吉里,1038,448,590,5,1043,2539,0,41.08,17.64
新北市,三重區,永發里,2245,834,1411,18,2263,5046,0,44.85,16.53
新北市,三重區,永順里,1669,641,1028,8,1677,4437,0,37.8,14.45
新北市,三重區,永豐里,2065,781,1284,20,2085,5061,0,41.2,15.43
新北市,三重區,立德里,1345,556,789,14,1359,2994,0,45.39,18.57
新北市,三重區,福樂里,1358,524,834,8,1366,3293,0,41.48,15.91
新北市,三重區,仁華里,1681,727,954,21,1702,3764,0,45.22,19.31
新北市,三重區,五順里,1344,538,806,12,1356,3524,0,38.48,15.27
新北市,三重區,合計,141979,60580,81399,1209,143188,330362,383135,43.34,18.34
新北市,中和區,中原里,2695,1426,1269,18,2713,6550,0,41.42,21.77
新北市,中和區,平河里,3639,2026,1613,27,3666,7974,0,45.97,25.41
新北市,中和區,信和里,1705,852,853,18,1723,3796,0,45.39,22.44
新北市,中和區,仁和里,1415,745,670,3,1418,3469,0,40.88,21.48
新北市,中和區,中正里,1354,687,667,13,1367,3452,0,39.6,19.9
新北市,中和區,建和里,1556,992,564,12,1568,3096,0,50.65,32.04
新北市,中和區,連和里,1029,692,337,5,1034,2171,0,47.63,31.87
新北市,中和區,連城里,2722,1632,1090,17,2739,5682,0,48.2,28.72
新北市,中和區,力行里,2528,1371,1157,16,2544,5265,0,48.32,26.04
新北市,中和區,枋寮里,1509,810,699,14,1523,3312,0,45.98,24.46
新北市,中和區,漳和里,1574,890,684,8,1582,3410,0,46.39,26.1
新北市,中和區,廟美里,1806,962,844,11,1817,3887,0,46.75,24.75
新北市,中和區,福真里,1685,853,832,16,1701,3709,0,45.86,23.0
新北市,中和區,福善里,1790,952,838,14,1804,3832,0,47.08,24.84
新北市,中和區,福美里,1878,1040,838,12,1890,3903,0,48.42,26.65
新北市,中和區,福祥里,2132,1100,1032,16,2148,4460,0,48.16,24.66
新北市,中和區,瓦磘里,2074,1102,972,16,2090,4916,0,42.51,22.42
新北市,中和區,福和里,1488,815,673,15,1503,3253,0,46.2,25.05
新北市,中和區,佳和里,2092,1166,926,29,2121,4420,0,47.99,26.38
新北市,中和區,安樂里,1678,1086,592,19,1697,3265,0,51.98,33.26
新北市,中和區,安和里,1407,810,597,10,1417,2767,0,51.21,29.27
新北市,中和區,安平里,2697,1747,950,30,2727,5289,0,51.56,33.03
新北市,中和區,中安里,2084,1363,721,13,2097,3903,0,53.73,34.92
新北市,中和區,泰安里,1451,803,648,18,1469,3171,0,46.33,25.32
新北市,中和區,新南里,3304,1992,1312,27,3331,7115,0,46.82,28.0
新北市,中和區,南山里,2151,1293,858,21,2172,4499,0,48.28,28.74
新北市,中和區,秀山里,1862,1136,726,10,1872,4018,0,46.59,28.27
新北市,中和區,秀成里,1438,840,598,13,1451,3062,0,47.39,27.43
新北市,中和區,秀福里,2065,1228,837,17,2082,4298,0,48.44,28.57
新北市,中和區,秀景里,2775,1781,994,22,2797,5620,0,49.77,31.69
新北市,中和區,秀明里,2120,1457,663,23,2143,4436,0,48.31,32.84
新北市,中和區,秀峰里,2032,1284,748,20,2052,4318,0,47.52,29.74
新北市,中和區,秀仁里,1305,814,491,11,1316,2931,0,44.9,27.77
新北市,中和區,頂南里,1250,833,417,13,1263,2614,0,48.32,31.87
新北市,中和區,華新里,2726,1760,966,31,2757,6686,0,41.24,26.32
新北市,中和區,東南里,1793,1367,426,17,1810,3818,0,47.41,35.8
新北市,中和區,華南里,2005,1305,700,18,2023,4482,0,45.14,29.12
新北市,中和區,忠孝里,1707,1119,588,20,1727,4171,0,41.4,26.83
新北市,中和區,崇南里,1909,1257,652,25,1934,3856,0,50.16,32.6
新北市,中和區,景南里,1242,774,468,16,1258,2778,0,45.28,27.86
新北市,中和區,橫路里,142,63,79,0,142,310,0,45.81,20.32
新北市,中和區,內南里,1890,1152,738,26,1916,4421,0,43.34,26.06
新北市,中和區,壽南里,967,548,419,8,975,2183,0,44.66,25.1
新北市,中和區,外南里,1623,908,715,9,1632,6944,0,23.5,13.08
新北市,中和區,復興里,2071,1232,839,18,2089,4423,0,47.23,27.85
新北市,中和區,和興里,1905,1133,772,20,1925,3949,0,48.75,28.69
新北市,中和區,景平里,2384,1494,890,27,2411,4885,0,49.36,30.58
新北市,中和區,景新里,1546,922,624,13,1559,3210,0,48.57,28.72
新北市,中和區,景福里,2372,1494,878,29,2401,5145,0,46.67,29.04
新北市,中和區,景安里,2193,1355,838,26,2219,4350,0,51.01,31.15
新北市,中和區,景文里,1608,886,722,25,1633,3381,0,48.3,26.21
新北市,中和區,錦和里,2114,1159,955,19,2133,4740,0,45.0,24.45
新北市,中和區,錦昌里,949,578,371,9,958,1986,0,48.24,29.1
新北市,中和區,灰磘里,278,125,153,3,281,699,0,40.2,17.88
新北市,中和區,積穗里,3447,1881,1566,31,3478,7243,0,48.02,25.97
新北市,中和區,民享里,1082,471,611,6,1088,2221,0,48.99,21.21
新北市,中和區,員山里,2431,1222,1209,23,2454,5500,0,44.62,22.22
新北市,中和區,嘉穗里,1115,575,540,6,1121,2534,0,44.24,22.69
新北市,中和區,文元里,2040,980,1060,19,2059,4552,0,45.23,21.53
新北市,中和區,嘉新里,1471,731,740,15,1486,3544,0,41.93,20.63
新北市,中和區,民安里,1973,1007,966,16,1989,4463,0,44.57,22.56
新北市,中和區,安穗里,1710,818,892,9,1719,4026,0,42.7,20.32
新北市,中和區,瑞穗里,983,565,418,5,988,2090,0,47.27,27.03
新北市,中和區,明穗里,1836,887,949,7,1843,3932,0,46.87,22.56
新北市,中和區,清穗里,1308,662,646,6,1314,2811,0,46.74,23.55
新北市,中和區,自強里,1859,876,983,12,1871,4374,0,42.78,20.03
新北市,中和區,德穗里,1830,975,855,12,1842,4038,0,45.62,24.15
新北市,中和區,民生里,1751,901,850,23,1774,3746,0,47.36,24.05
新北市,中和區,國光里,1591,861,730,17,1608,3413,0,47.11,25.23
新北市,中和區,壽德里,1949,1322,627,25,1974,3950,0,49.97,33.47
新北市,中和區,明德里,1433,672,761,15,1448,3434,0,42.17,19.57
新北市,中和區,秀水里,1469,954,515,13,1482,3329,0,44.52,28.66
新北市,中和區,德行里,2819,1657,1162,23,2842,5696,0,49.89,29.09
新北市,中和區,宜安里,865,543,322,11,876,1721,0,50.9,31.55
新北市,中和區,安順里,1974,1223,751,33,2007,3886,0,51.65,31.47
新北市,中和區,秀義里,1197,678,519,8,1205,2405,0,50.1,28.19
新北市,中和區,秀士里,1014,650,364,6,1020,2226,0,45.82,29.2
新北市,中和區,興南里,1249,769,480,21,1270,2756,0,46.08,27.9
新北市,中和區,景本里,939,554,385,8,947,1883,0,50.29,29.42
新北市,中和區,福南里,1670,1075,595,22,1692,3773,0,44.84,28.49
新北市,中和區,中興里,2656,1605,1051,13,2669,5825,0,45.82,27.55
新北市,中和區,吉興里,1195,749,446,3,1198,2623,0,45.67,28.56
新北市,中和區,中山里,999,497,502,9,1008,2395,0,42.09,20.75
新北市,中和區,碧河里,2042,1104,938,19,2061,4326,0,47.64,25.52
新北市,中和區,錦中里,1559,830,729,12,1571,3643,0,43.12,22.78
新北市,中和區,錦盛里,1485,710,775,18,1503,3432,0,43.79,20.69
新北市,中和區,民有里,1174,609,565,10,1184,2486,0,47.63,24.5
新北市,中和區,員富里,1351,661,690,20,1371,3236,0,42.37,20.43
新北市,中和區,嘉慶里,1510,739,771,7,1517,3862,0,39.28,19.14
新北市,中和區,冠穗里,1451,695,756,18,1469,2946,0,49.86,23.59
新北市,中和區,國華里,1315,624,691,14,1329,2987,0,44.49,20.89
新北市,中和區,正南里,1288,834,454,10,1298,3087,0,42.05,27.02
新北市,中和區,正行里,1170,662,508,6,1176,2564,0,45.87,25.82
新北市,中和區,合計,161914,93039,68875,1457,163371,355238,408654,45.99,26.19
新北市,永和區,福林里,1365,805,560,14,1379,2917,0,47.27,27.6
新北市,永和區,文化里,1184,745,439,16,1200,2476,0,48.47,30.09
新北市,永和區,豫溪里,1563,986,577,13,1576,4502,0,35.01,21.9
新北市,永和區,光明里,1343,860,483,8,1351,2581,0,52.34,33.32
新北市,永和區,仁愛里,1233,748,485,9,1242,2419,0,51.34,30.92
新北市,永和區,永貞里,1470,871,599,17,1487,2938,0,50.61,29.65
新北市,永和區,永福里,1244,759,485,5,1249,2396,0,52.13,31.68
新北市,永和區,民治里,1066,677,389,7,1073,2525,0,42.5,26.81
新北市,永和區,永成里,409,332,77,7,416,876,0,47.49,37.9
新北市,永和區,忠義里,346,279,67,6,352,704,0,50.0,39.63
新北市,永和區,永元里,1978,1190,788,19,1997,4085,0,48.89,29.13
新北市,永和區,秀林里,1710,941,769,12,1722,3437,0,50.1,27.38
新北市,永和區,保安里,3057,1803,1254,21,3078,6137,0,50.15,29.38
新北市,永和區,中溪里,2123,1210,913,16,2139,4473,0,47.82,27.05
新北市,永和區,永安里,1876,1179,697,11,1887,3634,0,51.93,32.44
新北市,永和區,民族里,1940,1210,730,16,1956,3986,0,49.07,30.36
新北市,永和區,民權里,1835,1123,712,14,1849,3852,0,48.0,29.15
新北市,永和區,中興里,1312,789,523,12,1324,2760,0,47.97,28.59
新北市,永和區,勵行里,490,246,244,4,494,1091,0,45.28,22.55
新北市,永和區,秀朗里,1521,844,677,13,1534,3358,0,45.68,25.13
新北市,永和區,秀成里,1196,687,509,12,1208,2545,0,47.47,26.99
新北市,永和區,上溪里,782,456,326,6,788,1702,0,46.3,26.79
新北市,永和區,竹林里,1500,977,523,13,1513,3222,0,46.96,30.32
新北市,永和區,雙和里,1768,1094,674,11,1779,3413,0,52.12,32.05
新北市,永和區,安和里,1666,1029,637,14,1680,3354,0,50.09,30.68
新北市,永和區,水源里,1795,1099,696,9,1804,3469,0,52.0,31.68
新北市,永和區,協和里,1276,751,525,6,1282,2623,0,48.88,28.63
新北市,永和區,河堤里,1383,885,498,10,1393,2995,0,46.51,29.55
新北市,永和區,頂溪里,1121,670,451,13,1134,2205,0,51.43,30.39
新北市,永和區,潭墘里,1980,1314,666,15,1995,3956,0,50.43,33.22
新北市,永和區,潭安里,2003,1323,680,25,2028,4105,0,49.4,32.23
新北市,永和區,大新里,1155,709,446,9,1164,2298,0,50.65,30.85
新北市,永和區,保平里,2032,1152,880,16,2048,4115,0,49.77,28.0
新北市,永和區,民本里,1509,905,604,9,1518,3433,0,44.22,26.36
新北市,永和區,民樂里,2057,1318,739,15,2072,4047,0,51.2,32.57
新北市,永和區,光復里,716,449,267,2,718,1527,0,47.02,29.4
新北市,永和區,復興里,1036,663,373,12,1048,2119,0,49.46,31.29
新北市,永和區,福和里,2202,1394,808,15,2217,4495,0,49.32,31.01
新北市,永和區,得和里,1931,1264,667,23,1954,3718,0,52.56,34.0
新北市,永和區,智光里,1220,746,474,15,1235,2845,0,43.41,26.22
新北市,永和區,新生里,384,287,97,4,388,809,0,47.96,35.48
新北市,永和區,大同里,444,324,120,3,447,907,0,49.28,35.72
新北市,永和區,前溪里,913,580,333,7,920,1894,0,48.57,30.62
新北市,永和區,和平里,1943,1173,770,16,1959,4232,0,46.29,27.72
新北市,永和區,新廍里,1013,613,400,10,1023,1996,0,51.25,30.71
新北市,永和區,下溪里,1912,1138,774,18,1930,3972,0,48.59,28.65
新北市,永和區,秀和里,2099,1267,832,18,2117,4293,0,49.31,29.51
新北市,永和區,河濱里,1324,787,537,10,1334,2797,0,47.69,28.14
新北市,永和區,民生里,1611,931,680,9,1620,3428,0,47.26,27.16
新北市,永和區,秀得里,1075,676,399,10,1085,2304,0,47.09,29.34
新北市,永和區,上林里,1523,1007,516,11,1534,3036,0,50.53,33.17
新北市,永和區,網溪里,466,314,152,3,469,1031,0,45.49,30.46
新北市,永和區,正興里,930,569,361,12,942,1963,0,47.99,28.99
新北市,永和區,永興里,1286,817,469,14,1300,2764,0,47.03,29.56
新北市,永和區,桂林里,1497,992,505,11,1508,3259,0,46.27,30.44
新北市,永和區,店街里,1643,1028,615,9,1652,3607,0,45.8,28.5
新北市,永和區,信義里,1154,684,470,12,1166,2350,0,49.62,29.11
新北市,永和區,後溪里,900,483,417,8,908,1783,0,50.93,27.09
新北市,永和區,民富里,1155,687,468,12,1167,2527,0,46.18,27.19
新北市,永和區,秀元里,1273,768,505,6,1279,2627,0,48.69,29.23
新北市,永和區,永樂里,984,545,439,6,990,2095,0,47.26,26.01
新北市,永和區,保順里,4152,2538,1614,20,4172,9013,0,46.29,28.16
新北市,永和區,合計,89074,54690,34384,719,89793,186020,217795,48.27,29.4
新北市,新莊區,海山里,2123,937,1186,13,2136,4736,0,45.1,19.78
新北市,新莊區,頭前里,3588,1642,1946,26,3614,8383,0,43.11,19.59
新北市,新莊區,國泰里,555,253,302,8,563,1293,0,43.54,19.57
新北市,新莊區,全安里,1858,814,1044,14,1872,3916,0,47.8,20.79
新北市,新莊區,福基里,2016,964,1052,15,2031,4570,0,44.44,21.09
新北市,新莊區,豐年里,1355,571,784,14,1369,3237,0,42.29,17.64
新北市,新莊區,忠孝里,2054,944,1110,17,2071,4625,0,44.78,20.41
新北市,新莊區,恆安里,1739,782,957,12,1751,3906,0,44.83,20.02
新北市,新莊區,後港里,2786,1197,1589,18,2804,6314,0,44.41,18.96
新北市,新莊區,文衡里,903,387,516,8,911,1879,0,48.48,20.6
新北市,新莊區,中美里,2331,1051,1280,17,2348,5211,0,45.06,20.17
新北市,新莊區,八德里,1023,420,603,7,1030,2744,0,37.54,15.31
新北市,新莊區,興漢里,1408,746,662,12,1420,2917,0,48.68,25.57
新北市,新莊區,中和里,1823,821,1002,11,1834,4028,0,45.53,20.38
新北市,新莊區,西盛里,4304,1986,2318,34,4338,10595,0,40.94,18.74
新北市,新莊區,榮和里,1299,614,685,7,1306,5142,0,25.4,11.94
新北市,新莊區,中泰里,1568,595,973,15,1583,3896,0,40.63,15.27
新北市,新莊區,瓊林里,2028,807,1221,19,2047,5058,0,40.47,15.95
新北市,新莊區,文德里,730,377,353,10,740,1553,0,47.65,24.28
新北市,新莊區,中誠里,760,292,468,5,765,1903,0,40.2,15.34
新北市,新莊區,裕民里,2404,974,1430,19,2423,6057,0,40.0,16.08
新北市,新莊區,文明里,667,287,380,6,673,1547,0,43.5,18.55
新北市,新莊區,中港里,2326,1006,1320,24,2350,5390,0,43.6,18.66
新北市,新莊區,富國里,855,372,483,10,865,2056,0,42.07,18.09
新北市,新莊區,思源里,1987,837,1150,19,2006,4652,0,43.12,17.99
新北市,新莊區,立人里,841,525,316,8,849,1674,0,50.72,31.36
新北市,新莊區,南港里,1772,762,1010,19,1791,4664,0,38.4,16.34
新北市,新莊區,仁愛里,937,353,584,9,946,2389,0,39.6,14.78
新北市,新莊區,立德里,1049,512,537,2,1051,2305,0,45.6,22.21
新北市,新莊區,信義里,1878,827,1051,19,1897,4652,0,40.78,17.78
新北市,新莊區,立言里,1879,895,984,15,1894,4324,0,43.8,20.7
新北市,新莊區,民安里,1961,916,1045,26,1987,5143,0,38.64,17.81
新北市,新莊區,和平里,1722,651,1071,16,1738,4178,0,41.6,15.58
新北市,新莊區,立功里,1249,526,723,9,1258,3266,0,38.52,16.11
新北市,新莊區,民本里,1006,366,640,8,1014,2666,0,38.03,13.73
新北市,新莊區,化成里,1485,603,882,11,1496,3422,0,43.72,17.62
新北市,新莊區,立志里,1487,598,889,10,1497,3451,0,43.38,17.33
新北市,新莊區,光華里,2236,989,1247,17,2253,6136,0,36.72,16.12
新北市,新莊區,思賢里,1625,700,925,14,1639,3692,0,44.39,18.96
新北市,新莊區,營盤里,774,348,426,1,775,1701,0,45.56,20.46
新北市,新莊區,光榮里,1344,647,697,11,1355,3835,0,35.33,16.87
新北市,新莊區,自強里,844,346,498,6,850,2341,0,36.31,14.78
新北市,新莊區,丹鳳里,2912,1406,1506,26,2938,7720,0,38.06,18.21
新北市,新莊區,光明里,1428,620,808,11,1439,4165,0,34.55,14.89
新北市,新莊區,自立里,1894,769,1125,30,1924,4667,0,41.23,16.48
新北市,新莊區,合鳳里,1502,640,862,11,1513,4014,0,37.69,15.94
新北市,新莊區,幸福里,1496,527,969,9,1505,3807,0,39.53,13.84
新北市,新莊區,雙鳳里,3806,1906,1900,24,3830,9790,0,39.12,19.47
新北市,新莊區,自信里,866,343,523,6,872,2188,0,39.85,15.68
新北市,新莊區,龍鳳里,3414,1634,1780,24,3438,8555,0,40.19,19.1
新北市,新莊區,中華里,1128,495,633,7,1135,2558,0,44.37,19.35
新北市,新莊區,中隆里,1709,763,946,15,1724,4343,0,39.7,17.57
新北市,新莊區,中原里,4535,2104,2431,33,4568,11108,0,41.12,18.94
新北市,新莊區,中信里,3019,1297,1722,19,3038,7280,0,41.73,17.82
新北市,新莊區,四維里,1464,614,850,18,1482,4090,0,36.23,15.01
新北市,新莊區,建福里,950,425,525,8,958,2178,0,43.99,19.51
新北市,新莊區,中宏里,1344,578,766,14,1358,3219,0,42.19,17.96
新北市,新莊區,中全里,1194,426,768,10,1204,3118,0,38.61,13.66
新北市,新莊區,立泰里,1857,865,992,18,1875,4308,0,43.52,20.08
新北市,新莊區,全泰里,2097,1065,1032,14,2111,4287,0,49.24,24.84
新北市,新莊區,仁義里,1275,461,814,6,1281,3271,0,39.16,14.09
新北市,新莊區,立基里,2471,1153,1318,15,2486,5316,0,46.76,21.69
新北市,新莊區,昌明里,1373,611,762,9,1382,3181,0,43.45,19.21
新北市,新莊區,昌平里,2970,1414,1556,13,2983,7008,0,42.57,20.18
新北市,新莊區,文聖里,1432,712,720,16,1448,2960,0,48.92,24.05
新北市,新莊區,萬安里,1274,559,715,10,1284,3234,0,39.7,17.29
新北市,新莊區,龍安里,774,331,443,8,782,2075,0,37.69,15.95
新北市,新莊區,福營里,997,425,572,7,1004,2274,0,44.15,18.69
新北市,新莊區,後德里,1278,589,689,10,1288,2720,0,47.35,21.65
新北市,新莊區,建安里,2309,1017,1292,19,2328,5875,0,39.63,17.31
新北市,新莊區,成德里,1615,697,918,7,1622,4416,0,36.73,15.78
新北市,新莊區,福興里,2278,974,1304,20,2298,5247,0,43.8,18.56
新北市,新莊區,昌信里,1349,613,736,9,1358,3272,0,41.5,18.73
新北市,新莊區,昌隆里,1660,802,858,15,1675,3858,0,43.42,20.79
新北市,新莊區,中平里,3261,1670,1591,19,3280,7749,0,42.33,21.55
新北市,新莊區,立廷里,4173,2146,2027,26,4199,9967,0,42.13,21.53
新北市,新莊區,泰豐里,957,445,512,15,972,2206,0,44.06,20.17
新北市,新莊區,富民里,1453,686,767,7,1460,3404,0,42.89,20.15
新北市,新莊區,龍福里,798,399,399,5,803,1990,0,40.35,20.05
新北市,新莊區,祥鳳里,858,398,460,4,862,2133,0,40.41,18.66
新北市,新莊區,民全里,1335,592,743,5,1340,3307,0,40.52,17.9
新北市,新莊區,民有里,1534,721,813,15,1549,3548,0,43.66,20.32
新北市,新莊區,光正里,1458,688,770,16,1474,3815,0,38.64,18.03
新北市,新莊區,光和里,899,351,548,8,907,2430,0,37.33,14.44
新北市,新莊區,合計,144975,65171,79804,1142,146117,352098,422668,41.5,18.51
新北市,新店區,國豐里,1409,966,443,14,1423,2846,0,50.0,33.94
新北市,新店區,明德里,1688,1105,583,11,1699,3541,0,47.98,31.21
新北市,新店區,大豐里,1600,985,615,7,1607,3306,0,48.61,29.79
新北市,新店區,大同里,1832,1138,694,20,1852,3497,0,52.96,32.54
新北市,新店區,江陵里,2489,1625,864,18,2507,4908,0,51.08,33.11
新北市,新店區,寶興里,2528,1602,926,28,2556,4879,0,52.39,32.83
新北市,新店區,寶安里,2455,1631,824,28,2483,4940,0,50.26,33.02
新北市,新店區,信義里,2995,1766,1229,22,3017,6086,0,49.57,29.02
新北市,新店區,忠孝里,1075,738,337,8,1083,2525,0,42.89,29.23
新北市,新店區,大鵬里,1412,1160,252,13,1425,2477,0,57.53,46.83
新北市,新店區,太平里,1277,842,435,11,1288,2805,0,45.92,30.02
新北市,新店區,頂城里,576,343,233,7,583,1541,0,37.83,22.26
新北市,新店區,下城里,1277,648,629,11,1288,2878,0,44.75,22.52
新北市,新店區,柴埕里,3373,2064,1309,23,3396,8098,0,41.94,25.49
新北市,新店區,永安里,1993,1120,873,10,2003,4606,0,43.49,24.32
新北市,新店區,公崙里,4955,3063,1892,41,4996,11616,0,43.01,26.37
新北市,新店區,德安里,2216,1226,990,22,2238,5492,0,40.75,22.32
新北市,新店區,雙城里,2111,1166,945,22,2133,5146,0,41.45,22.66
新北市,新店區,日興里,1986,1040,946,14,2000,5288,0,37.82,19.67
新北市,新店區,玫瑰里,2369,1533,836,14,2383,5383,0,44.27,28.48
新北市,新店區,塗潭里,379,98,281,3,382,928,0,41.16,10.56
新北市,新店區,美潭里,2081,1273,808,17,2098,4705,0,44.59,27.06
新北市,新店區,員潭里,1971,1200,771,15,1986,4714,0,42.13,25.46
新北市,新店區,雙坑里,249,97,152,6,255,726,0,35.12,13.36
新北市,新店區,粗坑里,1384,712,672,14,1398,2813,0,49.7,25.31
新北市,新店區,屈尺里,942,460,482,9,951,2253,0,42.21,20.42
新北市,新店區,龜山里,634,295,339,6,640,1598,0,40.05,18.46
新北市,新店區,廣興里,494,178,316,10,504,1264,0,39.87,14.08
新北市,新店區,直潭里,512,197,315,4,516,1196,0,43.14,16.47
新北市,新店區,青潭里,2061,1213,848,20,2081,4825,0,43.13,25.14
新北市,新店區,新店里,754,385,369,6,760,1629,0,46.65,23.63
新北市,新店區,張南里,1077,666,411,6,1083,2137,0,50.68,31.17
新北市,新店區,國校里,1023,600,423,14,1037,2320,0,44.7,25.86
新北市,新店區,文中里,731,481,250,9,740,1575,0,46.98,30.54
新北市,新店區,廣明里,413,193,220,4,417,782,0,53.32,24.68
新北市,新店區,文明里,1132,613,519,5,1137,2230,0,50.99,27.49
新北市,新店區,中興里,2408,1614,794,17,2425,6858,0,35.36,23.53
新北市,新店區,新生里,2619,1705,914,29,2648,5204,0,50.88,32.76
新北市,新店區,新德里,1085,642,443,7,1092,2418,0,45.16,26.55
新北市,新店區,張北里,3680,2426,1254,32,3712,8055,0,46.08,30.12
新北市,新店區,五峯里,3336,2135,1201,21,3357,6910,0,48.58,30.9
新北市,新店區,新安里,1748,1183,565,15,1763,3647,0,48.34,32.44
新北市,新店區,忠誠里,1157,747,410,2,1159,2185,0,53.04,34.19
新北市,新店區,中正里,2620,1712,908,25,2645,5458,0,48.46,31.37
新北市,新店區,中華里,1876,1299,577,16,1892,3832,0,49.37,33.9
新北市,新店區,仁愛里,925,624,301,10,935,1791,0,52.21,34.84
新北市,新店區,百忍里,1644,1104,540,18,1662,3376,0,49.23,32.7
新北市,新店區,百和里,1413,886,527,7,1420,2847,0,49.88,31.12
新北市,新店區,福德里,1567,983,584,21,1588,3469,0,45.78,28.34
新北市,新店區,百福里,1682,1094,588,11,1693,3294,0,51.4,33.21
新北市,新店區,福民里,1839,1326,513,9,1848,3726,0,49.6,35.59
新北市,新店區,中山里,2324,1643,681,19,2343,4191,0,55.91,39.2
新北市,新店區,和平里,550,353,197,12,562,1240,0,45.32,28.47
新北市,新店區,中央里,2871,1919,952,17,2888,5278,0,54.72,36.36
新北市,新店區,明城里,1471,1007,464,3,1474,3130,0,47.09,32.17
新北市,新店區,安和里,3095,1846,1249,29,3124,7029,0,44.44,26.26
新北市,新店區,吉祥里,2023,1402,621,27,2050,4302,0,47.65,32.59
新北市,新店區,寶福里,3227,2070,1157,21,3248,6458,0,50.29,32.05
新北市,新店區,小城里,1657,1100,557,16,1673,3305,0,50.62,33.28
新北市,新店區,香坡里,4469,3029,1440,37,4506,10096,0,44.63,30.0
新北市,新店區,建國里,1384,953,431,14,1398,2786,0,50.18,34.21
新北市,新店區,復興里,1194,737,457,8,1202,2930,0,41.02,25.15
新北市,新店區,美城里,1135,692,443,13,1148,2466,0,46.55,28.06
新北市,新店區,安昌里,2255,1422,833,24,2279,4853,0,46.96,29.3
新北市,新店區,長春里,1224,795,429,11,1235,2304,0,53.6,34.51
新北市,新店區,新和里,1656,1071,585,16,1672,3718,0,44.97,28.81
新北市,新店區,永平里,2183,1281,902,23,2206,4949,0,44.57,25.88
新北市,新店區,達觀里,1668,1205,463,11,1679,3614,0,46.46,33.34
新北市,新店區,華城里,1303,812,491,16,1319,2551,0,51.71,31.83
新北市,新店區,合計,122741,77239,45502,1049,123790,265823,301768,46.57,29.06
新北市,樹林區,三多里,1390,556,834,11,1401,3594,0,38.98,15.47
新北市,樹林區,三福里,1336,647,689,17,1353,3437,0,39.37,18.82
新北市,樹林區,三興里,1566,686,880,14,1580,4203,0,37.59,16.32
新北市,樹林區,圳安里,1330,522,808,14,1344,3354,0,40.07,15.56
新北市,樹林區,保安里,2357,1061,1296,17,2374,5473,0,43.38,19.39
新北市,樹林區,潭底里,1552,669,883,12,1564,4463,0,35.04,14.99
新北市,樹林區,獇寮里,1545,591,954,16,1561,4406,0,35.43,13.41
新北市,樹林區,樹德里,1491,731,760,10,1501,3190,0,47.05,22.92
新北市,樹林區,樹西里,2100,1007,1093,13,2113,4496,0,47.0,22.4
新北市,樹林區,樹南里,1629,731,898,7,1636,3699,0,44.23,19.76
新北市,樹林區,樹人里,1220,631,589,8,1228,2937,0,41.81,21.48
新北市,樹林區,坡內里,588,231,357,3,591,1506,0,39.24,15.34
新北市,樹林區,樹東里,445,222,223,1,446,1073,0,41.57,20.69
新北市,樹林區,大同里,1312,654,658,11,1323,3130,0,42.27,20.89
新北市,樹林區,和平里,1339,556,783,15,1354,3345,0,40.48,16.62
新北市,樹林區,彭厝里,1555,624,931,12,1567,4373,0,35.83,14.27
新北市,樹林區,彭福里,1820,815,1005,13,1833,4657,0,39.36,17.5
新北市,樹林區,東山里,1099,484,615,13,1112,2876,0,38.66,16.83
新北市,樹林區,東陽里,1991,920,1071,9,2000,5229,0,38.25,17.59
新北市,樹林區,東昇里,1766,775,991,24,1790,4435,0,40.36,17.47
新北市,樹林區,樂山里,628,284,344,6,634,1769,0,35.84,16.05
新北市,樹林區,東園里,603,186,417,2,605,1494,0,40.5,12.45
新北市,樹林區,西園里,635,230,405,12,647,1602,0,40.39,14.36
新北市,樹林區,南園里,5260,2932,2328,34,5294,12321,0,42.97,23.8
新北市,樹林區,北園里,788,265,523,8,796,1967,0,40.47,13.47
新北市,樹林區,柑園里,3496,1922,1574,25,3521,8030,0,43.85,23.94
新北市,樹林區,樹北里,429,207,222,1,430,853,0,50.41,24.27
新北市,樹林區,圳福里,1535,717,818,8,1543,3833,0,40.26,18.71
新北市,樹林區,樹興里,1328,628,700,12,1340,3184,0,42.09,19.72
新北市,樹林區,樹福里,1500,703,797,22,1522,3145,0,48.39,22.35
新北市,樹林區,光興里,1359,578,781,9,1368,3600,0,38.0,16.06
新北市,樹林區,金寮里,1467,621,846,19,1486,3906,0,38.04,15.9
新北市,樹林區,彭興里,1825,758,1067,10,1835,5086,0,36.08,14.9
新北市,樹林區,文林里,1833,846,987,28,1861,4401,0,42.29,19.22
新北市,樹林區,山佳里,1878,828,1050,13,1891,5096,0,37.11,16.25
新北市,樹林區,中山里,1838,794,1044,19,1857,4640,0,40.02,17.11
新北市,樹林區,育英里,1249,596,653,9,1258,2790,0,45.09,21.36
新北市,樹林區,中華里,1108,541,567,9,1117,3019,0,37.0,17.92
新北市,樹林區,太順里,860,382,478,4,864,2412,0,35.82,15.84
新北市,樹林區,圳民里,1033,490,543,11,1044,2578,0,40.5,19.01
新北市,樹林區,圳生里,612,201,411,2,614,1430,0,42.94,14.06
新北市,樹林區,三龍里,820,336,484,5,825,1875,0,44.0,17.92
新北市,樹林區,合計,61515,28158,33357,508,62023,152907,182668,40.56,18.42
新北市,鶯歌區,東鶯里,442,198,244,4,446,946,0,47.15,20.93
新北市,鶯歌區,西鶯里,864,421,443,3,867,1968,0,44.05,21.39
新北市,鶯歌區,南鶯里,2135,971,1164,14,2149,4997,0,43.01,19.43
新北市,鶯歌區,北鶯里,1478,782,696,17,1495,3748,0,39.89,20.86
新北市,鶯歌區,中鶯里,465,210,255,3,468,940,0,49.79,22.34
新北市,鶯歌區,建德里,241,106,135,0,241,518,0,46.53,20.46
新北市,鶯歌區,同慶里,637,271,366,1,638,1386,0,46.03,19.55
新北市,鶯歌區,永昌里,2837,1330,1507,27,2864,7317,0,39.14,18.18
新北市,鶯歌區,南靖里,1318,551,767,11,1329,3154,0,42.14,17.47
新北市,鶯歌區,尖山里,2945,1342,1603,26,2971,7755,0,38.31,17.3
新北市,鶯歌區,二橋里,2662,1197,1465,17,2679,7334,0,36.53,16.32
新北市,鶯歌區,二甲里,378,167,211,3,381,836,0,45.57,19.98
新北市,鶯歌區,東湖里,150,59,91,0,150,250,0,60.0,23.6
新北市,鶯歌區,大湖里,1874,917,957,16,1890,4527,0,41.75,20.26
新北市,鶯歌區,鳳鳴里,1749,830,919,23,1772,4996,0,35.47,16.61
新北市,鶯歌區,鳳福里,1475,691,784,12,1487,3896,0,38.17,17.74
新北市,鶯歌區,永吉里,1709,854,855,19,1728,4275,0,40.42,19.98
新北市,鶯歌區,中湖里,1825,881,944,15,1840,5088,0,36.16,17.32
新北市,鶯歌區,鳳祥里,1448,630,818,12,1460,3878,0,37.65,16.25
新北市,鶯歌區,建國里,2311,1023,1288,16,2327,6172,0,37.7,16.57
新北市,鶯歌區,合計,28943,13431,15512,239,29182,73981,88131,39.45,18.15
新北市,三峽區,三峽里,161,68,93,3,164,285,0,57.54,23.86
新北市,三峽區,秀川里,228,104,124,2,230,575,0,40.0,18.09
新北市,三峽區,八張里,1355,679,676,10,1365,3542,0,38.54,19.17
新北市,三峽區,中埔里,1064,574,490,10,1074,3013,0,35.65,19.05
新北市,三峽區,弘道里,366,125,241,2,368,1027,0,35.83,12.17
新北市,三峽區,永舘里,2546,1166,1380,29,2575,6463,0,39.84,18.04
新北市,三峽區,礁溪里,1922,959,963,12,1934,5237,0,36.93,18.31
新北市,三峽區,鳶山里,3067,1473,1594,34,3101,8816,0,35.17,16.71
新北市,三峽區,龍埔里,3089,1601,1488,40,3129,8410,0,37.21,19.04
新北市,三峽區,大埔里,1348,722,626,9,1357,3676,0,36.92,19.64
新北市,三峽區,嘉添里,843,454,389,9,852,2111,0,40.36,21.51
新北市,三峽區,添福里,379,154,225,7,386,1045,0,36.94,14.74
新北市,三峽區,金圳里,176,71,105,4,180,486,0,37.04,14.61
新北市,三峽區,五寮里,232,116,116,4,236,794,0,29.72,14.61
新北市,三峽區,插角里,279,92,187,3,282,632,0,44.62,14.56
新北市,三峽區,有木里,216,75,141,2,218,683,0,31.92,10.98
新北市,三峽區,溪北里,872,363,509,7,879,2123,0,41.4,17.1
新北市,三峽區,溪南里,587,242,345,7,594,1375,0,43.2,17.6
新北市,三峽區,溪東里,986,467,519,10,996,2733,0,36.44,17.09
新北市,三峽區,成福里,396,150,246,4,400,860,0,46.51,17.44
新北市,三峽區,安坑里,449,157,292,8,457,1294,0,35.32,12.13
新北市,三峽區,竹崙里,643,249,394,1,644,1870,0,34.44,13.32
新北市,三峽區,介壽里,2006,895,1111,11,2017,6055,0,33.31,14.78
新北市,三峽區,安溪里,2323,1176,1147,22,2345,6654,0,35.24,17.67
新北市,三峽區,中正里,1585,730,855,14,1599,4616,0,34.64,15.81
新北市,三峽區,二鬮里,1205,663,542,9,1214,3228,0,37.61,20.54
新北市,三峽區,龍學里,5483,3252,2231,33,5516,12581,0,43.84,25.85
新北市,三峽區,龍恩里,2403,1382,1021,16,2419,5980,0,40.45,23.11
新北市,三峽區,合計,36209,18159,18050,322,36531,96164,116549,37.99,18.88
新北市,淡水區,中和里,194,68,126,3,197,557,0,35.37,12.21
新北市,淡水區,屯山里,321,123,198,6,327,994,0,32.9,12.37
新北市,淡水區,賢孝里,476,227,249,8,484,1447,0,33.45,15.69
新北市,淡水區,興仁里,568,262,306,6,574,1510,0,38.01,17.35
新北市,淡水區,蕃薯里,342,174,168,0,342,973,0,35.15,17.88
新北市,淡水區,義山里,805,397,408,8,813,2422,0,33.57,16.39
新北市,淡水區,忠山里,323,163,160,7,330,803,0,41.1,20.3
新北市,淡水區,崁頂里,6104,3545,2559,39,6143,17538,0,35.03,20.21
新北市,淡水區,埤島里,580,279,301,3,583,1616,0,36.08,17.26
新北市,淡水區,新興里,2532,1404,1128,15,2547,6573,0,38.75,21.36
新北市,淡水區,水碓里,1981,950,1031,23,2004,5098,0,39.31,18.63
新北市,淡水區,北投里,3658,2061,1597,28,3686,9067,0,40.65,22.73
新北市,淡水區,水源里,742,284,458,9,751,1974,0,38.04,14.39
新北市,淡水區,忠寮里,404,150,254,2,406,1054,0,38.52,14.23
新北市,淡水區,樹興里,543,262,281,11,554,1361,0,40.71,19.25
新北市,淡水區,坪頂里,541,268,273,7,548,1263,0,43.39,21.22
新北市,淡水區,福德里,3084,1767,1317,26,3110,6369,0,48.83,27.74
新北市,淡水區,竹圍里,2571,1392,1179,19,2590,5639,0,45.93,24.69
新北市,淡水區,民生里,2763,1443,1320,10,2773,6465,0,42.89,22.32
新北市,淡水區,八勢里,2574,1418,1156,20,2594,6014,0,43.13,23.58
新北市,淡水區,竿蓁里,4073,2340,1733,29,4102,10029,0,40.9,23.33
新北市,淡水區,鄧公里,2298,1257,1041,15,2313,5542,0,41.74,22.68
新北市,淡水區,中興里,1392,672,720,20,1412,3650,0,38.68,18.41
新北市,淡水區,長庚里,611,285,326,6,617,1326,0,46.53,21.49
新北市,淡水區,清文里,418,182,236,7,425,1068,0,39.79,17.04
新北市,淡水區,草東里,306,126,180,4,310,682,0,45.45,18.48
新北市,淡水區,協元里,518,245,273,4,522,1339,0,38.98,18.3
新北市,淡水區,永吉里,398,186,212,2,400,804,0,49.75,23.13
新北市,淡水區,民安里,317,142,175,6,323,624,0,51.76,22.76
新北市,淡水區,新生里,185,89,96,1,186,396,0,46.97,22.47
新北市,淡水區,文化里,669,372,297,3,672,1587,0,42.34,23.44
新北市,淡水區,油車里,2042,1124,918,20,2062,4932,0,41.81,22.79
新北市,淡水區,沙崙里,1590,857,733,9,1599,4158,0,38.46,20.61
新北市,淡水區,新義里,1353,610,743,10,1363,3658,0,37.26,16.68
新北市,淡水區,新春里,2936,1526,1410,24,2960,7974,0,37.12,19.14
新北市,淡水區,新民里,1764,917,847,10,1774,4269,0,41.56,21.48
新北市,淡水區,正德里,1644,936,708,12,1656,4169,0,39.72,22.45
新北市,淡水區,北新里,961,520,441,5,966,2486,0,38.86,20.92
新北市,淡水區,民權里,1925,974,951,16,1941,4221,0,45.98,23.08
新北市,淡水區,幸福里,1414,695,719,14,1428,3477,0,41.07,19.99
新北市,淡水區,學府里,1573,866,707,11,1584,4251,0,37.26,20.37
新北市,淡水區,大庄里,3821,2222,1599,28,3849,9198,0,41.85,24.16
新北市,淡水區,合計,63314,33780,29534,506,63820,158577,184450,40.25,21.3
新北市,汐止區,義民里,529,289,240,3,532,1238,0,42.97,23.34
新北市,汐止區,禮門里,449,204,245,3,452,980,0,46.12,20.82
新北市,汐止區,智慧里,1864,1092,772,16,1880,4239,0,44.35,25.76
新北市,汐止區,信望里,146,71,75,1,147,320,0,45.94,22.19
新北市,汐止區,橋東里,1246,661,585,8,1254,2889,0,43.41,22.88
新北市,汐止區,秀峰里,1409,702,707,17,1426,4888,0,29.17,14.36
新北市,汐止區,新昌里,1962,1015,947,11,1973,4758,0,41.47,21.33
新北市,汐止區,復興里,3167,1811,1356,24,3191,6286,0,50.76,28.81
新北市,汐止區,茄苳里,1375,688,687,16,1391,3956,0,35.16,17.39
新北市,汐止區,長安里,633,291,342,6,639,1489,0,42.91,19.54
新北市,汐止區,保安里,544,274,270,7,551,1494,0,36.88,18.34
新北市,汐止區,保長里,1665,821,844,23,1688,4194,0,40.25,19.58
新北市,汐止區,鄉長里,934,441,493,6,940,2101,0,44.74,20.99
新北市,汐止區,江北里,2113,1093,1020,17,2130,5478,0,38.88,19.95
新北市,汐止區,拱北里,1598,850,748,10,1608,4648,0,34.6,18.29
新北市,汐止區,烘內里,625,329,296,8,633,1479,0,42.8,22.24
新北市,汐止區,八連里,339,145,194,3,342,921,0,37.13,15.74
新北市,汐止區,樟樹里,768,373,395,8,776,1990,0,38.99,18.74
新北市,汐止區,北峰里,1721,805,916,14,1735,4527,0,38.33,17.78
新北市,汐止區,北山里,2415,1288,1127,15,2430,5282,0,46.01,24.38
新北市,汐止區,白雲里,1597,849,748,20,1617,3974,0,40.69,21.36
新北市,汐止區,橫科里,1828,989,839,22,1850,4272,0,43.31,23.15
新北市,汐止區,東山里,216,106,110,2,218,542,0,40.22,19.56
新北市,汐止區,福山里,1548,865,683,12,1560,3388,0,46.04,25.53
新北市,汐止區,宜興里,1320,809,511,18,1338,2728,0,49.05,29.66
新北市,汐止區,中興里,2727,1387,1340,25,2752,7130,0,38.6,19.45
新北市,汐止區,湖光里,2476,1451,1025,24,2500,5589,0,44.73,25.96
新北市,汐止區,仁德里,738,404,334,9,747,1675,0,44.6,24.12
新北市,汐止區,厚德里,2447,1378,1069,13,2460,6767,0,36.35,20.36
新北市,汐止區,忠孝里,2942,1661,1281,15,2957,7500,0,39.43,22.15
新北市,汐止區,自強里,2149,1165,984,16,2165,5118,0,42.3,22.76
新北市,汐止區,文化里,1726,912,814,13,1739,4130,0,42.11,22.08
新北市,汐止區,金龍里,1931,1010,921,21,1952,4841,0,40.32,20.86
新北市,汐止區,福德里,1132,580,552,11,1143,2985,0,38.29,19.43
新北市,汐止區,興福里,1270,717,553,5,1275,2904,0,43.9,24.69
新北市,汐止區,康福里,1873,992,881,13,1886,4716,0,39.99,21.03
新北市,汐止區,忠山里,1634,1043,591,15,1649,3115,0,52.94,33.48
新北市,汐止區,環河里,513,204,309,4,517,1145,0,45.15,17.82
新北市,汐止區,東勢里,2074,1189,885,18,2092,4238,0,49.36,28.06
新北市,汐止區,山光里,894,545,349,6,900,2598,0,34.64,20.98
新北市,汐止區,大同里,1086,587,499,7,1093,2552,0,42.83,23.0
新北市,汐止區,崇德里,1920,1022,898,20,1940,4444,0,43.65,23.0
新北市,汐止區,湖興里,2732,1663,1069,32,2764,6020,0,45.91,27.62
新北市,汐止區,長青里,453,266,187,8,461,872,0,52.87,30.5
新北市,汐止區,福安里,2265,1211,1054,19,2284,5639,0,40.5,21.48
新北市,汐止區,秀山里,1679,948,731,10,1689,3952,0,42.74,23.99
新北市,汐止區,建成里,2126,1248,878,18,2144,4633,0,46.28,26.94
新北市,汐止區,城中里,1846,1092,754,15,1861,4091,0,45.49,26.69
新北市,汐止區,湖蓮里,1353,889,464,14,1367,2514,0,54.38,35.36
新北市,汐止區,保新里,1030,621,409,11,1041,2680,0,38.84,23.17
新北市,汐止區,合計,75027,41046,33981,652,75679,179909,205551,42.07,22.81
新北市,瑞芳區,龍潭里,304,167,137,2,306,728,0,42.03,22.94
新北市,瑞芳區,龍興里,777,431,346,14,791,1862,0,42.48,23.15
新北市,瑞芳區,龍鎮里,464,261,203,4,468,1203,0,38.9,21.7
新北市,瑞芳區,龍川里,590,317,273,5,595,1573,0,37.83,20.15
新北市,瑞芳區,龍山里,481,294,187,4,485,1281,0,37.86,22.95
新北市,瑞芳區,龍安里,218,129,89,4,222,598,0,37.12,21.57
新北市,瑞芳區,爪峯里,1295,634,661,13,1308,3539,0,36.96,17.91
新北市,瑞芳區,柑坪里,365,157,208,6,371,1041,0,35.64,15.08
新北市,瑞芳區,東和里,567,282,285,2,569,1589,0,35.81,17.75
新北市,瑞芳區,上天里,465,241,224,7,472,1272,0,37.11,18.95
新北市,瑞芳區,吉慶里,559,313,246,7,566,1680,0,33.69,18.63
新北市,瑞芳區,吉安里,985,519,466,5,990,2918,0,33.93,17.79
新北市,瑞芳區,傑魚里,658,303,355,12,670,1891,0,35.43,16.02
新北市,瑞芳區,猴硐里,142,57,85,0,142,434,0,32.72,13.13
新北市,瑞芳區,光復里,91,35,56,3,94,241,0,39.0,14.52
新北市,瑞芳區,弓橋里,116,40,76,3,119,264,0,45.08,15.15
新北市,瑞芳區,碩仁里,73,38,35,0,73,138,0,52.9,27.54
新北市,瑞芳區,基山里,180,84,96,3,183,417,0,43.88,20.14
新北市,瑞芳區,永慶里,128,61,67,0,128,408,0,31.37,14.95
新北市,瑞芳區,崇文里,114,53,61,2,116,296,0,39.19,17.91
新北市,瑞芳區,福住里,69,41,28,2,71,164,0,43.29,25.0
新北市,瑞芳區,頌德里,119,56,63,1,120,326,0,36.81,17.18
新北市,瑞芳區,新山里,105,54,51,4,109,339,0,32.15,15.93
新北市,瑞芳區,瓜山里,74,48,26,0,74,164,0,45.12,29.27
新北市,瑞芳區,銅山里,81,41,40,1,82,186,0,44.09,22.04
新北市,瑞芳區,石山里,110,67,43,0,110,321,0,34.27,20.87
新北市,瑞芳區,濓新里,78,34,44,2,80,286,0,27.97,11.89
新北市,瑞芳區,濓洞里,167,102,65,3,170,459,0,37.04,22.22
新北市,瑞芳區,海濱里,333,199,134,5,338,1241,0,27.24,16.04
新北市,瑞芳區,瑞濱里,590,315,275,6,596,1905,0,31.29,16.54
新北市,瑞芳區,深澳里,364,220,144,3,367,1290,0,28.45,17.05
新北市,瑞芳區,南雅里,118,49,69,2,120,264,0,45.45,18.56
新北市,瑞芳區,鼻頭里,262,110,152,8,270,853,0,31.65,12.9
新北市,瑞芳區,新峰里,908,499,409,9,917,3060,0,29.97,16.31
新北市,瑞芳區,合計,11950,6251,5699,142,12092,34231,38764,35.32,18.26
新北市,土城區,埤塘里,1290,615,675,7,1297,5065,0,25.61,12.14
新北市,土城區,土城里,742,378,364,11,753,1838,0,40.97,20.57
新北市,土城區,員林里,2587,1363,1224,16,2603,6368,0,40.88,21.4
新北市,土城區,員仁里,1841,903,938,21,1862,4879,0,38.16,18.51
新北市,土城區,長風里,988,742,246,10,998,1844,0,54.12,40.24
新北市,土城區,日新里,1714,778,936,22,1736,4107,0,42.27,18.94
新北市,土城區,日和里,2376,1078,1298,17,2393,5788,0,41.34,18.62
新北市,土城區,貨饒里,1605,706,899,17,1622,3999,0,40.56,17.65
新北市,土城區,柑林里,1323,657,666,14,1337,3209,0,41.66,20.47
新北市,土城區,埤林里,3178,1601,1577,15,3193,7337,0,43.52,21.82
新北市,土城區,瑞興里,1077,429,648,8,1085,2741,0,39.58,15.65
新北市,土城區,清水里,2808,1319,1489,20,2828,7167,0,39.46,18.4
新北市,土城區,清和里,1972,891,1081,29,2001,5572,0,35.91,15.99
新北市,土城區,永豐里,1487,795,692,17,1504,3780,0,39.79,21.03
新北市,土城區,清化里,578,251,327,5,583,1455,0,40.07,17.25
新北市,土城區,清溪里,2431,1235,1196,24,2455,6034,0,40.69,20.47
新北市,土城區,峯廷里,2370,1082,1288,25,2395,6492,0,36.89,16.67
新北市,土城區,平和里,2476,1105,1371,21,2497,6188,0,40.35,17.86
新北市,土城區,廷寮里,1738,752,986,15,1753,4348,0,40.32,17.3
新北市,土城區,大安里,1854,874,980,19,1873,4345,0,43.11,20.12
新北市,土城區,永寧里,2680,1334,1346,27,2707,7273,0,37.22,18.34
新北市,土城區,沛陂里,1733,790,943,22,1755,4244,0,41.35,18.61
新北市,土城區,頂埔里,1716,846,870,27,1743,4447,0,39.19,19.02
新北市,土城區,頂福里,1796,877,919,20,1816,4672,0,38.87,18.77
新北市,土城區,頂新里,1153,726,427,9,1162,2561,0,45.37,28.35
新北市,土城區,祖田里,569,213,356,5,574,1476,0,38.89,14.43
新北市,土城區,樂利里,1835,898,937,22,1857,4491,0,41.35,20.0
新北市,土城區,廣福里,2207,1138,1069,18,2225,4980,0,44.68,22.85
新北市,土城區,學府里,1271,588,683,15,1286,3076,0,41.81,19.12
新北市,土城區,延壽里,1525,718,807,9,1534,3907,0,39.26,18.38
新北市,土城區,安和里,1821,840,981,9,1830,4353,0,42.04,19.3
新北市,土城區,青雲里,1164,563,601,14,1178,2751,0,42.82,20.47
新北市,土城區,員福里,1939,950,989,15,1954,4879,0,40.05,19.47
新北市,土城區,延吉里,1438,625,813,11,1449,3854,0,37.6,16.22
新北市,土城區,復興里,1628,791,837,14,1642,3997,0,41.08,19.79
新北市,土城區,裕生里,1981,872,1109,12,1993,4880,0,40.84,17.87
新北市,土城區,員信里,1445,738,707,6,1451,3873,0,37.46,19.05
新北市,土城區,永富里,1814,869,945,16,1830,4972,0,36.81,17.48
新北市,土城區,學成里,1292,546,746,10,1302,2895,0,44.97,18.86
新北市,土城區,延和里,2360,1123,1237,19,2379,5897,0,40.34,19.04
新北市,土城區,中正里,1216,641,575,8,1224,2851,0,42.93,22.48
新北市,土城區,學士里,1877,963,914,15,1892,4214,0,44.9,22.85
新北市,土城區,明德里,2203,1152,1051,18,2221,5145,0,43.17,22.39
新北市,土城區,廣興里,1244,622,622,10,1254,3049,0,41.13,20.4
新北市,土城區,青山里,1079,504,575,4,1083,2621,0,41.32,19.23
新北市,土城區,金城里,1994,1125,869,16,2010,5390,0,37.29,20.87
新北市,土城區,延祿里,1298,597,701,11,1309,3708,0,35.3,16.1
新北市,土城區,合計,80713,39203,41510,715,81428,203012,238020,40.11,19.31
新北市,蘆洲區,正義里,4822,2225,2597,39,4861,11581,0,41.97,19.21
新北市,蘆洲區,中原里,2048,871,1177,16,2064,5216,0,39.57,16.7
新北市,蘆洲區,中路里,1457,591,866,11,1468,3615,0,40.61,16.35
新北市,蘆洲區,光華里,1919,789,1130,14,1933,4716,0,40.99,16.73
新北市,蘆洲區,保佑里,1277,542,735,14,1291,3348,0,38.56,16.19
新北市,蘆洲區,水湳里,3648,1501,2147,33,3681,9167,0,40.15,16.37
新北市,蘆洲區,樓厝里,2459,1133,1326,18,2477,5872,0,42.18,19.29
新北市,蘆洲區,鷺江里,1940,828,1112,16,1956,4812,0,40.65,17.21
新北市,蘆洲區,恆德里,2244,1043,1201,15,2259,5571,0,40.55,18.72
新北市,蘆洲區,溪墘里,1234,473,761,8,1242,2798,0,44.39,16.9
新北市,蘆洲區,樹德里,1294,532,762,17,1311,2888,0,45.39,18.42
新北市,蘆洲區,保和里,943,402,541,9,952,2322,0,41.0,17.31
新北市,蘆洲區,仁復里,736,301,435,3,739,1885,0,39.2,15.97
新北市,蘆洲區,得勝里,1183,494,689,7,1190,2972,0,40.04,16.62
新北市,蘆洲區,南港里,1916,777,1139,22,1938,5162,0,37.54,15.05
新北市,蘆洲區,永樂里,2141,925,1216,15,2156,5439,0,39.64,17.01
新北市,蘆洲區,永康里,2247,900,1347,24,2271,5948,0,38.18,15.13
新北市,蘆洲區,信義里,1399,529,870,12,1411,3564,0,39.59,14.84
新北市,蘆洲區,玉清里,2204,967,1237,12,2216,5243,0,42.27,18.44
新北市,蘆洲區,復興里,1355,481,874,10,1365,3166,0,43.11,15.19
新北市,蘆洲區,水河里,3219,1284,1935,32,3251,8441,0,38.51,15.21
新北市,蘆洲區,仁愛里,1891,741,1150,13,1904,4663,0,40.83,15.89
新北市,蘆洲區,忠義里,1022,409,613,11,1033,2855,0,36.18,14.33
新北市,蘆洲區,九芎里,1857,785,1072,13,1870,4834,0,38.68,16.24
新北市,蘆洲區,中華里,1255,488,767,10,1265,2975,0,42.52,16.4
新北市,蘆洲區,得仁里,1231,495,736,19,1250,2688,0,46.5,18.42
新北市,蘆洲區,仁德里,1966,784,1182,17,1983,4838,0,40.99,16.21
新北市,蘆洲區,仁義里,1586,678,908,21,1607,4916,0,32.69,13.79
新北市,蘆洲區,光明里,1706,696,1010,17,1723,4262,0,40.43,16.33
新北市,蘆洲區,保新里,1324,567,757,14,1338,3431,0,39.0,16.53
新北市,蘆洲區,長安里,1621,594,1027,14,1635,4622,0,35.37,12.85
新北市,蘆洲區,民和里,1012,442,570,8,1020,2400,0,42.5,18.42
新北市,蘆洲區,忠孝里,876,303,573,5,881,2171,0,40.58,13.96
新北市,蘆洲區,福安里,1213,494,719,10,1223,2886,0,42.38,17.12
新北市,蘆洲區,永安里,1840,693,1147,15,1855,4625,0,40.11,14.98
新北市,蘆洲區,延平里,1474,565,909,20,1494,3685,0,40.54,15.33
新北市,蘆洲區,成功里,2589,1052,1537,27,2616,6695,0,39.07,15.71
新北市,蘆洲區,永德里,1414,560,854,13,1427,4010,0,35.59,13.97
新北市,蘆洲區,合計,67562,27934,39628,594,68156,170282,202131,40.03,16.4
新北市,五股區,興珍里,1739,597,1142,12,1751,4197,0,41.72,14.22
新北市,五股區,更寮里,488,126,362,4,492,1073,0,45.85,11.74
新北市,五股區,集福里,1486,592,894,10,1496,3475,0,43.05,17.04
新北市,五股區,觀音里,495,148,347,4,499,1260,0,39.6,11.75
新北市,五股區,成州里,1974,760,1214,17,1991,5457,0,36.49,13.93
新北市,五股區,成功里,2413,946,1467,16,2429,6462,0,37.59,14.64
新北市,五股區,五龍里,525,143,382,2,527,1245,0,42.33,11.49
新北市,五股區,五股里,1389,617,772,14,1403,3885,0,36.11,15.88
新北市,五股區,五福里,1240,546,694,9,1249,3097,0,40.33,17.63
新北市,五股區,德音里,1951,962,989,17,1968,4718,0,41.71,20.39
新北市,五股區,陸一里,1048,862,186,11,1059,2315,0,45.75,37.24
新北市,五股區,貿商里,1245,891,354,15,1260,2648,0,47.58,33.65
新北市,五股區,德泰里,1555,789,766,13,1568,3948,0,39.72,19.98
新北市,五股區,成德里,1112,442,670,8,1120,3009,0,37.22,14.69
新北市,五股區,六福里,1356,692,664,18,1374,3460,0,39.71,20.0
新北市,五股區,集賢里,1492,579,913,10,1502,3661,0,41.03,15.82
新北市,五股區,民義里,1303,610,693,8,1311,3192,0,41.07,19.11
新北市,五股區,成泰里,3539,1580,1959,22,3561,9533,0,37.35,16.57
新北市,五股區,水碓里,2739,1154,1585,23,2762,7004,0,39.43,16.48
新北市,五股區,福德里,1023,435,588,8,1031,3018,0,34.16,14.41
新北市,五股區,合計,30112,13471,16641,241,30353,76657,90027,39.6,17.57
新北市,泰山區,大科里,325,128,197,3,328,822,0,39.9,15.57
新北市,泰山區,黎明里,1226,601,625,6,1232,3030,0,40.66,19.83
新北市,泰山區,山腳里,2247,1075,1172,10,2257,5956,0,37.89,18.05
新北市,泰山區,福泰里,986,455,531,17,1003,2521,0,39.79,18.05
新北市,泰山區,楓樹里,1544,751,793,12,1556,3870,0,40.21,19.41
新北市,泰山區,同榮里,1510,765,745,13,1523,3617,0,42.11,21.15
新北市,泰山區,義學里,1675,764,911,7,1682,4172,0,40.32,18.31
新北市,泰山區,明志里,1449,718,731,9,1458,3385,0,43.07,21.21
新北市,泰山區,貴子里,1575,747,828,4,1579,3571,0,44.22,20.92
新北市,泰山區,貴和里,1814,866,948,18,1832,4404,0,41.6,19.66
新北市,泰山區,同興里,1376,588,788,12,1388,3234,0,42.92,18.18
新北市,泰山區,義仁里,2889,1379,1510,19,2908,7169,0,40.56,19.24
新北市,泰山區,泰友里,771,382,389,2,773,1857,0,41.63,20.57
新北市,泰山區,新明里,1148,524,624,9,1157,2868,0,40.34,18.27
新北市,泰山區,貴賢里,1533,775,758,11,1544,3300,0,46.79,23.48
新北市,泰山區,福興里,1255,636,619,14,1269,3114,0,40.75,20.42
新北市,泰山區,全興里,2928,1465,1463,25,2953,7587,0,38.92,19.31
新北市,泰山區,合計,26251,12619,13632,191,26442,64477,77862,41.01,19.57
新北市,林口區,東林里,1226,530,696,13,1239,3528,0,35.12,15.02
新北市,林口區,林口里,1732,844,888,15,1747,4811,0,36.31,17.54
新北市,林口區,西林里,3757,1966,1791,25,3782,9419,0,40.15,20.87
新北市,林口區,菁湖里,1652,739,913,16,1668,3771,0,44.23,19.6
新北市,林口區,中湖里,1552,718,834,12,1564,4170,0,37.51,17.22
新北市,林口區,湖北里,616,235,381,7,623,1384,0,45.01,16.98
新北市,林口區,湖南里,8372,4822,3550,50,8422,20700,0,40.69,23.29
新北市,林口區,南勢里,8639,4930,3709,68,8707,20299,0,42.89,24.29
新北市,林口區,東勢里,2730,1508,1222,20,2750,6489,0,42.38,23.24
新北市,林口區,頂福里,356,106,250,4,360,1010,0,35.64,10.5
新北市,林口區,下福里,447,199,248,10,457,1229,0,37.18,16.19
新北市,林口區,嘉寶里,396,144,252,5,401,911,0,44.02,15.81
新北市,林口區,瑞平里,263,101,162,0,263,763,0,34.47,13.24
新北市,林口區,太平里,463,158,305,3,466,1461,0,31.9,10.81
新北市,林口區,仁愛里,2520,1463,1057,15,2535,6006,0,42.21,24.36
新北市,林口區,麗林里,3150,1838,1312,29,3179,7589,0,41.89,24.22
新北市,林口區,麗園里,1557,805,752,16,1573,3627,0,43.37,22.19
新北市,林口區,合計,39428,21106,18322,308,39736,97167,123095,40.89,21.72
新北市,深坑區,深坑里,1327,648,679,10,1337,3097,0,43.17,20.92
新北市,深坑區,萬順里,958,475,483,6,964,2316,0,41.62,20.51
新北市,深坑區,土庫里,1145,592,553,8,1153,2749,0,41.94,21.54
新北市,深坑區,昇高里,901,501,400,9,910,1926,0,47.25,26.01
新北市,深坑區,阿柔里,236,111,125,2,238,558,0,42.65,19.89
新北市,深坑區,埔新里,2431,1349,1082,16,2447,5654,0,43.28,23.86
新北市,深坑區,萬福里,1044,527,517,7,1051,2486,0,42.28,21.2
新北市,深坑區,賴仲里,962,575,387,9,971,2115,0,45.91,27.19
新北市,深坑區,合計,9004,4778,4226,67,9071,20901,23730,43.4,22.86
新北市,石碇區,石碇里,143,55,88,0,143,365,0,39.18,15.07
新北市,石碇區,潭邊里,292,152,140,1,293,798,0,36.72,19.05
新北市,石碇區,隆盛里,237,96,141,3,240,668,0,35.93,14.37
新北市,石碇區,烏塗里,243,86,157,2,245,607,0,40.36,14.17
新北市,石碇區,彭山里,103,44,59,3,106,296,0,35.81,14.86
新北市,石碇區,豐田里,185,85,100,0,185,387,0,47.8,21.96
新北市,石碇區,永定里,200,77,123,5,205,589,0,34.8,13.07
新北市,石碇區,中民里,248,99,149,3,251,717,0,35.01,13.81
新北市,石碇區,光明里,106,34,72,1,107,261,0,41.0,13.03
新北市,石碇區,豐林里,124,62,62,0,124,302,0,41.06,20.53
新北市,石碇區,永安里,314,99,215,5,319,809,0,39.43,12.24
新北市,石碇區,格頭里,411,134,277,3,414,991,0,41.78,13.52
新北市,石碇區,合計,2606,1023,1583,26,2632,6790,7487,38.76,15.07
新北市,坪林區,粗窟里,323,145,178,4,327,853,0,38.34,17.0
新北市,坪林區,坪林里,500,204,296,2,502,1290,0,38.91,15.81
新北市,坪林區,大林里,439,134,305,5,444,1167,0,38.05,11.48
新北市,坪林區,石𥕢里,135,45,90,4,139,420,0,33.1,10.71
新北市,坪林區,上德里,280,128,152,4,284,836,0,33.97,15.31
新北市,坪林區,水德里,211,81,130,1,212,631,0,33.6,12.84
新北市,坪林區,漁光里,314,92,222,2,316,860,0,36.74,10.7
新北市,坪林區,合計,2202,829,1373,22,2224,6057,6670,36.72,13.69
新北市,三芝區,八賢里,106,31,75,1,107,311,0,34.41,9.97
新北市,三芝區,埔頭里,1555,818,737,12,1567,4787,0,32.73,17.09
新北市,三芝區,古庄里,381,201,180,3,384,1113,0,34.5,18.06
新北市,三芝區,新庄里,272,134,138,4,276,776,0,35.57,17.27
新北市,三芝區,埔坪里,1895,1018,877,25,1920,6124,0,31.35,16.62
新北市,三芝區,茂長里,277,146,131,2,279,604,0,46.19,24.17
新北市,三芝區,橫山里,158,89,69,4,162,477,0,33.96,18.66
新北市,三芝區,錫板里,281,132,149,4,285,661,0,43.12,19.97
新北市,三芝區,後厝里,774,461,313,6,780,2030,0,38.42,22.71
新北市,三芝區,福德里,298,155,143,6,304,762,0,39.9,20.34
新北市,三芝區,圓山里,153,58,95,5,158,532,0,29.7,10.9
新北市,三芝區,店子里,191,78,113,1,192,580,0,33.1,13.45
新北市,三芝區,興華里,434,174,260,7,441,1170,0,37.69,14.87
新北市,三芝區,合計,6775,3495,3280,80,6855,19927,22460,34.4,17.54
新北市,石門區,德茂里,337,152,185,5,342,1087,0,31.46,13.98
新北市,石門區,富基里,481,247,234,7,488,1316,0,37.08,18.77
新北市,石門區,老梅里,627,316,311,9,636,2052,0,30.99,15.4
新北市,石門區,山溪里,266,141,125,4,270,867,0,31.14,16.26
新北市,石門區,石門里,516,301,215,9,525,1496,0,35.09,20.12
新北市,石門區,尖鹿里,426,224,202,7,433,1452,0,29.82,15.43
新北市,石門區,乾華里,100,51,49,0,100,315,0,31.75,16.19
新北市,石門區,茂林里,194,92,102,0,194,589,0,32.94,15.62
新北市,石門區,草里里,259,140,119,2,261,915,0,28.52,15.3
新北市,石門區,合計,3206,1664,1542,43,3249,10089,11303,32.2,16.49
新北市,八里區,龍源里,2778,1374,1404,23,2801,6740,0,41.56,20.39
新北市,八里區,米倉里,1191,595,596,7,1198,3256,0,36.79,18.27
新北市,八里區,大崁里,1209,554,655,5,1214,3091,0,39.28,17.92
新北市,八里區,埤頭里,1417,648,769,9,1426,3745,0,38.08,17.3
新北市,八里區,頂罟里,779,375,404,8,787,2139,0,36.79,17.53
新北市,八里區,舊城里,2324,1062,1262,17,2341,6501,0,36.01,16.34
新北市,八里區,訊塘里,1463,697,766,15,1478,4113,0,35.93,16.95
新北市,八里區,荖阡里,562,260,302,3,565,1639,0,34.47,15.86
新北市,八里區,長坑里,510,238,272,5,515,1521,0,33.86,15.65
新北市,八里區,下罟里,494,240,254,7,501,1476,0,33.94,16.26
新北市,八里區,合計,12727,6043,6684,99,12826,34221,39799,37.48,17.66
新北市,平溪區,薯榔里,133,54,79,1,134,361,0,37.12,14.96
新北市,平溪區,菁桐里,85,51,34,0,85,226,0,37.61,22.57
新北市,平溪區,白石里,96,43,53,1,97,229,0,42.36,18.78
新北市,平溪區,石底里,159,55,104,2,161,417,0,38.61,13.19
新北市,平溪區,平溪里,102,64,38,0,102,247,0,41.3,25.91
新北市,平溪區,嶺腳里,178,85,93,2,180,586,0,30.72,14.51
新北市,平溪區,東勢里,157,76,81,3,160,406,0,39.41,18.72
新北市,平溪區,望古里,58,25,33,0,58,154,0,37.66,16.23
新北市,平溪區,南山里,120,57,63,4,124,337,0,36.8,16.91
新北市,平溪區,平湖里,72,31,41,0,72,164,0,43.9,18.9
新北市,平溪區,十分里,251,119,132,9,260,798,0,32.58,14.91
新北市,平溪區,新寮里,40,20,20,0,40,151,0,26.49,13.25
新北市,平溪區,合計,1451,680,771,22,1473,4076,4354,36.14,16.68
新北市,雙溪區,雙溪里,177,105,72,2,179,444,0,40.32,23.65
新北市,雙溪區,共和里,132,59,73,2,134,363,0,36.91,16.25
新北市,雙溪區,新基里,295,166,129,9,304,713,0,42.64,23.28
新北市,雙溪區,魚行里,230,102,128,4,234,678,0,34.51,15.04
新北市,雙溪區,三港里,122,52,70,2,124,345,0,35.94,15.07
新北市,雙溪區,牡丹里,490,225,265,12,502,1416,0,35.45,15.89
新北市,雙溪區,三貂里,107,51,56,1,108,319,0,33.86,15.99
新北市,雙溪區,平林里,332,179,153,0,332,860,0,38.6,20.81
新北市,雙溪區,上林里,203,75,128,8,211,593,0,35.58,12.65
新北市,雙溪區,外柑里,161,77,84,2,163,394,0,41.37,19.54
新北市,雙溪區,長源里,109,35,74,0,109,351,0,31.05,9.97
新北市,雙溪區,泰平里,328,159,169,8,336,1129,0,29.76,14.08
新北市,雙溪區,合計,2686,1285,1401,50,2736,7605,8307,35.98,16.9
新北市,貢寮區,貢寮里,316,138,178,4,320,823,0,38.88,16.77
新北市,貢寮區,吉林里,159,52,107,3,162,462,0,35.06,11.26
新北市,貢寮區,雙玉里,240,83,157,6,246,631,0,38.99,13.15
新北市,貢寮區,龍崗里,146,46,100,2,148,398,0,37.19,11.56
新北市,貢寮區,龍門里,279,69,210,5,284,630,0,45.08,10.95
新北市,貢寮區,福隆里,588,226,362,7,595,1599,0,37.21,14.13
新北市,貢寮區,仁里里,730,233,497,11,741,1652,0,44.85,14.1
新北市,貢寮區,真理里,732,148,584,17,749,1987,0,37.7,7.45
新北市,貢寮區,福連里,321,94,227,0,321,886,0,36.23,10.61
新北市,貢寮區,美豐里,292,95,197,7,299,716,0,41.76,13.27
新北市,貢寮區,和美里,340,84,256,1,341,981,0,34.76,8.56
新北市,貢寮區,合計,4143,1268,2875,63,4206,10765,11658,39.07,11.78
新北市,金山區,和平里,190,107,83,1,191,456,0,41.89,23.46
新北市,金山區,大同里,241,119,122,5,246,712,0,34.55,16.71
新北市,金山區,豐漁里,193,82,111,2,195,502,0,38.84,16.33
新北市,金山區,磺港里,624,210,414,6,630,1719,0,36.65,12.22
新北市,金山區,美田里,1306,633,673,14,1320,3777,0,34.95,16.76
新北市,金山區,五湖里,602,296,306,3,605,1641,0,36.87,18.04
新北市,金山區,重和里,403,162,241,3,406,1182,0,34.35,13.71
新北市,金山區,兩湖里,121,57,64,2,123,377,0,32.63,15.12
新北市,金山區,六股里,239,89,150,5,244,643,0,37.95,13.84
新北市,金山區,三界里,234,94,140,3,237,619,0,38.29,15.19
新北市,金山區,清泉里,252,111,141,2,254,801,0,31.71,13.86
新北市,金山區,萬壽里,164,54,110,2,166,443,0,37.47,12.19
新北市,金山區,西湖里,72,31,41,1,73,177,0,41.24,17.51
新北市,金山區,永興里,177,70,107,5,182,570,0,31.93,12.28
新北市,金山區,金美里,1693,780,913,13,1706,4954,0,34.44,15.74
新北市,金山區,合計,6511,2895,3616,67,6578,18573,20926,35.42,15.59
新北市,萬里區,萬里里,1475,753,722,10,1485,4232,0,35.09,17.79
新北市,萬里區,龜吼里,764,385,379,5,769,2548,0,30.18,15.11
新北市,萬里區,野柳里,1021,474,547,10,1031,3153,0,32.7,15.03
新北市,萬里區,大鵬里,949,477,472,10,959,2681,0,35.77,17.79
新北市,萬里區,磺潭里,183,91,92,2,185,574,0,32.23,15.85
新北市,萬里區,雙興里,323,128,195,7,330,966,0,34.16,13.25
新北市,萬里區,溪底里,201,71,130,3,204,659,0,30.96,10.77
新北市,萬里區,崁脚里,147,50,97,1,148,403,0,36.72,12.41
新北市,萬里區,中幅里,355,170,185,4,359,1107,0,32.43,15.36
新北市,萬里區,北基里,926,498,428,6,932,2751,0,33.88,18.1
新北市,萬里區,合計,6344,3097,3247,58,6402,19074,21542,33.56,16.24
新北市,烏來區,烏來里,779,478,301,7,786,2348,0,33.48,20.36
新北市,烏來區,忠治里,534,331,203,4,538,1572,0,34.22,21.06
新北市,烏來區,福山里,153,119,34,5,158,606,0,26.07,19.64
新北市,烏來區,信賢里,156,73,83,1,157,504,0,31.15,14.48
新北市,烏來區,孝義里,67,26,41,1,68,231,0,29.44,11.26
新北市,烏來區,合計,1689,1027,662,18,1707,5261,6343,32.45,19.52
新北市,合計,合計,1444060,730469,713591,12291,1456351,3427162,4021398,42.49,21.31
桃園市,桃園區,文化里,484,236,248,3,487,1024,0,47.56,23.05
桃園市,桃園區,文明里,688,339,349,7,695,1396,0,49.79,24.28
桃園市,桃園區,武陵里,623,298,325,4,627,1628,0,38.51,18.3
桃園市,桃園區,大林里,2537,1212,1325,22,2559,6940,0,36.87,17.46
桃園市,桃園區,忠義里,1367,757,610,10,1377,3581,0,38.45,21.14
桃園市,桃園區,會稽里,3772,2182,1590,24,3796,9791,0,38.77,22.29
桃園市,桃園區,長美里,467,162,305,4,471,1005,0,46.87,16.12
桃園市,桃園區,民生里,682,338,344,4,686,1649,0,41.6,20.5
桃園市,桃園區,永興里,744,310,434,8,752,1820,0,41.32,17.03
桃園市,桃園區,汴洲里,2595,1161,1434,20,2615,6542,0,39.97,17.75
桃園市,桃園區,永安里,2063,856,1207,23,2086,4520,0,46.15,18.94
桃園市,桃園區,東埔里,1876,841,1035,15,1891,4602,0,41.09,18.27
桃園市,桃園區,東門里,1361,708,653,7,1368,3019,0,45.31,23.45
桃園市,桃園區,東山里,809,368,441,8,817,1896,0,43.09,19.41
桃園市,桃園區,萬壽里,391,144,247,3,394,924,0,42.64,15.58
桃園市,桃園區,長安里,1485,642,843,8,1493,3527,0,42.33,18.2
桃園市,桃園區,中埔里,976,370,606,10,986,2382,0,41.39,15.53
桃園市,桃園區,西埔里,1333,531,802,12,1345,3082,0,43.64,17.23
桃園市,桃園區,西門里,640,303,337,4,644,1626,0,39.61,18.63
桃園市,桃園區,中和里,615,258,357,7,622,1307,0,47.59,19.74
桃園市,桃園區,文昌里,379,142,237,5,384,778,0,49.36,18.25
桃園市,桃園區,新埔里,4192,2323,1869,42,4234,9814,0,43.14,23.67
桃園市,桃園區,中山里,2880,1561,1319,17,2897,6789,0,42.67,22.99
桃園市,桃園區,慈文里,2450,1225,1225,15,2465,6329,0,38.95,19.36
桃園市,桃園區,西湖里,634,320,314,4,638,1430,0,44.62,22.38
桃園市,桃園區,南門里,2470,1253,1217,30,2500,5908,0,42.32,21.21
桃園市,桃園區,南華里,609,237,372,6,615,1365,0,45.05,17.36
桃園市,桃園區,玉山里,2063,960,1103,17,2080,4880,0,42.62,19.67
桃園市,桃園區,中成里,2260,1103,1157,17,2277,5722,0,39.79,19.28
桃園市,桃園區,中正里,2879,1519,1360,12,2891,6550,0,44.14,23.19
桃園市,桃園區,北門里,730,302,428,3,733,1710,0,42.87,17.66
桃園市,桃園區,雲林里,2630,1335,1295,20,2650,6053,0,43.78,22.06
桃園市,桃園區,福林里,2646,1336,1310,24,2670,5943,0,44.93,22.48
桃園市,桃園區,光興里,2135,938,1197,15,2150,4548,0,47.27,20.62
桃園市,桃園區,龍山里,1290,689,601,14,1304,3479,0,37.48,19.8
桃園市,桃園區,龍岡里,2321,1334,987,24,2345,5803,0,40.41,22.99
桃園市,桃園區,成功里,1801,963,838,18,1819,3846,0,47.3,25.04
桃園市,桃園區,青溪里,1833,790,1043,14,1847,4213,0,43.84,18.75
桃園市,桃園區,朝陽里,894,396,498,10,904,1970,0,45.89,20.1
桃園市,桃園區,中興里,2463,1115,1348,13,2476,5681,0,43.58,19.63
桃園市,桃園區,豐林里,2834,1409,1425,16,2850,6243,0,45.65,22.57
桃園市,桃園區,建國里,2209,1130,1079,36,2245,5129,0,43.77,22.03
桃園市,桃園區,大豐里,2042,968,1074,15,2057,4911,0,41.89,19.71
桃園市,桃園區,福安里,1756,874,882,10,1766,4122,0,42.84,21.2
桃園市,桃園區,三民里,1966,1158,808,16,1982,4162,0,47.62,27.82
桃園市,桃園區,大興里,1992,921,1071,10,2002,5398,0,37.09,17.06
桃園市,桃園區,春日里,2247,1096,1151,17,2264,6093,0,37.16,17.99
桃園市,桃園區,信光里,2777,1309,1468,20,2797,6914,0,40.45,18.93
桃園市,桃園區,中寧里,2414,1334,1080,12,2426,6089,0,39.84,21.91
桃園市,桃園區,同安里,3890,2004,1886,20,3910,9540,0,40.99,21.01
桃園市,桃園區,莊敬里,3711,2158,1553,18,3729,8779,0,42.48,24.58
桃園市,桃園區,文中里,1765,867,898,13,1778,3991,0,44.55,21.72
桃園市,桃園區,泰山里,1636,849,787,18,1654,3653,0,45.28,23.24
桃園市,桃園區,中路里,1607,845,762,13,1620,3883,0,41.72,21.76
桃園市,桃園區,中德里,2670,1388,1282,27,2697,6452,0,41.8,21.51
桃園市,桃園區,龍祥里,1822,1093,729,15,1837,4939,0,37.19,22.13
桃園市,桃園區,大有里,2395,1392,1003,19,2414,6433,0,37.53,21.64
桃園市,桃園區,寶山里,3161,1720,1441,18,3179,8491,0,37.44,20.26
桃園市,桃園區,龍鳳里,2982,1618,1364,18,3000,9776,0,30.69,16.55
桃園市,桃園區,龍安里,2099,1129,970,18,2117,5408,0,39.15,20.88
桃園市,桃園區,自強里,3229,1750,1479,27,3256,7355,0,44.27,23.79
桃園市,桃園區,中信里,2212,1148,1064,14,2226,5612,0,39.67,20.46
桃園市,桃園區,長德里,2194,1046,1148,16,2210,4931,0,44.82,21.21
桃園市,桃園區,中平里,1958,1064,894,14,1972,4612,0,42.76,23.07
桃園市,桃園區,中原里,2024,1144,880,9,2033,4570,0,44.49,25.03
桃園市,桃園區,中泰里,1825,1074,751,17,1842,4145,0,44.44,25.91
桃園市,桃園區,南埔里,2105,1044,1061,13,2118,4872,0,43.47,21.43
桃園市,桃園區,寶慶里,2567,1423,1144,18,2585,6169,0,41.9,23.07
桃園市,桃園區,北埔里,1917,1064,853,13,1930,4734,0,40.77,22.48
桃園市,桃園區,中聖里,2317,1405,912,13,2330,5481,0,42.51,25.63
桃園市,桃園區,龍壽里,2474,1258,1216,15,2489,6540,0,38.06,19.24
桃園市,桃園區,同德里,2589,1475,1114,15,2604,6061,0,42.96,24.34
桃園市,桃園區,明德里,1446,790,656,12,1458,3179,0,45.86,24.85
桃園市,桃園區,寶安里,3093,1696,1397,26,3119,8113,0,38.44,20.9
桃園市,桃園區,瑞慶里,2262,1189,1073,14,2276,5936,0,38.34,20.03
桃園市,桃園區,三元里,1532,820,712,12,1544,3791,0,40.73,21.63
桃園市,桃園區,大樹里,1492,736,756,11,1503,3881,0,38.73,18.96
桃園市,桃園區,大業里,2000,1090,910,17,2017,5006,0,40.29,21.77
桃園市,桃園區,福元里,1831,1026,805,8,1839,4546,0,40.45,22.57
桃園市,桃園區,合計,154109,79361,74748,1156,155265,375012,458824,41.4,21.16
桃園市,中壢區,龍平里,1287,982,305,11,1298,2898,0,44.79,33.89
桃園市,中壢區,龍昌里,2252,1454,798,16,2268,5428,0,41.78,26.79
桃園市,中壢區,仁德里,1278,818,460,15,1293,3064,0,42.2,26.7
桃園市,中壢區,永興里,394,206,188,2,396,914,0,43.33,22.54
桃園市,中壢區,內壢里,913,576,337,11,924,2196,0,42.08,26.23
桃園市,中壢區,成功里,1744,1026,718,16,1760,4380,0,40.18,23.42
桃園市,中壢區,光明里,2387,1398,989,18,2405,5320,0,45.21,26.28
桃園市,中壢區,自立里,2330,1921,409,29,2359,5087,0,46.37,37.76
桃園市,中壢區,自強里,1528,1019,509,12,1540,3497,0,44.04,29.14
桃園市,中壢區,中堅里,1506,1001,505,12,1518,3778,0,40.18,26.5
桃園市,中壢區,龍興里,1785,1016,769,18,1803,4305,0,41.88,23.6
桃園市,中壢區,仁美里,2208,1371,837,12,2220,5566,0,39.89,24.63
桃園市,中壢區,仁愛里,1294,744,550,7,1301,3006,0,43.28,24.75
桃園市,中壢區,新街里,981,524,457,7,988,2310,0,42.77,22.68
桃園市,中壢區,中央里,1638,873,765,9,1647,3407,0,48.34,25.62
桃園市,中壢區,普仁里,1619,941,678,11,1630,4240,0,38.44,22.19
桃園市,中壢區,普義里,1736,1026,710,12,1748,5599,0,31.22,18.32
桃園市,中壢區,忠義里,1574,869,705,13,1587,3943,0,40.25,22.04
桃園市,中壢區,中正里,1981,1257,724,17,1998,5241,0,38.12,23.98
桃園市,中壢區,興仁里,1280,757,523,6,1286,3393,0,37.9,22.31
桃園市,中壢區,東興里,1484,790,694,11,1495,3315,0,45.1,23.83
桃園市,中壢區,洽溪里,2811,1434,1377,17,2828,6960,0,40.63,20.6
桃園市,中壢區,篤行里,1003,601,402,7,1010,2660,0,37.97,22.59
桃園市,中壢區,新明里,1583,753,830,10,1593,3765,0,42.31,20.0
桃園市,中壢區,新興里,1549,848,701,7,1556,3646,0,42.68,23.26
桃園市,中壢區,中原里,1561,850,711,7,1568,3654,0,42.91,23.26
桃園市,中壢區,內定里,2450,1105,1345,20,2470,6882,0,35.89,16.06
桃園市,中壢區,中壢里,294,156,138,1,295,674,0,43.77,23.15
桃園市,中壢區,龍岡里,1998,1298,700,22,2020,4607,0,43.85,28.17
桃園市,中壢區,仁祥里,1063,703,360,7,1070,2813,0,38.04,24.99
桃園市,中壢區,水尾里,1502,726,776,13,1515,3634,0,41.69,19.98
桃園市,中壢區,青埔里,2628,1376,1252,17,2645,6486,0,40.78,21.21
桃園市,中壢區,復興里,3481,1962,1519,28,3509,9665,0,36.31,20.3
桃園市,中壢區,文化里,3400,1832,1568,21,3421,8837,0,38.71,20.73
桃園市,中壢區,興國里,855,402,453,8,863,1888,0,45.71,21.29
桃園市,中壢區,忠福里,3161,1711,1450,27,3188,7822,0,40.76,21.87
桃園市,中壢區,信義里,1982,1141,841,9,1991,4334,0,45.94,26.33
桃園市,中壢區,石頭里,703,344,359,4,707,1585,0,44.61,21.7
桃園市,中壢區,龍東里,2059,1564,495,24,2083,4952,0,42.06,31.58
桃園市,中壢區,中建里,450,205,245,1,451,991,0,45.51,20.69
桃園市,中壢區,興南里,1277,734,543,15,1292,3012,0,42.9,24.37
桃園市,中壢區,後寮里,1829,1040,789,18,1847,4849,0,38.09,21.45
桃園市,中壢區,過嶺里,3016,1496,1520,21,3037,7935,0,38.27,18.85
桃園市,中壢區,五權里,2546,1308,1238,34,2580,6137,0,42.04,21.31
桃園市,中壢區,舊明里,705,319,386,8,713,1460,0,48.84,21.85
桃園市,中壢區,芝芭里,1712,743,969,13,1725,4196,0,41.11,17.71
桃園市,中壢區,月眉里,2099,752,1347,21,2120,5631,0,37.65,13.35
桃園市,中壢區,三民里,1268,554,714,8,1276,3254,0,39.21,17.03
桃園市,中壢區,山東里,1470,493,977,18,1488,3746,0,39.72,13.16
桃園市,中壢區,中榮里,382,180,202,4,386,827,0,46.67,21.77
桃園市,中壢區,內厝里,2043,866,1177,16,2059,4787,0,43.01,18.09
桃園市,中壢區,振興里,2105,1252,853,14,2119,4813,0,44.03,26.01
桃園市,中壢區,普慶里,1148,680,468,6,1154,2583,0,44.68,26.33
桃園市,中壢區,興和里,1223,566,657,10,1233,2700,0,45.67,20.96
桃園市,中壢區,永光里,2220,1135,1085,14,2234,5435,0,41.1,20.88
桃園市,中壢區,復華里,2228,1249,979,17,2245,5563,0,40.36,22.45
桃園市,中壢區,忠孝里,1867,1102,765,20,1887,4591,0,41.1,24.0
桃園市,中壢區,福德里,1213,713,500,10,1223,2834,0,43.15,25.16
桃園市,中壢區,和平里,1003,554,449,6,1009,2525,0,39.96,21.94
桃園市,中壢區,普忠里,1449,825,624,11,1460,3252,0,44.9,25.37
桃園市,中壢區,普強里,1690,1048,642,8,1698,3683,0,46.1,28.46
桃園市,中壢區,明德里,2037,1134,903,8,2045,4693,0,43.58,24.16
桃園市,中壢區,至善里,1425,974,451,9,1434,3713,0,38.62,26.23
桃園市,中壢區,五福里,1488,726,762,13,1501,3620,0,41.46,20.06
桃園市,中壢區,龍德里,1775,1107,668,12,1787,4104,0,43.54,26.97
桃園市,中壢區,正義里,1913,1052,861,13,1926,4282,0,44.98,24.57
桃園市,中壢區,龍安里,1012,784,228,8,1020,2050,0,49.76,38.24
桃園市,中壢區,中山里,1832,1188,644,14,1846,4761,0,38.77,24.95
桃園市,中壢區,德義里,1132,634,498,8,1140,2501,0,45.58,25.35
桃園市,中壢區,仁義里,1595,868,727,14,1609,3783,0,42.53,22.94
桃園市,中壢區,華勛里,1485,1043,442,11,1496,3965,0,37.73,26.31
桃園市,中壢區,仁福里,1843,1218,625,15,1858,4804,0,38.68,25.35
桃園市,中壢區,幸福里,2447,1330,1117,18,2465,6095,0,40.44,21.82
桃園市,中壢區,永福里,2431,1260,1171,15,2446,5469,0,44.72,23.04
桃園市,中壢區,仁和里,1390,858,532,10,1400,3582,0,39.08,23.95
桃園市,中壢區,華愛里,1359,883,476,12,1371,3555,0,38.57,24.84
桃園市,中壢區,莊敬里,1623,1259,364,17,1640,3413,0,48.05,36.89
桃園市,中壢區,自治里,1655,1243,412,12,1667,3620,0,46.05,34.34
桃園市,中壢區,健行里,1911,1138,773,14,1925,4454,0,43.22,25.55
桃園市,中壢區,興平里,1149,529,620,6,1155,2395,0,48.23,22.09
桃園市,中壢區,中興里,1353,874,479,9,1362,3376,0,40.34,25.89
桃園市,中壢區,龍慈里,2015,1333,682,7,2022,4787,0,42.24,27.85
桃園市,中壢區,自信里,2301,1475,826,10,2311,5590,0,41.34,26.39
桃園市,中壢區,林森里,1703,1005,698,10,1713,3821,0,44.83,26.3
桃園市,中壢區,金華里,2076,1322,754,16,2092,4035,0,51.85,32.76
桃園市,中壢區,合計,143175,82426,60749,1088,144263,347023,422582,41.57,23.75
桃園市,大溪區,興和里,673,251,422,3,676,1435,0,47.11,17.49
桃園市,大溪區,福仁里,452,145,307,5,457,963,0,47.46,15.06
桃園市,大溪區,一心里,1823,817,1006,11,1834,4760,0,38.53,17.16
桃園市,大溪區,一德里,1999,762,1237,24,2023,5582,0,36.24,13.65
桃園市,大溪區,月眉里,475,142,333,9,484,1237,0,39.13,11.48
桃園市,大溪區,永福里,432,120,312,4,436,964,0,45.23,12.45
桃園市,大溪區,美華里,1240,440,800,5,1245,3069,0,40.57,14.34
桃園市,大溪區,福安里,895,296,599,12,907,2222,0,40.82,13.32
桃園市,大溪區,復興里,348,120,228,5,353,859,0,41.09,13.97
桃園市,大溪區,新峰里,305,111,194,4,309,808,0,38.24,13.74
桃園市,大溪區,康安里,578,166,412,9,587,1300,0,45.15,12.77
桃園市,大溪區,義和里,722,261,461,9,731,1752,0,41.72,14.9
桃園市,大溪區,瑞興里,1002,393,609,11,1013,2714,0,37.32,14.48
桃園市,大溪區,中新里,674,235,439,6,680,1519,0,44.77,15.47
桃園市,大溪區,仁義里,1059,756,303,19,1078,2831,0,38.08,26.7
桃園市,大溪區,僑愛里,1094,908,186,4,1098,2488,0,44.13,36.5
桃園市,大溪區,仁善里,1780,902,878,13,1793,4490,0,39.93,20.09
桃園市,大溪區,仁愛里,1951,971,980,17,1968,5178,0,38.01,18.75
桃園市,大溪區,仁武里,1268,706,562,9,1277,3244,0,39.36,21.76
桃園市,大溪區,員林里,600,301,299,3,603,1577,0,38.24,19.09
桃園市,大溪區,南興里,1784,792,992,23,1807,5101,0,35.42,15.53
桃園市,大溪區,瑞源里,1449,628,821,10,1459,3734,0,39.07,16.82
桃園市,大溪區,光明里,919,587,332,22,941,2437,0,38.61,24.09
桃園市,大溪區,三元里,1195,803,392,18,1213,3012,0,40.27,26.66
桃園市,大溪區,田心里,1848,713,1135,17,1865,4436,0,42.04,16.07
桃園市,大溪區,仁文里,1472,817,655,15,1487,3897,0,38.16,20.96
桃園市,大溪區,仁和里,1818,950,868,15,1833,4772,0,38.41,19.91
桃園市,大溪區,仁美里,1240,699,541,15,1255,3309,0,37.93,21.12
桃園市,大溪區,合計,31095,14792,16303,317,31412,79690,95240,39.42,18.56
桃園市,楊梅區,楊梅里,1576,938,638,8,1584,3845,0,41.2,24.4
桃園市,楊梅區,楊江里,469,278,191,5,474,1054,0,44.97,26.38
桃園市,楊梅區,紅梅里,1092,662,430,8,1100,2595,0,42.39,25.51
桃園市,楊梅區,永寧里,2464,1408,1056,18,2482,7481,0,33.18,18.82
桃園市,楊梅區,大平里,1134,710,424,10,1144,3148,0,36.34,22.55
桃園市,楊梅區,東流里,992,459,533,3,995,2934,0,33.91,15.64
桃園市,楊梅區,水美里,1602,855,747,18,1620,4097,0,39.54,20.87
桃園市,楊梅區,上田里,972,462,510,10,982,2632,0,37.31,17.55
桃園市,楊梅區,梅新里,796,475,321,6,802,1933,0,41.49,24.57
桃園市,楊梅區,大同里,1430,874,556,14,1444,3487,0,41.41,25.06
桃園市,楊梅區,埔心里,659,331,328,11,670,1355,0,49.45,24.43
桃園市,楊梅區,金龍里,562,401,161,11,573,1396,0,41.05,28.72
桃園市,楊梅區,瑞塘里,2153,1160,993,18,2171,5757,0,37.71,20.15
桃園市,楊梅區,四維里,1901,1069,832,16,1917,4609,0,41.59,23.19
桃園市,楊梅區,梅溪里,1459,872,587,12,1471,4143,0,35.51,21.05
桃園市,楊梅區,高山里,1251,775,476,9,1260,3760,0,33.51,20.61
桃園市,楊梅區,高榮里,1374,658,716,13,1387,3518,0,39.43,18.7
桃園市,楊梅區,仁美里,1651,972,679,17,1668,3818,0,43.69,25.46
桃園市,楊梅區,光華里,1306,820,486,16,1322,3153,0,41.93,26.01
桃園市,楊梅區,富岡里,698,384,314,5,703,1787,0,39.34,21.49
桃園市,楊梅區,豐野里,1459,795,664,8,1467,3873,0,37.88,20.53
桃園市,楊梅區,員本里,1052,554,498,18,1070,2859,0,37.43,19.38
桃園市,楊梅區,瑞原里,1184,664,520,25,1209,3757,0,32.18,17.67
桃園市,楊梅區,三湖里,971,495,476,6,977,2794,0,34.97,17.72
桃園市,楊梅區,上湖里,1954,1123,831,14,1968,5853,0,33.62,19.19
桃園市,楊梅區,中山里,1210,715,495,5,1215,2986,0,40.69,23.95
桃園市,楊梅區,楊明里,2752,1586,1166,13,2765,7742,0,35.71,20.49
桃園市,楊梅區,金溪里,1647,1037,610,15,1662,4048,0,41.06,25.62
桃園市,楊梅區,裕成里,1473,914,559,17,1490,3286,0,45.34,27.81
桃園市,楊梅區,秀才里,1326,668,658,18,1344,3311,0,40.59,20.18
桃園市,楊梅區,青山里,1435,864,571,6,1441,4482,0,32.15,19.28
桃園市,楊梅區,新榮里,1421,754,667,13,1434,3453,0,41.53,21.84
桃園市,楊梅區,雙榮里,1420,759,661,9,1429,3233,0,44.2,23.48
桃園市,楊梅區,瑞坪里,2093,1275,818,11,2104,5934,0,35.46,21.49
桃園市,楊梅區,永平里,741,445,296,8,749,1966,0,38.1,22.63
桃園市,楊梅區,瑞溪里,1183,719,464,10,1193,3639,0,32.78,19.76
桃園市,楊梅區,高上里,969,502,467,10,979,2766,0,35.39,18.15
桃園市,楊梅區,富豐里,1024,530,494,9,1033,3030,0,34.09,17.49
桃園市,楊梅區,裕新里,850,524,326,5,855,2486,0,34.39,21.08
桃園市,楊梅區,三民里,1198,713,485,3,1201,3449,0,34.82,20.67
桃園市,楊梅區,頭湖里,1022,555,467,8,1030,2900,0,35.52,19.14
桃園市,楊梅區,合計,53925,30754,23171,459,54384,144349,176189,37.68,21.31
桃園市,蘆竹區,新興里,1249,432,817,9,1258,2950,0,42.64,14.64
桃園市,蘆竹區,中福里,1655,597,1058,13,1668,4062,0,41.06,14.7
桃園市,蘆竹區,新莊里,1992,842,1150,18,2010,5043,0,39.86,16.7
桃園市,蘆竹區,大竹里,1924,939,985,26,1950,4969,0,39.24,18.9
桃園市,蘆竹區,蘆竹里,1576,533,1043,12,1588,4036,0,39.35,13.21
桃園市,蘆竹區,南崁里,1535,744,791,14,1549,3675,0,42.15,20.24
桃園市,蘆竹區,錦興里,1612,728,884,8,1620,3906,0,41.47,18.64
桃園市,蘆竹區,五福里,1023,539,484,3,1026,2425,0,42.31,22.23
桃園市,蘆竹區,內厝里,917,337,580,8,925,2595,0,35.65,12.99
桃園市,蘆竹區,山鼻里,597,250,347,6,603,1778,0,33.91,14.06
桃園市,蘆竹區,山腳里,1311,452,859,16,1327,3579,0,37.08,12.63
桃園市,蘆竹區,外社里,619,151,468,11,630,1486,0,42.4,10.16
桃園市,蘆竹區,坑子里,616,173,443,8,624,1673,0,37.3,10.34
桃園市,蘆竹區,坑口里,977,353,624,8,985,2501,0,39.38,14.11
桃園市,蘆竹區,海湖里,926,455,471,13,939,2969,0,31.63,15.33
桃園市,蘆竹區,南榮里,1525,727,798,16,1541,3532,0,43.63,20.58
桃園市,蘆竹區,南興里,2188,1205,983,14,2202,5162,0,42.66,23.34
桃園市,蘆竹區,長興里,859,392,467,10,869,2582,0,33.66,15.18
桃園市,蘆竹區,錦中里,1327,619,708,7,1334,3128,0,42.65,19.79
桃園市,蘆竹區,富竹里,578,145,433,3,581,1327,0,43.78,10.93
桃園市,蘆竹區,上竹里,1430,647,783,10,1440,3516,0,40.96,18.4
桃園市,蘆竹區,宏竹里,1162,467,695,17,1179,2982,0,39.54,15.66
桃園市,蘆竹區,瓦窯里,1276,725,551,14,1290,3360,0,38.39,21.58
桃園市,蘆竹區,營盤里,1938,1022,916,17,1955,4886,0,40.01,20.92
桃園市,蘆竹區,羊稠里,1915,986,929,13,1928,4459,0,43.24,22.11
桃園市,蘆竹區,順興里,1520,777,743,4,1524,3985,0,38.24,19.5
桃園市,蘆竹區,福昌里,1966,1123,843,7,1973,5062,0,38.98,22.18
桃園市,蘆竹區,福興里,1354,713,641,5,1359,3442,0,39.48,20.71
桃園市,蘆竹區,蘆興里,591,280,311,9,600,1633,0,36.74,17.15
桃園市,蘆竹區,長壽里,2343,1300,1043,17,2360,5584,0,42.26,23.28
桃園市,蘆竹區,吉祥里,1756,973,783,14,1770,3690,0,47.97,26.37
桃園市,蘆竹區,中山里,1230,666,564,6,1236,3243,0,38.11,20.54
桃園市,蘆竹區,福祿里,1172,522,650,7,1179,3227,0,36.54,16.18
桃園市,蘆竹區,興榮里,1234,665,569,6,1240,2793,0,44.4,23.81
桃園市,蘆竹區,中興里,1817,925,892,8,1825,5074,0,35.97,18.23
桃園市,蘆竹區,上興里,1372,676,696,7,1379,3380,0,40.8,20.0
桃園市,蘆竹區,營福里,1283,672,611,7,1290,3296,0,39.14,20.39
桃園市,蘆竹區,正興里,1511,715,796,9,1520,4443,0,34.21,16.09
桃園市,蘆竹區,濱海里,762,328,434,10,772,2532,0,30.49,12.95
桃園市,蘆竹區,合計,52638,24795,27843,410,53048,133965,166690,39.6,18.51
桃園市,大園區,大園里,2342,1047,1295,16,2358,6107,0,38.61,17.14
桃園市,大園區,田心里,2513,1089,1424,24,2537,6972,0,36.39,15.62
桃園市,大園區,溪海里,1474,621,853,16,1490,4705,0,31.67,13.2
桃園市,大園區,和平里,642,231,411,4,646,1612,0,40.07,14.33
桃園市,大園區,橫峰里,4571,2236,2335,34,4605,11610,0,39.66,19.26
桃園市,大園區,五權里,1980,706,1274,18,1998,5222,0,38.26,13.52
桃園市,大園區,埔心里,2154,910,1244,14,2168,5896,0,36.77,15.43
桃園市,大園區,大海里,650,369,281,12,662,1650,0,40.12,22.36
桃園市,大園區,三石里,1206,501,705,9,1215,2851,0,42.62,17.57
桃園市,大園區,菓林里,2485,1137,1348,30,2515,7202,0,34.92,15.79
桃園市,大園區,竹圍里,1193,565,628,7,1200,3212,0,37.36,17.59
桃園市,大園區,海口里,602,307,295,5,607,1863,0,32.58,16.48
桃園市,大園區,沙崙里,878,413,465,10,888,2595,0,34.22,15.92
桃園市,大園區,後厝里,818,386,432,4,822,2523,0,32.58,15.3
桃園市,大園區,圳頭里,949,398,551,5,954,2566,0,37.18,15.51
桃園市,大園區,內海里,753,302,451,9,762,2154,0,35.38,14.02
桃園市,大園區,北港里,957,366,591,13,970,2912,0,33.31,12.57
桃園市,大園區,南港里,1734,846,888,12,1746,5701,0,30.63,14.84
桃園市,大園區,合計,27901,12430,15471,242,28143,77353,93663,36.38,16.07
桃園市,龜山區,楓樹里,1705,752,953,6,1711,3984,0,42.95,18.88
桃園市,龜山區,龜山里,2585,1286,1299,20,2605,6579,0,39.6,19.55
桃園市,龜山區,兔坑里,1559,752,807,11,1570,4492,0,34.95,16.74
桃園市,龜山區,大同里,2221,1107,1114,17,2238,5834,0,38.36,18.97
桃園市,龜山區,山福里,1264,589,675,17,1281,3262,0,39.27,18.06
桃園市,龜山區,山頂里,1960,995,965,15,1975,5439,0,36.31,18.29
桃園市,龜山區,陸光里,1775,1537,238,26,1801,3606,0,49.94,42.62
桃園市,龜山區,精忠里,2153,1439,714,30,2183,5179,0,42.15,27.79
桃園市,龜山區,公西里,627,291,336,6,633,1298,0,48.77,22.42
桃園市,龜山區,樂善里,1926,889,1037,10,1936,5523,0,35.05,16.1
桃園市,龜山區,南上里,791,325,466,9,800,1874,0,42.69,17.34
桃園市,龜山區,大坑里,729,300,429,3,732,1975,0,37.06,15.19
桃園市,龜山區,中興里,1798,898,900,14,1812,4708,0,38.49,19.07
桃園市,龜山區,山德里,1978,931,1047,22,2000,4790,0,41.75,19.44
桃園市,龜山區,新路里,2290,1093,1197,24,2314,5265,0,43.95,20.76
桃園市,龜山區,嶺頂里,1513,684,829,13,1526,4034,0,37.83,16.96
桃園市,龜山區,龍壽里,694,225,469,3,697,1760,0,39.6,12.78
桃園市,龜山區,舊路里,1146,558,588,15,1161,2636,0,44.04,21.17
桃園市,龜山區,大崗里,1405,679,726,11,1416,4111,0,34.44,16.52
桃園市,龜山區,文化里,2733,1364,1369,19,2752,6959,0,39.55,19.6
桃園市,龜山區,南美里,914,431,483,4,918,2303,0,39.86,18.71
桃園市,龜山區,幸福里,1686,858,828,19,1705,5268,0,32.37,16.29
桃園市,龜山區,福源里,783,398,385,8,791,1960,0,40.36,20.31
桃園市,龜山區,龍華里,1334,595,739,16,1350,3423,0,39.44,17.38
桃園市,龜山區,迴龍里,2349,1182,1167,25,2374,6098,0,38.93,19.38
桃園市,龜山區,新嶺里,1403,688,715,14,1417,3965,0,35.74,17.35
桃園市,龜山區,大湖里,2040,1059,981,15,2055,5410,0,37.99,19.57
桃園市,龜山區,大華里,3528,1767,1761,25,3553,8945,0,39.72,19.75
桃園市,龜山區,長庚里,1769,828,941,10,1779,4161,0,42.75,19.9
桃園市,龜山區,新興里,931,594,337,11,942,3071,0,30.67,19.34
桃園市,龜山區,文青里,3130,1753,1377,23,3153,7571,0,41.65,23.15
桃園市,龜山區,楓福里,1371,726,645,10,1381,3109,0,44.42,23.35
桃園市,龜山區,合計,54090,27573,26517,471,54561,138592,165716,39.37,19.9
桃園市,八德區,興仁里,2932,1575,1357,28,2960,9275,0,31.91,16.98
桃園市,八德區,福興里,3369,1782,1587,22,3391,9960,0,34.05,17.89
桃園市,八德區,瑞豐里,1670,938,732,8,1678,4926,0,34.06,19.04
桃園市,八德區,瑞發里,1321,775,546,33,1354,3178,0,42.61,24.39
桃園市,八德區,瑞德里,1346,854,492,22,1368,3521,0,38.85,24.25
桃園市,八德區,瑞祥里,1303,880,423,18,1321,3201,0,41.27,27.49
桃園市,八德區,廣興里,1268,587,681,8,1276,3233,0,39.47,18.16
桃園市,八德區,廣隆里,1946,1057,889,19,1965,4536,0,43.32,23.3
桃園市,八德區,竹園里,1257,629,628,11,1268,3596,0,35.26,17.49
桃園市,八德區,霄裡里,823,384,439,13,836,2214,0,37.76,17.34
桃園市,八德區,茄苳里,923,404,519,8,931,2537,0,36.7,15.92
桃園市,八德區,高明里,1489,705,784,15,1504,3852,0,39.04,18.3
桃園市,八德區,白鷺里,1261,576,685,18,1279,3101,0,41.24,18.57
桃園市,八德區,大湳里,1474,665,809,9,1483,3930,0,37.74,16.92
桃園市,八德區,大安里,1371,623,748,16,1387,3486,0,39.79,17.87
桃園市,八德區,大興里,1512,781,731,10,1522,3792,0,40.14,20.6
桃園市,八德區,大和里,3010,1848,1162,27,3037,7352,0,41.31,25.14
桃園市,八德區,大同里,664,294,370,1,665,1505,0,44.19,19.53
桃園市,八德區,大成里,1425,683,742,12,1437,3312,0,43.39,20.62
桃園市,八德區,大義里,1450,821,629,16,1466,3738,0,39.22,21.96
桃園市,八德區,大忠里,713,387,326,7,720,1789,0,40.25,21.63
桃園市,八德區,大福里,2324,1229,1095,12,2336,5181,0,45.09,23.72
桃園市,八德區,大勇里,1691,838,853,11,1702,4113,0,41.38,20.37
桃園市,八德區,大信里,1274,703,571,25,1299,3515,0,36.96,20.0
桃園市,八德區,大華里,1061,584,477,9,1070,2531,0,42.28,23.07
桃園市,八德區,大仁里,1747,821,926,17,1764,4188,0,42.12,19.6
桃園市,八德區,大智里,1795,1126,669,10,1805,4256,0,42.41,26.46
桃園市,八德區,瑞泰里,1576,795,781,13,1589,4161,0,38.19,19.11
桃園市,八德區,大昌里,1185,630,555,20,1205,2848,0,42.31,22.12
桃園市,八德區,大正里,1630,890,740,14,1644,4290,0,38.32,20.75
桃園市,八德區,大強里,1342,574,768,8,1350,3074,0,43.92,18.67
桃園市,八德區,大發里,808,356,452,8,816,2030,0,40.2,17.54
桃園市,八德區,大明里,1456,676,780,15,1471,3632,0,40.5,18.61
桃園市,八德區,大竹里,606,245,361,4,610,1474,0,41.38,16.62
桃園市,八德區,大慶里,556,265,291,6,562,1414,0,39.75,18.74
桃園市,八德區,大千里,840,479,361,13,853,2222,0,38.39,21.56
桃園市,八德區,大榮里,766,386,380,9,775,1947,0,39.8,19.83
桃園市,八德區,茄明里,1774,947,827,16,1790,4778,0,37.46,19.82
桃園市,八德區,高城里,1239,656,583,5,1244,3114,0,39.95,21.07
桃園市,八德區,瑞興里,1125,515,610,8,1133,2788,0,40.64,18.47
桃園市,八德區,大愛里,1067,612,455,13,1080,2512,0,42.99,24.36
桃園市,八德區,大宏里,1789,1021,768,9,1798,4144,0,43.39,24.64
桃園市,八德區,大漢里,1539,860,679,7,1546,3923,0,39.41,21.92
桃園市,八德區,廣德里,1202,597,605,10,1212,2667,0,45.44,22.38
桃園市,八德區,龍友里,941,744,197,22,963,2166,0,44.46,34.35
桃園市,八德區,陸光里,1724,1368,356,37,1761,4338,0,40.59,31.54
桃園市,八德區,永豐里,1062,498,564,14,1076,2762,0,38.96,18.03
桃園市,八德區,大順里,1013,543,470,7,1020,2525,0,40.4,21.5
桃園市,八德區,合計,67659,36206,31453,663,68322,172627,209448,39.58,20.97
桃園市,龍潭區,黃唐里,1696,966,730,8,1704,4655,0,36.61,20.75
桃園市,龍潭區,中山里,2293,1323,970,22,2315,5884,0,39.34,22.48
桃園市,龍潭區,烏林里,1492,871,621,10,1502,4416,0,34.01,19.72
桃園市,龍潭區,高平里,1196,594,602,8,1204,3205,0,37.57,18.53
桃園市,龍潭區,凌雲里,1323,751,572,11,1334,3744,0,35.63,20.06
桃園市,龍潭區,八德里,1580,866,714,9,1589,4226,0,37.6,20.49
桃園市,龍潭區,三水里,280,94,186,3,283,652,0,43.4,14.42
桃園市,龍潭區,上林里,1721,939,782,6,1727,4406,0,39.2,21.31
桃園市,龍潭區,中正里,2152,1393,759,11,2163,5430,0,39.83,25.65
桃園市,龍潭區,龍潭里,837,423,414,4,841,1835,0,45.83,23.05
桃園市,龍潭區,高原里,1620,863,757,23,1643,4539,0,36.2,19.01
桃園市,龍潭區,九龍里,1438,848,590,13,1451,3741,0,38.79,22.67
桃園市,龍潭區,中興里,1566,976,590,18,1584,4232,0,37.43,23.06
桃園市,龍潭區,佳安里,1564,1066,498,19,1583,3420,0,46.29,31.17
桃園市,龍潭區,三和里,1185,739,446,9,1194,2574,0,46.39,28.71
桃園市,龍潭區,三坑里,606,275,331,8,614,1466,0,41.88,18.76
桃園市,龍潭區,大平里,1034,572,462,6,1040,2332,0,44.6,24.53
桃園市,龍潭區,三林里,1448,931,517,12,1460,3072,0,47.53,30.31
桃園市,龍潭區,永興里,1072,588,484,19,1091,2825,0,38.62,20.81
桃園市,龍潭區,烏樹林里,1010,522,488,9,1019,2613,0,39.0,19.98
桃園市,龍潭區,百年里,1967,1401,566,12,1979,4262,0,46.43,32.87
桃園市,龍潭區,龍祥里,1278,781,497,14,1292,3487,0,37.05,22.4
桃園市,龍潭區,聖德里,1139,582,557,6,1145,2995,0,38.23,19.43
桃園市,龍潭區,龍星里,1827,1075,752,24,1851,4094,0,45.21,26.26
桃園市,龍潭區,上華里,1387,912,475,12,1399,3238,0,43.21,28.17
桃園市,龍潭區,武漢里,552,340,212,10,562,1491,0,37.69,22.8
桃園市,龍潭區,東興里,1471,1021,450,14,1485,3992,0,37.2,25.58
桃園市,龍潭區,北興里,772,485,287,9,781,2314,0,33.75,20.96
桃園市,龍潭區,建林里,1783,1255,528,10,1793,3664,0,48.94,34.25
桃園市,龍潭區,富林里,1442,977,465,11,1453,3448,0,42.14,28.34
桃園市,龍潭區,祥和里,483,233,250,5,488,1583,0,30.83,14.72
桃園市,龍潭區,合計,41214,24662,16552,355,41569,103835,124481,40.03,23.75
桃園市,平鎮區,雙連里,1808,968,840,16,1824,4741,0,38.47,20.42
桃園市,平鎮區,高雙里,1901,910,991,18,1919,4288,0,44.75,21.22
桃園市,平鎮區,復旦里,2291,1366,925,11,2302,5412,0,42.54,25.24
桃園市,平鎮區,廣興里,2515,1344,1171,16,2531,5467,0,46.3,24.58
桃園市,平鎮區,義民里,2054,1165,889,13,2067,5228,0,39.54,22.28
桃園市,平鎮區,宋屋里,1670,893,777,15,1685,4332,0,38.9,20.61
桃園市,平鎮區,新勢里,1581,833,748,14,1595,3659,0,43.59,22.77
桃園市,平鎮區,新富里,2371,1360,1011,19,2390,6520,0,36.66,20.86
桃園市,平鎮區,北勢里,1162,595,567,8,1170,2424,0,48.27,24.55
桃園市,平鎮區,北興里,1576,803,773,12,1588,3911,0,40.6,20.53
桃園市,平鎮區,北貴里,1703,883,820,10,1713,3974,0,43.11,22.22
桃園市,平鎮區,平鎮里,1671,851,820,17,1688,4457,0,37.87,19.09
桃園市,平鎮區,南勢里,2263,1217,1046,16,2279,5771,0,39.49,21.09
桃園市,平鎮區,莊敬里,1894,1187,707,29,1923,4674,0,41.14,25.4
桃園市,平鎮區,山峰里,908,569,339,7,915,2330,0,39.27,24.42
桃園市,平鎮區,湧光里,2113,1198,915,23,2136,5189,0,41.16,23.09
桃園市,平鎮區,龍恩里,1116,726,390,13,1129,2791,0,40.45,26.01
桃園市,平鎮區,東社里,1306,860,446,10,1316,3322,0,39.61,25.89
桃園市,平鎮區,龍興里,1069,787,282,13,1082,2548,0,42.46,30.89
桃園市,平鎮區,貿易里,921,625,296,7,928,1945,0,47.71,32.13
桃園市,平鎮區,忠貞里,602,438,164,3,605,1318,0,45.9,33.23
桃園市,平鎮區,中正里,701,542,159,12,713,1650,0,43.21,32.85
桃園市,平鎮區,建安里,1720,892,828,17,1737,4292,0,40.47,20.78
桃園市,平鎮區,東勢里,2059,973,1086,15,2074,5410,0,38.34,17.99
桃園市,平鎮區,東安里,1015,670,345,8,1023,2812,0,36.38,23.83
桃園市,平鎮區,新安里,1592,956,636,24,1616,4358,0,37.08,21.94
桃園市,平鎮區,鎮興里,1205,575,630,10,1215,3084,0,39.4,18.64
桃園市,平鎮區,義興里,2959,1531,1428,16,2975,6850,0,43.43,22.35
桃園市,平鎮區,湧豐里,712,392,320,8,720,1755,0,41.03,22.34
桃園市,平鎮區,湧安里,1545,910,635,11,1556,4511,0,34.49,20.17
桃園市,平鎮區,廣達里,1701,841,860,17,1718,3871,0,44.38,21.73
桃園市,平鎮區,福林里,1439,757,682,10,1449,3429,0,42.26,22.08
桃園市,平鎮區,金星里,2440,1416,1024,19,2459,6586,0,37.34,21.5
桃園市,平鎮區,廣仁里,1533,813,720,8,1541,4222,0,36.5,19.26
桃園市,平鎮區,新貴里,1365,684,681,15,1380,3064,0,45.04,22.32
桃園市,平鎮區,北富里,1667,860,807,15,1682,3878,0,43.37,22.18
桃園市,平鎮區,新榮里,2251,1239,1012,17,2268,5110,0,44.38,24.25
桃園市,平鎮區,華安里,1516,995,521,20,1536,4282,0,35.87,23.24
桃園市,平鎮區,金陵里,1265,724,541,10,1275,2823,0,45.16,25.65
桃園市,平鎮區,北安里,733,350,383,3,736,1551,0,47.45,22.57
桃園市,平鎮區,北華里,1728,1032,696,8,1736,3758,0,46.19,27.46
桃園市,平鎮區,復興里,2191,1174,1017,26,2217,4904,0,45.21,23.94
桃園市,平鎮區,平興里,2185,1252,933,12,2197,5498,0,39.96,22.77
桃園市,平鎮區,新英里,1600,997,603,12,1612,3806,0,42.35,26.2
桃園市,平鎮區,平安里,2027,1069,958,20,2047,5085,0,40.26,21.02
桃園市,平鎮區,平南里,2619,1460,1159,22,2641,6707,0,39.38,21.77
桃園市,平鎮區,合計,76263,42682,33581,645,76908,187597,228672,41.0,22.75
桃園市,新屋區,新屋里,1142,585,557,6,1148,2883,0,39.82,20.29
桃園市,新屋區,新生里,1561,845,716,10,1571,3991,0,39.36,21.17
桃園市,新屋區,後湖里,538,252,286,5,543,1517,0,35.79,16.61
桃園市,新屋區,清華里,1454,748,706,6,1460,4096,0,35.64,18.26
桃園市,新屋區,頭洲里,1722,843,879,14,1736,4467,0,38.86,18.87
桃園市,新屋區,埔頂里,887,444,443,4,891,2563,0,34.76,17.32
桃園市,新屋區,九斗里,888,390,498,11,899,2292,0,39.22,17.02
桃園市,新屋區,社子里,534,225,309,6,540,1356,0,39.82,16.59
桃園市,新屋區,東明里,566,265,301,11,577,1466,0,39.36,18.08
桃園市,新屋區,石磊里,809,339,470,16,825,2076,0,39.74,16.33
桃園市,新屋區,下埔里,310,148,162,0,310,730,0,42.47,20.27
桃園市,新屋區,下田里,628,301,327,8,636,1727,0,36.83,17.43
桃園市,新屋區,石牌里,384,205,179,4,388,926,0,41.9,22.14
桃園市,新屋區,赤欄里,493,243,250,7,500,1310,0,38.17,18.55
桃園市,新屋區,永興里,417,186,231,5,422,1021,0,41.33,18.22
桃園市,新屋區,永安里,900,426,474,10,910,2201,0,41.34,19.35
桃園市,新屋區,笨港里,409,212,197,8,417,1020,0,40.88,20.78
桃園市,新屋區,深圳里,244,119,125,1,245,639,0,38.34,18.62
桃園市,新屋區,蚵間里,335,119,216,3,338,900,0,37.56,13.22
桃園市,新屋區,槺榔里,411,183,228,8,419,1072,0,39.09,17.07
桃園市,新屋區,後庄里,452,232,220,3,455,1098,0,41.44,21.13
桃園市,新屋區,大坡里,478,194,284,3,481,1294,0,37.17,14.99
桃園市,新屋區,望間里,516,211,305,2,518,1391,0,37.24,15.17
桃園市,新屋區,合計,16078,7715,8363,151,16229,42036,49237,38.61,18.35
桃園市,觀音區,觀音里,993,462,531,10,1003,2767,0,36.25,16.7
桃園市,觀音區,白玉里,373,185,188,2,375,875,0,42.86,21.14
桃園市,觀音區,廣興里,481,224,257,10,491,1310,0,37.48,17.1
桃園市,觀音區,大潭里,801,317,484,11,812,1899,0,42.76,16.69
桃園市,觀音區,武威里,377,165,212,3,380,912,0,41.67,18.09
桃園市,觀音區,保生里,813,345,468,9,822,2180,0,37.71,15.83
桃園市,觀音區,三和里,371,182,189,4,375,854,0,43.91,21.31
桃園市,觀音區,新興里,297,136,161,3,300,705,0,42.55,19.29
桃園市,觀音區,坑尾里,604,262,342,7,611,1831,0,33.37,14.31
桃園市,觀音區,金湖里,927,392,535,8,935,2633,0,35.51,14.89
桃園市,觀音區,藍埔里,1049,432,617,3,1052,2621,0,40.14,16.48
桃園市,觀音區,大同里,1199,446,753,10,1209,3116,0,38.8,14.31
桃園市,觀音區,大堀里,544,195,349,4,548,1484,0,36.93,13.14
桃園市,觀音區,崙坪里,1920,866,1054,7,1927,4757,0,40.51,18.2
桃園市,觀音區,富源里,1483,729,754,9,1492,3918,0,38.08,18.61
桃園市,觀音區,上大里,969,421,548,13,982,2458,0,39.95,17.13
桃園市,觀音區,新坡里,1132,446,686,6,1138,2971,0,38.3,15.01
桃園市,觀音區,廣福里,921,358,563,9,930,2482,0,37.47,14.42
桃園市,觀音區,塔腳里,338,142,196,7,345,1021,0,33.79,13.91
桃園市,觀音區,保障里,777,235,542,7,784,1950,0,40.21,12.05
桃園市,觀音區,草漯里,984,384,600,9,993,2935,0,33.83,13.08
桃園市,觀音區,樹林里,1235,563,672,19,1254,4468,0,28.07,12.6
桃園市,觀音區,富林里,651,277,374,7,658,1926,0,34.16,14.38
桃園市,觀音區,草新里,1884,884,1000,16,1900,5720,0,33.22,15.45
桃園市,觀音區,合計,21123,9048,12075,193,21316,57793,69326,36.88,15.66
桃園市,復興區,三民里,666,355,311,15,681,2041,0,33.37,17.39
桃園市,復興區,澤仁里,434,305,129,5,439,1426,0,30.79,21.39
桃園市,復興區,義盛里,218,181,37,5,223,745,0,29.93,24.3
桃園市,復興區,霞雲里,163,133,30,2,165,631,0,26.15,21.08
桃園市,復興區,長興里,155,117,38,5,160,660,0,24.24,17.73
桃園市,復興區,三光里,129,110,19,1,130,683,0,19.03,16.11
桃園市,復興區,奎輝里,205,167,38,1,206,764,0,26.96,21.86
桃園市,復興區,華陵里,288,165,123,2,290,1265,0,22.92,13.04
桃園市,復興區,羅浮里,334,246,88,3,337,1067,0,31.58,23.06
桃園市,復興區,高義里,123,91,32,0,123,754,0,16.31,12.07
桃園市,復興區,合計,2715,1870,845,39,2754,10036,12391,27.44,18.63
桃園市,合計,合計,741985,394314,347671,6189,748174,1869908,2272459,40.01,21.09
臺中市,中區,繼光里,641,268,373,5,646,1436,0,44.99,18.66
臺中市,中區,大墩里,825,385,440,3,828,1946,0,42.55,19.78
臺中市,中區,綠川里,680,300,380,7,687,1572,0,43.7,19.08
臺中市,中區,公園里,574,270,304,9,583,1353,0,43.09,19.96
臺中市,中區,光復里,842,406,436,10,852,1913,0,44.54,21.22
臺中市,中區,柳川里,705,333,372,9,714,1884,0,37.9,17.68
臺中市,中區,大誠里,993,465,528,10,1003,2244,0,44.7,20.72
臺中市,中區,中華里,762,398,364,6,768,1847,0,41.58,21.55
臺中市,中區,合計,6022,2825,3197,59,6081,14195,17930,42.84,19.9
臺中市,東區,新庄里,1167,514,653,9,1176,2974,0,39.54,17.28
臺中市,東區,振興里,1426,570,856,17,1443,3053,0,47.26,18.67
臺中市,東區,東橋里,1696,654,1042,20,1716,3732,0,45.98,17.52
臺中市,東區,東興里,1244,537,707,14,1258,2791,0,45.07,19.24
臺中市,東區,干城里,915,429,486,7,922,1889,0,48.81,22.71
臺中市,東區,泉源里,923,422,501,12,935,2030,0,46.06,20.79
臺中市,東區,旱溪里,1176,526,650,13,1189,2499,0,47.58,21.05
臺中市,東區,樂成里,966,403,563,8,974,2244,0,43.4,17.96
臺中市,東區,東門里,3030,1268,1762,33,3063,6693,0,45.76,18.95
臺中市,東區,十甲里,2089,1023,1066,15,2104,4732,0,44.46,21.62
臺中市,東區,東南里,1651,881,770,9,1660,3682,0,45.08,23.93
臺中市,東區,東勢里,1078,554,524,11,1089,2651,0,41.08,20.9
臺中市,東區,合作里,1674,1067,607,14,1688,3985,0,42.36,26.78
臺中市,東區,富台里,762,495,267,5,767,1703,0,45.04,29.07
臺中市,東區,富仁里,1839,1245,594,17,1856,4044,0,45.9,30.79
臺中市,東區,東信里,3993,1749,2244,42,4035,8763,0,46.05,19.96
臺中市,東區,東英里,3211,1477,1734,18,3229,7152,0,45.15,20.65
臺中市,東區,合計,28840,13814,15026,264,29104,64617,75468,45.04,21.38
臺中市,南區,城隍里,1606,743,863,14,1620,3502,0,46.26,21.22
臺中市,南區,國光里,1679,780,899,16,1695,3745,0,45.26,20.83
臺中市,南區,南門里,1626,782,844,14,1640,3412,0,48.07,22.92
臺中市,南區,德義里,1343,688,655,18,1361,2840,0,47.92,24.23
臺中市,南區,積善里,1148,514,634,9,1157,2506,0,46.17,20.51
臺中市,南區,江川里,1330,692,638,12,1342,2714,0,49.45,25.5
臺中市,南區,新榮里,1904,1049,855,11,1915,4415,0,43.37,23.76
臺中市,南區,福興里,1824,903,921,7,1831,3817,0,47.97,23.66
臺中市,南區,福平里,2312,1128,1184,21,2333,5297,0,44.04,21.3
臺中市,南區,和平里,1557,770,787,11,1568,4091,0,38.33,18.82
臺中市,南區,永興里,3522,1876,1646,17,3539,7871,0,44.96,23.83
臺中市,南區,樹義里,5061,2544,2517,27,5088,11718,0,43.42,21.71
臺中市,南區,樹德里,3757,2022,1735,29,3786,8372,0,45.22,24.15
臺中市,南區,西川里,1909,1020,889,14,1923,4215,0,45.62,24.2
臺中市,南區,長春里,896,435,461,9,905,1865,0,48.53,23.32
臺中市,南區,長榮里,1163,554,609,11,1174,2394,0,49.04,23.14
臺中市,南區,福順里,2417,1250,1167,19,2436,5566,0,43.77,22.46
臺中市,南區,平和里,1505,688,817,17,1522,3459,0,44.0,19.89
臺中市,南區,南和里,2982,1626,1356,21,3003,7374,0,40.72,22.05
臺中市,南區,永和里,1949,999,950,13,1962,4610,0,42.56,21.67
臺中市,南區,工學里,2851,1516,1335,15,2866,6608,0,43.37,22.94
臺中市,南區,崇倫里,2445,1233,1212,20,2465,5361,0,45.98,23.0
臺中市,南區,合計,46786,23812,22974,345,47131,105752,126574,44.57,22.52
臺中市,西區,民生里,799,409,390,8,807,1694,0,47.64,24.14
臺中市,西區,利民里,624,365,259,6,630,1340,0,47.01,27.24
臺中市,西區,三民里,803,426,377,3,806,2306,0,34.95,18.47
臺中市,西區,東昇里,1101,577,524,6,1107,2250,0,49.2,25.64
臺中市,西區,廣民里,608,303,305,5,613,1370,0,44.74,22.12
臺中市,西區,平和里,809,438,371,4,813,1840,0,44.18,23.8
臺中市,西區,公民里,2244,1099,1145,23,2267,4767,0,47.56,23.05
臺中市,西區,藍興里,1843,946,897,22,1865,3884,0,48.02,24.36
臺中市,西區,公舘里,2516,1214,1302,17,2533,5582,0,45.38,21.75
臺中市,西區,和龍里,988,440,548,9,997,2244,0,44.43,19.61
臺中市,西區,民龍里,1510,809,701,16,1526,3397,0,44.92,23.82
臺中市,西區,後龍里,1490,712,778,10,1500,3447,0,43.52,20.66
臺中市,西區,安龍里,1370,692,678,14,1384,2776,0,49.86,24.93
臺中市,西區,吉龍里,2962,1559,1403,21,2983,6405,0,46.57,24.34
臺中市,西區,昇平里,2512,1219,1293,15,2527,5634,0,44.85,21.64
臺中市,西區,忠明里,2679,1309,1370,20,2699,5653,0,47.74,23.16
臺中市,西區,公正里,2918,1484,1434,24,2942,6172,0,47.67,24.04
臺中市,西區,土庫里,2572,1220,1352,18,2590,5619,0,46.09,21.71
臺中市,西區,忠誠里,2479,1224,1255,18,2497,5548,0,45.01,22.06
臺中市,西區,公益里,1259,565,694,15,1274,2725,0,46.75,20.73
臺中市,西區,中興里,1718,754,964,8,1726,3518,0,49.06,21.43
臺中市,西區,公平里,2121,1148,973,12,2133,4905,0,43.49,23.4
臺中市,西區,公德里,1872,961,911,11,1883,4170,0,45.16,23.05
臺中市,西區,双龍里,1237,664,573,13,1250,2712,0,46.09,24.48
臺中市,西區,大忠里,2122,1115,1007,21,2143,4315,0,49.66,25.84
臺中市,西區,合計,43156,21652,21504,339,43495,94273,113744,46.14,22.97
臺中市,北區,光大里,840,386,454,11,851,2049,0,41.53,18.84
臺中市,北區,文莊里,1624,1018,606,14,1638,3331,0,49.17,30.56
臺中市,北區,五常里,563,232,331,6,569,1343,0,42.37,17.27
臺中市,北區,新興里,617,358,259,4,621,1453,0,42.74,24.64
臺中市,北區,新北里,775,382,393,6,781,1655,0,47.19,23.08
臺中市,北區,樂英里,1151,886,265,11,1162,2490,0,46.67,35.58
臺中市,北區,錦村里,1507,786,721,7,1514,3071,0,49.3,25.59
臺中市,北區,建成里,2299,1131,1168,16,2315,5570,0,41.56,20.31
臺中市,北區,錦洲里,1452,835,617,16,1468,3236,0,45.36,25.8
臺中市,北區,金華里,1170,654,516,12,1182,2501,0,47.26,26.15
臺中市,北區,金龍里,1848,986,862,10,1858,4247,0,43.75,23.22
臺中市,北區,邱厝里,994,520,474,6,1000,2256,0,44.33,23.05
臺中市,北區,建興里,2455,1218,1237,18,2473,5454,0,45.34,22.33
臺中市,北區,頂厝里,1863,1011,852,20,1883,4109,0,45.83,24.6
臺中市,北區,賴厝里,1718,998,720,7,1725,5017,0,34.38,19.89
臺中市,北區,賴村里,1929,895,1034,11,1940,4300,0,45.12,20.81
臺中市,北區,育德里,1661,866,795,8,1669,3585,0,46.56,24.16
臺中市,北區,淡溝里,2255,1127,1128,25,2280,5018,0,45.44,22.46
臺中市,北區,中達里,1137,571,566,12,1149,2573,0,44.66,22.19
臺中市,北區,錦祥里,1967,1099,868,10,1977,4459,0,44.34,24.65
臺中市,北區,健行里,3048,1457,1591,35,3083,6438,0,47.89,22.63
臺中市,北區,明德里,2321,1147,1174,15,2336,5217,0,44.78,21.99
臺中市,北區,長青里,2574,1303,1271,15,2589,5993,0,43.2,21.74
臺中市,北區,賴明里,1580,902,678,7,1587,3763,0,42.17,23.97
臺中市,北區,賴興里,1646,951,695,9,1655,3730,0,44.37,25.5
臺中市,北區,中正里,575,225,350,3,578,1309,0,44.16,17.19
臺中市,北區,六合里,676,258,418,3,679,1727,0,39.32,14.94
臺中市,北區,大湖里,818,334,484,8,826,2153,0,38.37,15.51
臺中市,北區,錦平里,776,369,407,7,783,1840,0,42.55,20.05
臺中市,北區,建德里,1561,812,749,12,1573,3229,0,48.71,25.15
臺中市,北區,崇德里,1445,731,714,10,1455,3417,0,42.58,21.39
臺中市,北區,賴旺里,1655,880,775,12,1667,4259,0,39.14,20.66
臺中市,北區,明新里,1166,623,543,12,1178,2661,0,44.27,23.41
臺中市,北區,立人里,1553,870,683,9,1562,3755,0,41.6,23.17
臺中市,北區,梅川里,1397,744,653,9,1406,3190,0,44.08,23.32
臺中市,北區,賴福里,1835,962,873,15,1850,3762,0,49.18,25.57
臺中市,北區,合計,54451,28527,25924,411,54862,124160,145438,44.19,22.98
臺中市,西屯區,西安里,2263,1161,1102,15,2278,5165,0,44.1,22.48
臺中市,西屯區,西墩里,2430,1163,1267,18,2448,5884,0,41.6,19.77
臺中市,西屯區,潮洋里,2272,1157,1115,24,2296,6268,0,36.63,18.46
臺中市,西屯區,龍潭里,411,162,249,5,416,833,0,49.94,19.45
臺中市,西屯區,惠來里,6213,3338,2875,50,6263,14638,0,42.79,22.8
臺中市,西屯區,上石里,1974,1068,906,19,1993,5016,0,39.73,21.29
臺中市,西屯區,逢甲里,1754,919,835,7,1761,4314,0,40.82,21.3
臺中市,西屯區,鵬程里,1246,1077,169,11,1257,2619,0,48.0,41.12
臺中市,西屯區,何安里,2194,1081,1113,22,2216,5075,0,43.67,21.3
臺中市,西屯區,何厝里,1354,653,701,7,1361,3200,0,42.53,20.41
臺中市,西屯區,大河里,1798,801,997,16,1814,3726,0,48.68,21.5
臺中市,西屯區,大石里,1021,882,139,20,1041,2082,0,50.0,42.36
臺中市,西屯區,大福里,1356,777,579,17,1373,3255,0,42.18,23.87
臺中市,西屯區,大鵬里,1994,1116,878,13,2007,4745,0,42.3,23.52
臺中市,西屯區,港尾里,2124,1072,1052,19,2143,4944,0,43.35,21.68
臺中市,西屯區,廣福里,1044,432,612,9,1053,2324,0,45.31,18.59
臺中市,西屯區,林厝里,1427,794,633,14,1441,3398,0,42.41,23.37
臺中市,西屯區,永安里,4990,2691,2299,41,5031,12696,0,39.63,21.2
臺中市,西屯區,福安里,1346,736,610,16,1362,2940,0,46.33,25.03
臺中市,西屯區,協和里,1934,903,1031,15,1949,4642,0,41.99,19.45
臺中市,西屯區,何仁里,2650,1327,1323,26,2676,6083,0,43.99,21.81
臺中市,西屯區,何德里,1566,784,782,19,1585,3633,0,43.63,21.58
臺中市,西屯區,何源里,2872,1571,1301,22,2894,6639,0,43.59,23.66
臺中市,西屯區,西平里,1964,1220,744,15,1979,4807,0,41.17,25.38
臺中市,西屯區,何南里,1971,1048,923,10,1981,4097,0,48.35,25.58
臺中市,西屯區,至善里,1904,1027,877,23,1927,4381,0,43.99,23.44
臺中市,西屯區,上安里,2301,1238,1063,25,2326,5223,0,44.53,23.7
臺中市,西屯區,上德里,1872,1066,806,15,1887,4120,0,45.8,25.87
臺中市,西屯區,逢福里,2435,1340,1095,15,2450,5257,0,46.6,25.49
臺中市,西屯區,何明里,1688,836,852,9,1697,3558,0,47.7,23.5
臺中市,西屯區,何成里,3073,1580,1493,17,3090,7080,0,43.64,22.32
臺中市,西屯區,何福里,1965,970,995,9,1974,4322,0,45.67,22.44
臺中市,西屯區,福和里,1763,733,1030,15,1778,4278,0,41.56,17.13
臺中市,西屯區,福中里,1379,720,659,10,1389,3203,0,43.37,22.48
臺中市,西屯區,福恩里,2251,1273,978,18,2269,4778,0,47.49,26.64
臺中市,西屯區,福聯里,1116,618,498,15,1131,3166,0,35.72,19.52
臺中市,西屯區,福瑞里,1120,664,456,9,1129,2980,0,37.89,22.28
臺中市,西屯區,福林里,3359,1938,1421,37,3396,7655,0,44.36,25.32
臺中市,西屯區,福雅里,2466,1349,1117,13,2479,5769,0,42.97,23.38
臺中市,西屯區,合計,80860,43285,37575,680,81540,188793,231415,43.19,22.93
臺中市,南屯區,南屯里,3774,1902,1872,39,3813,8528,0,44.71,22.3
臺中市,南屯區,豐樂里,5217,2646,2571,48,5265,11358,0,46.35,23.3
臺中市,南屯區,楓樹里,2806,1322,1484,27,2833,5891,0,48.09,22.44
臺中市,南屯區,中和里,1860,765,1095,16,1876,4324,0,43.39,17.69
臺中市,南屯區,春社里,2460,1301,1159,25,2485,6534,0,38.03,19.91
臺中市,南屯區,春安里,492,268,224,5,497,1366,0,36.38,19.62
臺中市,南屯區,文山里,4276,2142,2134,30,4306,11272,0,38.2,19.0
臺中市,南屯區,新生里,914,438,476,5,919,2301,0,39.94,19.04
臺中市,南屯區,永定里,2136,974,1162,20,2156,5105,0,42.23,19.08
臺中市,南屯區,三厝里,2981,1583,1398,31,3012,7137,0,42.2,22.18
臺中市,南屯區,溝墘里,2629,1402,1227,20,2649,5220,0,50.75,26.86
臺中市,南屯區,田心里,2755,1342,1413,31,2786,6268,0,44.45,21.41
臺中市,南屯區,黎明里,1959,1181,778,12,1971,4151,0,47.48,28.45
臺中市,南屯區,鎮平里,576,223,353,13,589,1357,0,43.4,16.43
臺中市,南屯區,大同里,2274,1103,1171,11,2285,4877,0,46.85,22.62
臺中市,南屯區,文心里,1726,888,838,21,1747,3803,0,45.94,23.35
臺中市,南屯區,同心里,2238,1178,1060,28,2266,5223,0,43.39,22.55
臺中市,南屯區,向心里,2162,1132,1030,19,2181,5433,0,40.14,20.84
臺中市,南屯區,大誠里,1644,849,795,10,1654,3609,0,45.83,23.52
臺中市,南屯區,大興里,1993,958,1035,18,2011,4436,0,45.33,21.6
臺中市,南屯區,大業里,3027,1612,1415,10,3037,6517,0,46.6,24.74
臺中市,南屯區,惠中里,3386,1804,1582,22,3408,7565,0,45.05,23.85
臺中市,南屯區,寶山里,2062,1035,1027,12,2074,5266,0,39.38,19.65
臺中市,南屯區,三和里,3778,2198,1580,41,3819,8478,0,45.05,25.93
臺中市,南屯區,三義里,2913,1642,1271,14,2927,6493,0,45.08,25.29
臺中市,南屯區,合計,62038,31888,30150,528,62566,142512,176754,43.9,22.38
臺中市,北屯區,北興里,1425,744,681,16,1441,3133,0,45.99,23.75
臺中市,北屯區,北屯里,1476,823,653,7,1483,3392,0,43.72,24.26
臺中市,北屯區,三光里,3038,1658,1380,28,3066,6954,0,44.09,23.84
臺中市,北屯區,平田里,2398,1287,1111,20,2418,5705,0,42.38,22.56
臺中市,北屯區,平和里,2096,1185,911,10,2106,5097,0,41.32,23.25
臺中市,北屯區,東光里,1943,1029,914,17,1960,4595,0,42.66,22.39
臺中市,北屯區,舊社里,2929,1517,1412,23,2952,7211,0,40.94,21.04
臺中市,北屯區,水景里,5911,2973,2938,41,5952,13462,0,44.21,22.08
臺中市,北屯區,軍功里,5442,2622,2820,49,5491,12347,0,44.47,21.24
臺中市,北屯區,和平里,4752,2325,2427,29,4781,11410,0,41.9,20.38
臺中市,北屯區,東山里,924,374,550,7,931,2030,0,45.86,18.42
臺中市,北屯區,民政里,372,178,194,5,377,1008,0,37.4,17.66
臺中市,北屯區,廍子里,5451,2961,2490,40,5491,14177,0,38.73,20.89
臺中市,北屯區,大坑里,905,429,476,13,918,2160,0,42.5,19.86
臺中市,北屯區,民德里,357,166,191,2,359,905,0,39.67,18.34
臺中市,北屯區,松竹里,3875,2171,1704,26,3901,8784,0,44.41,24.72
臺中市,北屯區,仁和里,3505,1758,1747,28,3533,9231,0,38.27,19.04
臺中市,北屯區,仁美里,3989,2042,1947,26,4015,9374,0,42.83,21.78
臺中市,北屯區,四民里,692,354,338,5,697,1525,0,45.7,23.21
臺中市,北屯區,后庄里,4324,2619,1705,33,4357,9850,0,44.23,26.59
臺中市,北屯區,同榮里,2411,1302,1109,15,2426,5327,0,45.54,24.44
臺中市,北屯區,仁愛里,479,279,200,3,482,1046,0,46.08,26.67
臺中市,北屯區,水湳里,2965,1539,1426,37,3002,6614,0,45.39,23.27
臺中市,北屯區,陳平里,1930,1099,831,14,1944,4564,0,42.59,24.08
臺中市,北屯區,新平里,1740,1020,720,18,1758,4248,0,41.38,24.01
臺中市,北屯區,平安里,2360,1186,1174,17,2377,5130,0,46.34,23.12
臺中市,北屯區,平順里,1397,709,688,7,1404,3146,0,44.63,22.54
臺中市,北屯區,平德里,2611,1387,1224,16,2627,6176,0,42.54,22.46
臺中市,北屯區,松安里,2062,1057,1005,17,2079,4780,0,43.49,22.11
臺中市,北屯區,松茂里,2253,1285,968,17,2270,5241,0,43.31,24.52
臺中市,北屯區,大德里,2260,1326,934,17,2277,4863,0,46.82,27.27
臺中市,北屯區,松強里,2724,1458,1266,16,2740,6705,0,40.87,21.74
臺中市,北屯區,松勇里,2254,1232,1022,18,2272,5153,0,44.09,23.91
臺中市,北屯區,北京里,1451,719,732,16,1467,3180,0,46.13,22.61
臺中市,北屯區,平心里,2015,1110,905,12,2027,4765,0,42.54,23.29
臺中市,北屯區,平福里,1601,897,704,14,1615,3560,0,45.37,25.2
臺中市,北屯區,松和里,2476,1318,1158,18,2494,6410,0,38.91,20.56
臺中市,北屯區,平陽里,2064,1128,936,18,2082,4887,0,42.6,23.08
臺中市,北屯區,平興里,2724,1467,1257,21,2745,6741,0,40.72,21.76
臺中市,北屯區,平昌里,1878,991,887,12,1890,4376,0,43.19,22.65
臺中市,北屯區,三和里,2488,1391,1097,15,2503,5662,0,44.21,24.57
臺中市,北屯區,忠平里,1708,1031,677,9,1717,3906,0,43.96,26.4
臺中市,北屯區,合計,101655,54146,47509,772,102427,238830,289830,42.89,22.67
臺中市,豐原區,豐原里,984,528,456,15,999,2243,0,44.54,23.54
臺中市,豐原區,頂街里,420,175,245,3,423,919,0,46.03,19.04
臺中市,豐原區,中山里,403,174,229,3,406,795,0,51.07,21.89
臺中市,豐原區,豐榮里,517,228,289,4,521,1106,0,47.11,20.61
臺中市,豐原區,下街里,297,137,160,4,301,744,0,40.46,18.41
臺中市,豐原區,富春里,386,168,218,1,387,720,0,53.75,23.33
臺中市,豐原區,葫蘆里,297,126,171,7,304,607,0,50.08,20.76
臺中市,豐原區,豐西里,756,375,381,4,760,1595,0,47.65,23.51
臺中市,豐原區,西安里,2176,1024,1152,19,2195,4781,0,45.91,21.42
臺中市,豐原區,西勢里,1044,486,558,12,1056,2152,0,49.07,22.58
臺中市,豐原區,東勢里,663,308,355,7,670,1433,0,46.76,21.49
臺中市,豐原區,民生里,468,183,285,4,472,1119,0,42.18,16.35
臺中市,豐原區,大湳里,1099,486,613,6,1105,2494,0,44.31,19.49
臺中市,豐原區,北湳里,1284,650,634,15,1299,2882,0,45.07,22.55
臺中市,豐原區,東湳里,1666,654,1012,10,1676,3976,0,42.15,16.45
臺中市,豐原區,西湳里,3835,1708,2127,40,3875,9125,0,42.47,18.72
臺中市,豐原區,圳寮里,592,262,330,8,600,1231,0,48.74,21.28
臺中市,豐原區,豐圳里,1497,740,757,11,1508,3367,0,44.79,21.98
臺中市,豐原區,社皮里,3901,1886,2015,27,3928,9864,0,39.82,19.12
臺中市,豐原區,三村里,2788,1298,1490,28,2816,6283,0,44.82,20.66
臺中市,豐原區,中興里,1234,681,553,16,1250,2877,0,43.45,23.67
臺中市,豐原區,田心里,2483,1179,1304,27,2510,6296,0,39.87,18.73
臺中市,豐原區,豐田里,4262,1929,2333,31,4293,10193,0,42.12,18.92
臺中市,豐原區,鎌村里,1999,907,1092,23,2022,4633,0,43.64,19.58
臺中市,豐原區,南陽里,4393,2154,2239,27,4420,10538,0,41.94,20.44
臺中市,豐原區,陽明里,1164,574,590,10,1174,2631,0,44.62,21.82
臺中市,豐原區,北陽里,5444,2655,2789,33,5477,12989,0,42.17,20.44
臺中市,豐原區,中陽里,2264,1094,1170,12,2276,5045,0,45.11,21.68
臺中市,豐原區,東陽里,727,296,431,10,737,1574,0,46.82,18.81
臺中市,豐原區,南村里,2324,1035,1289,18,2342,5234,0,44.75,19.77
臺中市,豐原區,南田里,1386,568,818,22,1408,3175,0,44.35,17.89
臺中市,豐原區,南嵩里,1439,600,839,18,1457,3377,0,43.14,17.77
臺中市,豐原區,翁明里,979,490,489,7,986,2265,0,43.53,21.63
臺中市,豐原區,翁子里,1328,646,682,14,1342,3221,0,41.66,20.06
臺中市,豐原區,翁社里,957,422,535,8,965,2049,0,47.1,20.6
臺中市,豐原區,朴子里,1355,518,837,14,1369,3287,0,41.65,15.76
臺中市,豐原區,合計,58811,27344,31467,518,59329,136820,165529,43.36,19.99
臺中市,東勢區,北興里,493,323,170,7,500,1297,0,38.55,24.9
臺中市,東勢區,中寧里,366,242,124,5,371,833,0,44.54,29.05
臺中市,東勢區,東安里,430,271,159,3,433,996,0,43.47,27.21
臺中市,東勢區,南平里,807,540,267,5,812,1754,0,46.29,30.79
臺中市,東勢區,延平里,909,513,396,8,917,2138,0,42.89,23.99
臺中市,東勢區,上新里,424,273,151,1,425,951,0,44.69,28.71
臺中市,東勢區,廣興里,573,334,239,6,579,1403,0,41.27,23.81
臺中市,東勢區,泰昌里,1447,922,525,14,1461,3402,0,42.95,27.1
臺中市,東勢區,中嵙里,668,402,266,10,678,1835,0,36.95,21.91
臺中市,東勢區,福隆里,1452,856,596,29,1481,3709,0,39.93,23.08
臺中市,東勢區,隆興里,488,275,213,3,491,1418,0,34.63,19.39
臺中市,東勢區,新盛里,1895,1006,889,13,1908,4812,0,39.65,20.91
臺中市,東勢區,詒福里,663,325,338,15,678,1616,0,41.96,20.11
臺中市,東勢區,上城里,426,228,198,11,437,963,0,45.38,23.68
臺中市,東勢區,下城里,361,182,179,11,372,832,0,44.71,21.88
臺中市,東勢區,慶東里,694,323,371,17,711,1825,0,38.96,17.7
臺中市,東勢區,慶福里,372,202,170,8,380,1233,0,30.82,16.38
臺中市,東勢區,東新里,859,542,317,7,866,1954,0,44.32,27.74
臺中市,東勢區,粵寧里,837,468,369,14,851,2023,0,42.07,23.13
臺中市,東勢區,下新里,654,341,313,13,667,1651,0,40.4,20.65
臺中市,東勢區,興隆里,456,201,255,4,460,1172,0,39.25,17.15
臺中市,東勢區,茂興里,621,353,268,6,627,1817,0,34.51,19.43
臺中市,東勢區,泰興里,225,120,105,3,228,701,0,32.52,17.12
臺中市,東勢區,埤頭里,284,113,171,7,291,657,0,44.29,17.2
臺中市,東勢區,明正里,458,213,245,12,470,1365,0,34.43,15.6
臺中市,東勢區,合計,16862,9568,7294,232,17094,42357,48747,40.36,22.59
臺中市,大甲區,朝陽里,576,258,318,6,582,1331,0,43.73,19.38
臺中市,大甲區,大甲里,434,195,239,4,438,991,0,44.2,19.68
臺中市,大甲區,順天里,682,319,363,5,687,1532,0,44.84,20.82
臺中市,大甲區,孔門里,288,152,136,2,290,748,0,38.77,20.32
臺中市,大甲區,平安里,784,368,416,12,796,2008,0,39.64,18.33
臺中市,大甲區,庄美里,882,425,457,12,894,2055,0,43.5,20.68
臺中市,大甲區,新美里,1333,675,658,12,1345,3394,0,39.63,19.89
臺中市,大甲區,岷山里,768,374,394,11,779,2042,0,38.15,18.32
臺中市,大甲區,中山里,1718,897,821,18,1736,4515,0,38.45,19.87
臺中市,大甲區,南陽里,328,163,165,3,331,813,0,40.71,20.05
臺中市,大甲區,薰風里,396,175,221,6,402,860,0,46.74,20.35
臺中市,大甲區,義和里,1144,573,571,6,1150,3232,0,35.58,17.73
臺中市,大甲區,武陵里,453,238,215,3,456,1160,0,39.31,20.52
臺中市,大甲區,文曲里,354,138,216,2,356,1073,0,33.18,12.86
臺中市,大甲區,武曲里,700,351,349,5,705,1810,0,38.95,19.39
臺中市,大甲區,文武里,2071,1056,1015,17,2088,5206,0,40.11,20.28
臺中市,大甲區,奉化里,792,428,364,8,800,1996,0,40.08,21.44
臺中市,大甲區,德化里,630,272,358,8,638,1755,0,36.35,15.5
臺中市,大甲區,江南里,466,234,232,2,468,1356,0,34.51,17.26
臺中市,大甲區,頂店里,1675,806,869,14,1689,4450,0,37.96,18.11
臺中市,大甲區,太白里,427,187,240,10,437,1233,0,35.44,15.17
臺中市,大甲區,孟春里,1374,624,750,11,1385,3909,0,35.43,15.96
臺中市,大甲區,幸福里,852,384,468,12,864,2515,0,34.35,15.27
臺中市,大甲區,日南里,1809,871,938,19,1828,5476,0,33.38,15.91
臺中市,大甲區,龍泉里,571,265,306,11,582,1475,0,39.46,17.97
臺中市,大甲區,西岐里,592,299,293,9,601,1649,0,36.45,18.13
臺中市,大甲區,銅安里,433,204,229,8,441,1340,0,32.91,15.22
臺中市,大甲區,福德里,371,184,187,5,376,1111,0,33.84,16.56
臺中市,大甲區,建興里,439,182,257,6,445,1446,0,30.77,12.59
臺中市,大甲區,合計,23342,11297,12045,247,23589,62481,75819,37.75,18.08
臺中市,清水區,鰲峰里,461,213,248,8,469,1063,0,44.12,20.04
臺中市,清水區,靈泉里,463,232,231,3,466,930,0,50.11,24.95
臺中市,清水區,清水里,913,419,494,8,921,2049,0,44.95,20.45
臺中市,清水區,文昌里,310,134,176,4,314,661,0,47.5,20.27
臺中市,清水區,南寧里,764,371,393,3,767,1743,0,44.0,21.29
臺中市,清水區,西寧里,659,285,374,4,663,1553,0,42.69,18.35
臺中市,清水區,北寧里,327,143,184,4,331,673,0,49.18,21.25
臺中市,清水區,中興里,209,95,114,2,211,391,0,53.96,24.3
臺中市,清水區,西社里,955,427,528,11,966,2191,0,44.09,19.49
臺中市,清水區,南社里,4115,1996,2119,28,4143,9925,0,41.74,20.11
臺中市,清水區,裕嘉里,537,242,295,5,542,1448,0,37.43,16.71
臺中市,清水區,臨江里,594,291,303,5,599,1505,0,39.8,19.34
臺中市,清水區,秀水里,1752,871,881,11,1763,4370,0,40.34,19.93
臺中市,清水區,武鹿里,1241,575,666,11,1252,3341,0,37.47,17.21
臺中市,清水區,海濱里,793,347,446,12,805,2104,0,38.26,16.49
臺中市,清水區,槺榔里,2299,1014,1285,15,2314,6655,0,34.77,15.24
臺中市,清水區,中社里,1184,840,344,8,1192,2801,0,42.56,29.99
臺中市,清水區,高西里,396,236,160,6,402,1278,0,31.46,18.47
臺中市,清水區,高南里,447,202,245,3,450,1330,0,33.83,15.19
臺中市,清水區,高東里,411,172,239,8,419,1234,0,33.95,13.94
臺中市,清水區,高北里,337,158,179,0,337,1155,0,29.18,13.68
臺中市,清水區,高美里,448,230,218,4,452,1309,0,34.53,17.57
臺中市,清水區,國姓里,663,238,425,5,668,2039,0,32.76,11.67
臺中市,清水區,菁埔里,896,360,536,8,904,2252,0,40.14,15.99
臺中市,清水區,頂湳里,598,285,313,6,604,1765,0,34.22,16.15
臺中市,清水區,田寮里,806,306,500,12,818,2488,0,32.88,12.3
臺中市,清水區,橋頭里,2945,1246,1699,30,2975,7404,0,40.18,16.83
臺中市,清水區,下湳里,1062,490,572,15,1077,2764,0,38.97,17.73
臺中市,清水區,東山里,424,213,211,7,431,1197,0,36.01,17.79
臺中市,清水區,楊厝里,437,181,256,3,440,1156,0,38.06,15.66
臺中市,清水區,海風里,495,239,256,8,503,1390,0,36.19,17.19
臺中市,清水區,吳厝里,567,280,287,7,574,1465,0,39.18,19.11
臺中市,清水區,合計,28508,13331,15177,264,28772,73629,88227,39.08,18.11
臺中市,沙鹿區,居仁里,608,287,321,3,611,1364,0,44.79,21.04
臺中市,沙鹿區,洛泉里,1027,519,508,8,1035,1976,0,52.38,26.27
臺中市,沙鹿區,沙鹿里,466,188,278,3,469,893,0,52.52,21.05
臺中市,沙鹿區,美仁里,235,120,115,3,238,489,0,48.67,24.54
臺中市,沙鹿區,興仁里,1079,513,566,7,1086,2409,0,45.08,21.3
臺中市,沙鹿區,斗抵里,1982,973,1009,18,2000,4364,0,45.83,22.3
臺中市,沙鹿區,鹿峰里,2325,1058,1267,28,2353,5345,0,44.02,19.79
臺中市,沙鹿區,鹿寮里,3129,1267,1862,23,3152,6799,0,46.36,18.64
臺中市,沙鹿區,竹林里,3090,1581,1509,25,3115,7344,0,42.42,21.53
臺中市,沙鹿區,犁分里,473,207,266,4,477,1089,0,43.8,19.01
臺中市,沙鹿區,北勢里,1865,953,912,22,1887,4904,0,38.48,19.43
臺中市,沙鹿區,福興里,1611,844,767,12,1623,3843,0,42.23,21.96
臺中市,沙鹿區,晉江里,771,373,398,12,783,1748,0,44.79,21.34
臺中市,沙鹿區,六路里,2215,1073,1142,13,2228,5388,0,41.35,19.91
臺中市,沙鹿區,南勢里,1408,742,666,11,1419,3381,0,41.97,21.95
臺中市,沙鹿區,埔子里,2513,1384,1129,20,2533,5682,0,44.58,24.36
臺中市,沙鹿區,公明里,1799,1041,758,24,1823,4396,0,41.47,23.68
臺中市,沙鹿區,清泉里,1019,580,439,11,1030,2331,0,44.19,24.88
臺中市,沙鹿區,西勢里,853,483,370,11,864,2130,0,40.56,22.68
臺中市,沙鹿區,興安里,1446,656,790,18,1464,3365,0,43.51,19.49
臺中市,沙鹿區,三鹿里,3028,1638,1390,21,3049,7321,0,41.65,22.37
臺中市,沙鹿區,合計,32942,16480,16462,297,33239,76561,95562,43.42,21.53
臺中市,梧棲區,頂寮里,1432,687,745,9,1441,3632,0,39.68,18.92
臺中市,梧棲區,下寮里,835,395,440,8,843,1967,0,42.86,20.08
臺中市,梧棲區,中正里,1495,775,720,12,1507,3879,0,38.85,19.98
臺中市,梧棲區,中和里,226,107,119,0,226,484,0,46.69,22.11
臺中市,梧棲區,文化里,488,257,231,6,494,1161,0,42.55,22.14
臺中市,梧棲區,安仁里,332,157,175,0,332,780,0,42.56,20.13
臺中市,梧棲區,草湳里,2410,1151,1259,26,2436,6132,0,39.73,18.77
臺中市,梧棲區,南簡里,1979,885,1094,17,1996,5294,0,37.7,16.72
臺中市,梧棲區,福德里,1750,794,956,19,1769,4953,0,35.72,16.03
臺中市,梧棲區,大庄里,2880,1442,1438,35,2915,7509,0,38.82,19.2
臺中市,梧棲區,大村里,2194,1052,1142,20,2214,5687,0,38.93,18.5
臺中市,梧棲區,興農里,827,376,451,10,837,2322,0,36.05,16.19
臺中市,梧棲區,永寧里,859,371,488,12,871,2298,0,37.9,16.14
臺中市,梧棲區,永安里,921,414,507,15,936,2493,0,37.55,16.61
臺中市,梧棲區,合計,18628,8863,9765,189,18817,48591,59487,38.73,18.24
臺中市,后里區,廣福里,774,507,267,21,795,2076,0,38.29,24.42
臺中市,后里區,仁里里,384,196,188,9,393,1031,0,38.12,19.01
臺中市,后里區,義里里,1188,692,496,15,1203,3086,0,38.98,22.42
臺中市,后里區,后里里,1563,802,761,14,1577,3652,0,43.18,21.96
臺中市,后里區,厚里里,830,415,415,9,839,2136,0,39.28,19.43
臺中市,后里區,墩東里,1918,993,925,20,1938,4739,0,40.89,20.95
臺中市,后里區,墩西里,763,330,433,4,767,1917,0,40.01,17.21
臺中市,后里區,墩南里,1328,618,710,14,1342,3347,0,40.1,18.46
臺中市,后里區,墩北里,1431,644,787,14,1445,3538,0,40.84,18.2
臺中市,后里區,中和里,933,420,513,17,950,2376,0,39.98,17.68
臺中市,后里區,舊社里,820,402,418,10,830,2187,0,37.95,18.38
臺中市,后里區,聯合里,616,270,346,6,622,1559,0,39.9,17.32
臺中市,后里區,太平里,706,336,370,6,712,2131,0,33.41,15.77
臺中市,后里區,眉山里,1143,576,567,14,1157,3198,0,36.18,18.01
臺中市,后里區,泰安里,521,230,291,4,525,1393,0,37.69,16.51
臺中市,后里區,公館里,734,334,400,16,750,2139,0,35.06,15.61
臺中市,后里區,月眉里,770,311,459,11,781,1956,0,39.93,15.9
臺中市,后里區,義德里,968,567,401,12,980,2591,0,37.82,21.88
臺中市,后里區,合計,17390,8643,8747,216,17606,45052,54126,39.08,19.18
臺中市,神岡區,神岡里,1235,604,631,13,1248,3173,0,39.33,19.04
臺中市,神岡區,庄前里,957,425,532,8,965,2296,0,42.03,18.51
臺中市,神岡區,北庄里,1053,454,599,11,1064,2611,0,40.75,17.39
臺中市,神岡區,庄後里,939,351,588,6,945,2220,0,42.57,15.81
臺中市,神岡區,社口里,2840,1238,1602,18,2858,7481,0,38.2,16.55
臺中市,神岡區,社南里,2098,836,1262,13,2111,5257,0,40.16,15.9
臺中市,神岡區,三角里,1082,404,678,6,1088,2555,0,42.58,15.81
臺中市,神岡區,岸裡里,1184,444,740,13,1197,2845,0,42.07,15.61
臺中市,神岡區,大社里,1684,771,913,13,1697,4465,0,38.01,17.27
臺中市,神岡區,豐洲里,2788,1192,1596,27,2815,7152,0,39.36,16.67
臺中市,神岡區,神洲里,1076,405,671,18,1094,2539,0,43.09,15.95
臺中市,神岡區,溪洲里,1106,462,644,20,1126,2800,0,40.21,16.5
臺中市,神岡區,圳前里,888,427,461,17,905,2268,0,39.9,18.83
臺中市,神岡區,新庄里,1455,599,856,16,1471,4135,0,35.57,14.49
臺中市,神岡區,圳堵里,800,378,422,8,808,2090,0,38.66,18.09
臺中市,神岡區,山皮里,411,143,268,5,416,1016,0,40.94,14.07
臺中市,神岡區,合計,21596,9133,12463,212,21808,54903,65143,39.72,16.63
臺中市,潭子區,潭陽里,4318,2066,2252,34,4352,10990,0,39.6,18.8
臺中市,潭子區,潭秀里,595,228,367,7,602,1262,0,47.7,18.07
臺中市,潭子區,潭北里,1017,518,499,8,1025,2378,0,43.1,21.78
臺中市,潭子區,福仁里,4200,2204,1996,22,4222,10488,0,40.26,21.01
臺中市,潭子區,頭家里,2275,1198,1077,21,2296,5345,0,42.96,22.41
臺中市,潭子區,甘蔗里,3873,2007,1866,21,3894,9332,0,41.73,21.51
臺中市,潭子區,東寶里,5015,2321,2694,41,5056,12018,0,42.07,19.31
臺中市,潭子區,大富里,1216,543,673,11,1227,2801,0,43.81,19.39
臺中市,潭子區,大豐里,2552,1155,1397,23,2575,6066,0,42.45,19.04
臺中市,潭子區,栗林里,2115,904,1211,21,2136,4733,0,45.13,19.1
臺中市,潭子區,嘉仁里,1610,691,919,18,1628,3997,0,40.73,17.29
臺中市,潭子區,新田里,663,259,404,6,669,1536,0,43.55,16.86
臺中市,潭子區,聚興里,1576,754,822,19,1595,4262,0,37.42,17.69
臺中市,潭子區,頭家東里,1765,897,868,9,1774,4319,0,41.07,20.77
臺中市,潭子區,家興里,2903,1545,1358,13,2916,6933,0,42.06,22.28
臺中市,潭子區,家福里,1989,1013,976,22,2011,4575,0,43.96,22.14
臺中市,潭子區,合計,37682,18303,19379,296,37978,91035,109158,41.72,20.11
臺中市,大雅區,大雅里,1788,911,877,15,1803,4325,0,41.69,21.06
臺中市,大雅區,員林里,3627,1711,1916,25,3652,9201,0,39.69,18.6
臺中市,大雅區,六寶里,2397,1317,1080,28,2425,6208,0,39.06,21.21
臺中市,大雅區,秀山里,1339,600,739,17,1356,3353,0,40.44,17.89
臺中市,大雅區,忠義里,1299,957,342,14,1313,3594,0,36.53,26.63
臺中市,大雅區,橫山里,1706,826,880,12,1718,4313,0,39.83,19.15
臺中市,大雅區,三和里,2040,1010,1030,24,2064,5252,0,39.3,19.23
臺中市,大雅區,西寶里,1755,822,933,12,1767,4779,0,36.97,17.2
臺中市,大雅區,上楓里,2296,1058,1238,20,2316,6244,0,37.09,16.94
臺中市,大雅區,二和里,2318,1161,1157,12,2330,5915,0,39.39,19.63
臺中市,大雅區,四德里,1928,1014,914,12,1940,4622,0,41.97,21.94
臺中市,大雅區,上雅里,2275,1113,1162,16,2291,6037,0,37.95,18.44
臺中市,大雅區,文雅里,2357,1262,1095,9,2366,6021,0,39.3,20.96
臺中市,大雅區,大楓里,1952,959,993,20,1972,5029,0,39.21,19.07
臺中市,大雅區,雅楓里,1331,693,638,8,1339,3545,0,37.77,19.55
臺中市,大雅區,合計,30408,15414,14994,244,30652,78438,95800,39.08,19.65
臺中市,新社區,新社里,1367,754,613,20,1387,3261,0,42.53,23.12
臺中市,新社區,復盛里,606,331,275,7,613,1835,0,33.41,18.04
臺中市,新社區,中正里,536,279,257,7,543,1342,0,40.46,20.79
臺中市,新社區,月湖里,379,161,218,10,389,986,0,39.45,16.33
臺中市,新社區,崑山里,471,161,310,1,472,1156,0,40.83,13.93
臺中市,新社區,大南里,722,376,346,15,737,1879,0,39.22,20.01
臺中市,新社區,永源里,1157,468,689,21,1178,2983,0,39.49,15.69
臺中市,新社區,中興里,266,202,64,1,267,582,0,45.88,34.71
臺中市,新社區,協成里,1098,480,618,18,1116,2927,0,38.13,16.4
臺中市,新社區,東興里,489,299,190,9,498,1187,0,41.95,25.19
臺中市,新社區,慶西里,318,127,191,8,326,885,0,36.84,14.35
臺中市,新社區,中和里,226,173,53,6,232,575,0,40.35,30.09
臺中市,新社區,福興里,415,229,186,7,422,1112,0,37.95,20.59
臺中市,新社區,合計,8050,4040,4010,130,8180,20710,23859,39.5,19.51
臺中市,石岡區,石岡里,440,227,213,6,446,1210,0,36.86,18.76
臺中市,石岡區,萬安里,648,329,319,8,656,1518,0,43.21,21.67
臺中市,石岡區,九房里,523,269,254,3,526,1204,0,43.69,22.34
臺中市,石岡區,金星里,459,227,232,10,469,1232,0,38.07,18.43
臺中市,石岡區,龍興里,259,127,132,4,263,638,0,41.22,19.91
臺中市,石岡區,萬興里,618,327,291,11,629,1443,0,43.59,22.66
臺中市,石岡區,梅子里,749,388,361,15,764,1794,0,42.59,21.63
臺中市,石岡區,土牛里,414,237,177,6,420,1002,0,41.92,23.65
臺中市,石岡區,德興里,568,329,239,13,581,1408,0,41.26,23.37
臺中市,石岡區,和盛里,528,315,213,5,533,1230,0,43.33,25.61
臺中市,石岡區,合計,5206,2775,2431,81,5287,12679,14532,41.7,21.89
臺中市,外埔區,永豐里,385,211,174,5,390,1099,0,35.49,19.2
臺中市,外埔區,六分里,776,439,337,4,780,2193,0,35.57,20.02
臺中市,外埔區,三崁里,620,328,292,7,627,1887,0,33.23,17.38
臺中市,外埔區,大同里,1764,990,774,17,1781,4680,0,38.06,21.15
臺中市,外埔區,水美里,1250,654,596,19,1269,3392,0,37.41,19.28
臺中市,外埔區,大東里,2337,1235,1102,25,2362,6342,0,37.24,19.47
臺中市,外埔區,馬鳴里,477,228,249,4,481,1384,0,34.75,16.47
臺中市,外埔區,中山里,522,301,221,4,526,1210,0,43.47,24.88
臺中市,外埔區,鐵山里,704,396,308,7,711,2115,0,33.62,18.72
臺中市,外埔區,土城里,597,247,350,2,599,1581,0,37.89,15.62
臺中市,外埔區,廍子里,349,162,187,6,355,1158,0,30.66,13.99
臺中市,外埔區,合計,9781,5191,4590,100,9881,27041,31790,36.54,19.2
臺中市,大安區,南埔里,356,127,229,6,362,1055,0,34.31,12.04
臺中市,大安區,南庄里,356,164,192,1,357,1023,0,34.9,16.03
臺中市,大安區,中庄里,863,385,478,5,868,2624,0,33.08,14.67
臺中市,大安區,龜壳里,523,258,265,5,528,1502,0,35.15,17.18
臺中市,大安區,福興里,392,165,227,8,400,1149,0,34.81,14.36
臺中市,大安區,東安里,448,210,238,2,450,1199,0,37.53,17.51
臺中市,大安區,頂安里,338,161,177,8,346,889,0,38.92,18.11
臺中市,大安區,永安里,558,260,298,12,570,1753,0,32.52,14.83
臺中市,大安區,福住里,337,159,178,1,338,1037,0,32.59,15.33
臺中市,大安區,海墘里,450,241,209,4,454,1385,0,32.78,17.4
臺中市,大安區,西安里,609,298,311,12,621,1738,0,35.73,17.15
臺中市,大安區,松雅里,442,197,245,1,443,966,0,45.86,20.39
臺中市,大安區,合計,5672,2625,3047,65,5737,16320,18688,35.15,16.08
臺中市,烏日區,烏日里,4122,1973,2149,38,4160,8638,0,48.16,22.84
臺中市,烏日區,湖日里,1152,527,625,13,1165,2486,0,46.86,21.2
臺中市,烏日區,三和里,2500,1262,1238,24,2524,5768,0,43.76,21.88
臺中市,烏日區,榮泉里,2468,1335,1133,9,2477,5795,0,42.74,23.04
臺中市,烏日區,學田里,1141,617,524,10,1151,2612,0,44.07,23.62
臺中市,烏日區,九德里,5799,2760,3039,30,5829,12829,0,45.44,21.51
臺中市,烏日區,仁德里,3566,1747,1819,26,3592,7556,0,47.54,23.12
臺中市,烏日區,前竹里,800,337,463,7,807,1621,0,49.78,20.79
臺中市,烏日區,五光里,751,339,412,12,763,1676,0,45.53,20.23
臺中市,烏日區,光明里,944,417,527,5,949,2095,0,45.3,19.9
臺中市,烏日區,東園里,966,419,547,13,979,2196,0,44.58,19.08
臺中市,烏日區,溪埧里,1926,875,1051,18,1944,4327,0,44.93,20.22
臺中市,烏日區,螺潭里,1072,495,577,11,1083,2158,0,50.19,22.94
臺中市,烏日區,北里里,755,320,435,6,761,1651,0,46.09,19.38
臺中市,烏日區,南里里,656,360,296,3,659,1350,0,48.81,26.67
臺中市,烏日區,溪尾里,364,211,153,5,369,829,0,44.51,25.45
臺中市,烏日區,合計,28982,13994,14988,230,29212,63587,76907,45.94,22.01
臺中市,大肚區,王田里,1741,806,935,16,1757,4325,0,40.62,18.64
臺中市,大肚區,中和里,411,186,225,4,415,865,0,47.98,21.5
臺中市,大肚區,福山里,1492,693,799,10,1502,3486,0,43.09,19.88
臺中市,大肚區,營埔里,641,298,343,7,648,1505,0,43.06,19.8
臺中市,大肚區,社腳里,1100,591,509,7,1107,2438,0,45.41,24.24
臺中市,大肚區,新興里,1127,559,568,7,1134,2601,0,43.6,21.49
臺中市,大肚區,大東里,1366,725,641,14,1380,3003,0,45.95,24.14
臺中市,大肚區,大肚里,1097,588,509,7,1104,2165,0,50.99,27.16
臺中市,大肚區,永和里,397,216,181,6,403,819,0,49.21,26.37
臺中市,大肚區,磺溪里,727,353,374,7,734,1699,0,43.2,20.78
臺中市,大肚區,永順里,767,343,424,9,776,1688,0,45.97,20.32
臺中市,大肚區,成功里,368,208,160,6,374,943,0,39.66,22.06
臺中市,大肚區,山陽里,571,281,290,13,584,1310,0,44.58,21.45
臺中市,大肚區,頂街里,3201,1687,1514,29,3230,7418,0,43.54,22.74
臺中市,大肚區,瑞井里,2051,970,1081,22,2073,5061,0,40.96,19.17
臺中市,大肚區,蔗廍里,1946,819,1127,8,1954,4958,0,39.41,16.52
臺中市,大肚區,自強里,1497,813,684,19,1516,3471,0,43.68,23.42
臺中市,大肚區,合計,20500,10136,10364,191,20691,47755,56669,43.33,21.23
臺中市,龍井區,竹坑里,1235,653,582,9,1244,3019,0,41.21,21.63
臺中市,龍井區,龍東里,1159,581,578,6,1165,2849,0,40.89,20.39
臺中市,龍井區,龍西里,776,422,354,8,784,1822,0,43.03,23.16
臺中市,龍井區,田中里,1577,761,816,17,1594,3624,0,43.98,21.0
臺中市,龍井區,福田里,375,197,178,8,383,1043,0,36.72,18.89
臺中市,龍井區,麗水里,926,520,406,8,934,2271,0,41.13,22.9
臺中市,龍井區,龍津里,1987,895,1092,19,2006,5015,0,40.0,17.85
臺中市,龍井區,三德里,1039,432,607,10,1049,2952,0,35.54,14.63
臺中市,龍井區,忠和里,1967,842,1125,20,1987,4892,0,40.62,17.21
臺中市,龍井區,山腳里,2191,993,1198,20,2211,5745,0,38.49,17.28
臺中市,龍井區,龍泉里,3093,1589,1504,27,3120,7612,0,40.99,20.87
臺中市,龍井區,龍崗里,1080,540,540,6,1086,2640,0,41.14,20.45
臺中市,龍井區,新庄里,2530,1267,1263,20,2550,6354,0,40.13,19.94
臺中市,龍井區,南寮里,703,299,404,8,711,1558,0,45.64,19.19
臺中市,龍井區,新東里,2078,1117,961,18,2096,4747,0,44.15,23.53
臺中市,龍井區,東海里,3827,2187,1640,32,3859,8616,0,44.79,25.38
臺中市,龍井區,合計,26543,13295,13248,236,26779,64759,78039,41.35,20.53
臺中市,霧峰區,桐林里,540,262,278,6,546,1194,0,45.73,21.94
臺中市,霧峰區,吉峰里,4005,1995,2010,18,4023,9381,0,42.88,21.27
臺中市,霧峰區,甲寅里,1974,1036,938,14,1988,4671,0,42.56,22.18
臺中市,霧峰區,本鄉里,1090,540,550,9,1099,2320,0,47.37,23.28
臺中市,霧峰區,中正里,998,507,491,5,1003,2025,0,49.53,25.04
臺中市,霧峰區,錦榮里,563,297,266,5,568,1224,0,46.41,24.26
臺中市,霧峰區,萊園里,487,208,279,9,496,1045,0,47.46,19.9
臺中市,霧峰區,本堂里,2663,1442,1221,15,2678,5783,0,46.31,24.94
臺中市,霧峰區,坑口里,1330,697,633,15,1345,2918,0,46.09,23.89
臺中市,霧峰區,北柳里,1759,799,960,10,1769,3965,0,44.62,20.15
臺中市,霧峰區,南柳里,913,432,481,9,922,1860,0,49.57,23.23
臺中市,霧峰區,四德里,1029,453,576,10,1039,2470,0,42.06,18.34
臺中市,霧峰區,五福里,1196,563,633,17,1213,2651,0,45.76,21.24
臺中市,霧峰區,萬豐里,1104,482,622,8,1112,2577,0,43.15,18.7
臺中市,霧峰區,舊正里,879,411,468,11,890,2046,0,43.5,20.09
臺中市,霧峰區,峰谷里,432,167,265,4,436,1104,0,39.49,15.13
臺中市,霧峰區,六股里,1114,441,673,13,1127,2352,0,47.92,18.75
臺中市,霧峰區,丁台里,1073,439,634,15,1088,2284,0,47.64,19.22
臺中市,霧峰區,北勢里,950,535,415,4,954,2071,0,46.06,25.83
臺中市,霧峰區,南勢里,559,267,292,1,560,1307,0,42.85,20.43
臺中市,霧峰區,合計,24658,11973,12685,198,24856,55248,64801,44.99,21.67
臺中市,太平區,太平里,2172,931,1241,27,2199,5378,0,40.89,17.31
臺中市,太平區,長億里,2406,1185,1221,28,2434,6193,0,39.3,19.13
臺中市,太平區,中平里,1587,715,872,15,1602,4030,0,39.75,17.74
臺中市,太平區,中興里,1331,557,774,9,1340,3192,0,41.98,17.45
臺中市,太平區,建國里,1123,532,591,15,1138,2873,0,39.61,18.52
臺中市,太平區,東平里,1531,703,828,13,1544,4108,0,37.59,17.11
臺中市,太平區,宜欣里,2316,1033,1283,21,2337,6203,0,37.68,16.65
臺中市,太平區,中山里,1275,729,546,8,1283,3727,0,34.42,19.56
臺中市,太平區,坪林里,1443,847,596,15,1458,3294,0,44.26,25.71
臺中市,太平區,光華里,2081,1147,934,22,2103,5188,0,40.54,22.11
臺中市,太平區,新坪里,2762,1492,1270,24,2786,7707,0,36.15,19.36
臺中市,太平區,新光里,3086,1484,1602,28,3114,7600,0,40.97,19.53
臺中市,太平區,新福里,2743,1398,1345,17,2760,6669,0,41.39,20.96
臺中市,太平區,頭汴里,659,325,334,6,665,1767,0,37.63,18.39
臺中市,太平區,東汴里,400,161,239,7,407,1199,0,33.94,13.43
臺中市,太平區,興隆里,1181,581,600,16,1197,3227,0,37.09,18.0
臺中市,太平區,光隆里,1185,426,759,10,1195,3052,0,39.15,13.96
臺中市,太平區,德隆里,1778,755,1023,14,1792,4742,0,37.79,15.92
臺中市,太平區,黃竹里,245,104,141,8,253,649,0,38.98,16.02
臺中市,太平區,永成里,2528,1192,1336,26,2554,6807,0,37.52,17.51
臺中市,太平區,永平里,1539,679,860,4,1543,4018,0,38.4,16.9
臺中市,太平區,成功里,1454,604,850,13,1467,3985,0,36.81,15.16
臺中市,太平區,東和里,1027,490,537,5,1032,2818,0,36.62,17.39
臺中市,太平區,中政里,1390,639,751,14,1404,3701,0,37.94,17.27
臺中市,太平區,平安里,868,373,495,12,880,2204,0,39.93,16.92
臺中市,太平區,建興里,998,464,534,10,1008,2894,0,34.83,16.03
臺中市,太平區,新興里,2250,1126,1124,15,2265,5508,0,41.12,20.44
臺中市,太平區,新高里,3237,1673,1564,25,3262,8031,0,40.62,20.83
臺中市,太平區,新吉里,2201,1183,1018,19,2220,5692,0,39.0,20.78
臺中市,太平區,新城里,1949,1062,887,15,1964,5664,0,34.68,18.75
臺中市,太平區,宜佳里,2307,1175,1132,17,2324,6055,0,38.38,19.41
臺中市,太平區,宜昌里,1398,614,784,18,1416,3821,0,37.06,16.07
臺中市,太平區,光明里,1501,892,609,11,1512,3832,0,39.46,23.28
臺中市,太平區,豐年里,1910,1041,869,15,1925,4323,0,44.53,24.08
臺中市,太平區,大興里,932,442,490,7,939,2539,0,36.98,17.41
臺中市,太平區,勤益里,896,533,363,13,909,2139,0,42.5,24.92
臺中市,太平區,聖和里,588,275,313,6,594,1536,0,38.67,17.9
臺中市,太平區,福隆里,1452,659,793,13,1465,3631,0,40.35,18.15
臺中市,太平區,永隆里,897,417,480,10,907,2486,0,36.48,16.77
臺中市,太平區,合計,62626,30638,31988,571,63197,162482,195494,38.89,18.86
臺中市,大里區,大里里,1537,715,822,16,1553,3731,0,41.62,19.16
臺中市,大里區,新里里,4246,2047,2199,24,4270,10438,0,40.91,19.61
臺中市,大里區,樹王里,1555,605,950,17,1572,3621,0,43.41,16.71
臺中市,大里區,東興里,2907,1358,1549,22,2929,6901,0,42.44,19.68
臺中市,大里區,祥興里,3090,1410,1680,31,3121,7279,0,42.88,19.37
臺中市,大里區,日新里,1818,895,923,17,1835,4162,0,44.09,21.5
臺中市,大里區,西榮里,2195,1030,1165,26,2221,5520,0,40.24,18.66
臺中市,大里區,內新里,3385,1742,1643,21,3406,8350,0,40.79,20.86
臺中市,大里區,東昇里,1410,679,731,20,1430,3400,0,42.06,19.97
臺中市,大里區,立仁里,1971,860,1111,23,1994,5356,0,37.23,16.06
臺中市,大里區,新仁里,3234,1453,1781,32,3266,7841,0,41.65,18.53
臺中市,大里區,大元里,1880,820,1060,14,1894,4167,0,45.45,19.68
臺中市,大里區,夏田里,462,179,283,7,469,982,0,47.76,18.23
臺中市,大里區,仁化里,3122,1386,1736,34,3156,8402,0,37.56,16.5
臺中市,大里區,健民里,1695,754,941,21,1716,4704,0,36.48,16.03
臺中市,大里區,塗城里,3199,1406,1793,28,3227,8359,0,38.61,16.82
臺中市,大里區,瑞城里,4489,2132,2357,29,4518,11593,0,38.97,18.39
臺中市,大里區,金城里,3749,1833,1916,27,3776,9507,0,39.72,19.28
臺中市,大里區,東湖里,4017,1934,2083,36,4053,10403,0,38.96,18.59
臺中市,大里區,西湖里,1166,505,661,13,1179,2803,0,42.06,18.02
臺中市,大里區,國光里,2451,1269,1182,17,2468,5719,0,43.15,22.19
臺中市,大里區,大明里,1677,785,892,10,1687,4144,0,40.71,18.94
臺中市,大里區,永隆里,4422,2316,2106,27,4449,9667,0,46.02,23.96
臺中市,大里區,長榮里,3811,1935,1876,31,3842,8636,0,44.49,22.41
臺中市,大里區,中新里,2124,1059,1065,19,2143,5389,0,39.77,19.65
臺中市,大里區,立德里,3021,1435,1586,24,3045,7712,0,39.48,18.61
臺中市,大里區,仁德里,2316,1043,1273,16,2332,5865,0,39.76,17.78
臺中市,大里區,合計,70949,33585,37364,602,71551,174651,212710,40.97,19.23
臺中市,和平區,南勢里,646,408,238,14,660,1883,0,35.05,21.67
臺中市,和平區,天輪里,141,74,67,4,145,456,0,31.8,16.23
臺中市,和平區,博愛里,528,396,132,7,535,1641,0,32.6,24.13
臺中市,和平區,中坑里,192,134,58,3,195,461,0,42.3,29.07
臺中市,和平區,自由里,422,322,100,3,425,1081,0,39.32,29.79
臺中市,和平區,達觀里,420,294,126,2,422,1107,0,38.12,26.56
臺中市,和平區,梨山里,431,280,151,2,433,1939,0,22.33,14.44
臺中市,和平區,平等里,208,159,49,4,212,868,0,24.42,18.32
臺中市,和平區,合計,2988,2067,921,39,3027,9436,10841,32.08,21.91
臺中市,合計,合計,975932,488644,487288,8556,984488,2337667,2819081,42.11,20.9
臺南市,新營區,忠政里,1946,1038,908,9,1955,4561,0,42.86,22.76
臺南市,新營區,民權里,906,407,499,11,917,2212,0,41.46,18.4
臺南市,新營區,三仙里,1144,502,642,12,1156,2807,0,41.18,17.88
臺南市,新營區,大宏里,1171,496,675,8,1179,2795,0,42.18,17.75
臺南市,新營區,王公里,1575,702,873,14,1589,4010,0,39.63,17.51
臺南市,新營區,中營里,473,194,279,4,477,1131,0,42.18,17.15
臺南市,新營區,土庫里,570,185,385,7,577,1430,0,40.35,12.94
臺南市,新營區,南興里,884,401,483,7,891,2371,0,37.58,16.91
臺南市,新營區,興業里,737,345,392,5,742,1734,0,42.79,19.9
臺南市,新營區,民生里,1202,493,709,10,1212,3194,0,37.95,15.44
臺南市,新營區,民榮里,1642,664,978,19,1661,4405,0,37.71,15.07
臺南市,新營區,埤寮里,640,243,397,14,654,1632,0,40.07,14.89
臺南市,新營區,護鎮里,514,171,343,2,516,1333,0,38.71,12.83
臺南市,新營區,太南里,597,162,435,8,605,1724,0,35.09,9.4
臺南市,新營區,太北里,657,191,466,5,662,1696,0,39.03,11.26
臺南市,新營區,南紙里,1321,584,737,14,1335,3665,0,36.43,15.93
臺南市,新營區,嘉芳里,659,227,432,6,665,1880,0,35.37,12.07
臺南市,新營區,五興里,609,155,454,6,615,1555,0,39.55,9.97
臺南市,新營區,姑爺里,339,106,233,8,347,897,0,38.68,11.82
臺南市,新營區,新北里,1880,903,977,16,1896,4874,0,38.9,18.53
臺南市,新營區,新南里,2046,877,1169,10,2056,5086,0,40.42,17.24
臺南市,新營區,新東里,2509,1251,1258,11,2520,6401,0,39.37,19.54
臺南市,新營區,永平里,1131,469,662,10,1141,2599,0,43.9,18.05
臺南市,新營區,合計,25152,10766,14386,216,25368,63992,76027,39.64,16.82
臺南市,鹽水區,水秀里,587,196,391,7,594,1549,0,38.35,12.65
臺南市,鹽水區,橋南里,1292,477,815,17,1309,3724,0,35.15,12.81
臺南市,鹽水區,汫水里,310,44,266,14,324,875,0,37.03,5.03
臺南市,鹽水區,岸內里,1449,531,918,14,1463,3815,0,38.35,13.92
臺南市,鹽水區,歡雅里,607,169,438,7,614,1621,0,37.88,10.43
臺南市,鹽水區,津城里,610,223,387,5,615,1413,0,43.52,15.78
臺南市,鹽水區,月港里,649,282,367,4,653,1575,0,41.46,17.9
臺南市,鹽水區,三明里,622,143,479,5,627,1519,0,41.28,9.41
臺南市,鹽水區,義中里,563,154,409,7,570,1545,0,36.89,9.97
臺南市,鹽水區,文昌里,366,96,270,3,369,981,0,37.61,9.79
臺南市,鹽水區,竹林里,434,106,328,10,444,1073,0,41.38,9.88
臺南市,鹽水區,三和里,369,114,255,7,376,900,0,41.78,12.67
臺南市,鹽水區,坔頭港里,465,132,333,10,475,1360,0,34.93,9.71
臺南市,鹽水區,合計,8323,2667,5656,110,8433,21950,24892,38.42,12.15
臺南市,白河區,白河里,671,218,453,3,674,1688,0,39.93,12.91
臺南市,白河區,永安里,1273,443,830,4,1277,2937,0,43.48,15.08
臺南市,白河區,外角里,546,180,366,4,550,1364,0,40.32,13.2
臺南市,白河區,庄內里,643,201,442,9,652,1596,0,40.85,12.59
臺南市,白河區,秀祐里,335,110,225,7,342,874,0,39.13,12.59
臺南市,白河區,河東里,543,175,368,11,554,1334,0,41.53,13.12
臺南市,白河區,虎山里,175,62,113,3,178,440,0,40.45,14.09
臺南市,白河區,大林里,182,40,142,1,183,560,0,32.68,7.14
臺南市,白河區,崁頭里,121,39,82,2,123,369,0,33.33,10.57
臺南市,白河區,六溪里,159,37,122,3,162,487,0,33.26,7.6
臺南市,白河區,仙草里,380,139,241,8,388,1178,0,32.94,11.8
臺南市,白河區,關嶺里,333,86,247,4,337,1001,0,33.67,8.59
臺南市,白河區,大竹里,494,159,335,4,498,1380,0,36.09,11.52
臺南市,白河區,竹門里,318,107,211,7,325,836,0,38.88,12.8
臺南市,白河區,崎內里,190,87,103,4,194,705,0,27.52,12.34
臺南市,白河區,昇安里,475,130,345,8,483,1303,0,37.07,9.98
臺南市,白河區,汴頭里,280,72,208,5,285,707,0,40.31,10.18
臺南市,白河區,內角里,253,81,172,4,257,657,0,39.12,12.33
臺南市,白河區,詔豐里,748,210,538,7,755,1930,0,39.12,10.88
臺南市,白河區,廣蓮里,584,161,423,6,590,1458,0,40.47,11.04
臺南市,白河區,馬稠後里,441,124,317,11,452,1318,0,34.29,9.41
臺南市,白河區,合計,9144,2861,6283,115,9259,24122,26978,38.38,11.86
臺南市,柳營區,士林里,711,236,475,10,721,1825,0,39.51,12.93
臺南市,柳營區,光福里,705,251,454,3,708,1608,0,44.03,15.61
臺南市,柳營區,中埕里,448,172,276,5,453,1107,0,40.92,15.54
臺南市,柳營區,東昇里,1093,399,694,9,1102,2722,0,40.48,14.66
臺南市,柳營區,八翁里,507,173,334,4,511,1368,0,37.35,12.65
臺南市,柳營區,人和里,297,105,192,1,298,727,0,40.99,14.44
臺南市,柳營區,太康里,601,206,395,15,616,1454,0,42.37,14.17
臺南市,柳營區,重溪里,645,187,458,7,652,1738,0,37.51,10.76
臺南市,柳營區,篤農里,470,144,326,5,475,1275,0,37.25,11.29
臺南市,柳營區,大農里,254,56,198,4,258,652,0,39.57,8.59
臺南市,柳營區,神農里,482,145,337,8,490,1337,0,36.65,10.85
臺南市,柳營區,果毅里,437,128,309,4,441,1192,0,37.0,10.74
臺南市,柳營區,旭山里,503,156,347,4,507,1517,0,33.42,10.28
臺南市,柳營區,合計,7153,2358,4795,79,7232,18522,20733,39.05,12.73
臺南市,後壁區,後壁里,691,269,422,6,697,1620,0,43.02,16.6
臺南市,後壁區,侯伯里,507,170,337,4,511,1264,0,40.43,13.45
臺南市,後壁區,嘉苳里,479,158,321,6,485,1275,0,38.04,12.39
臺南市,後壁區,土溝里,527,139,388,5,532,1304,0,40.8,10.66
臺南市,後壁區,竹新里,573,118,455,8,581,1336,0,43.49,8.83
臺南市,後壁區,新東里,607,177,430,6,613,1610,0,38.07,10.99
臺南市,後壁區,頂安里,480,187,293,11,491,1223,0,40.15,15.29
臺南市,後壁區,長安里,505,197,308,8,513,1216,0,42.19,16.2
臺南市,後壁區,福安里,683,238,445,8,691,1753,0,39.42,13.58
臺南市,後壁區,菁寮里,564,183,381,7,571,1379,0,41.41,13.27
臺南市,後壁區,新嘉里,303,82,221,4,307,966,0,31.78,8.49
臺南市,後壁區,長短樹里,811,251,560,23,834,1961,0,42.53,12.8
臺南市,後壁區,上茄苳里,859,249,610,14,873,2164,0,40.34,11.51
臺南市,後壁區,菁豐里,448,150,298,8,456,1194,0,38.19,12.56
臺南市,後壁區,合計,8037,2568,5469,118,8155,20265,22532,40.24,12.67
臺南市,東山區,東山里,476,199,277,6,482,1400,0,34.43,14.21
臺南市,東山區,東中里,869,340,529,6,875,2475,0,35.35,13.74
臺南市,東山區,東正里,469,134,335,3,472,1405,0,33.59,9.54
臺南市,東山區,三榮里,285,88,197,3,288,920,0,31.3,9.57
臺南市,東山區,大客里,296,100,196,2,298,1058,0,28.17,9.45
臺南市,東山區,科里里,415,137,278,9,424,1193,0,35.54,11.48
臺南市,東山區,東河里,290,74,216,10,300,826,0,36.32,8.96
臺南市,東山區,南溪里,115,30,85,3,118,420,0,28.1,7.14
臺南市,東山區,水雲里,106,28,78,0,106,376,0,28.19,7.45
臺南市,東山區,林安里,136,43,93,4,140,370,0,37.84,11.62
臺南市,東山區,東原里,621,246,375,7,628,2040,0,30.78,12.06
臺南市,東山區,嶺南里,147,55,92,1,148,647,0,22.87,8.5
臺南市,東山區,南勢里,277,92,185,3,280,1054,0,26.57,8.73
臺南市,東山區,青山里,300,112,188,4,304,1052,0,28.9,10.65
臺南市,東山區,高原里,217,109,108,4,221,877,0,25.2,12.43
臺南市,東山區,聖賢里,721,212,509,12,733,1847,0,39.69,11.48
臺南市,東山區,合計,5740,1999,3741,77,5817,17960,19922,32.39,11.13
臺南市,麻豆區,東角里,1123,387,736,10,1133,2562,0,44.22,15.11
臺南市,麻豆區,晋江里,1103,309,794,17,1120,2463,0,45.47,12.55
臺南市,麻豆區,巷口里,969,317,652,6,975,2086,0,46.74,15.2
臺南市,麻豆區,中興里,849,290,559,9,858,1936,0,44.32,14.98
臺南市,麻豆區,興農里,647,192,455,6,653,1433,0,45.57,13.4
臺南市,麻豆區,油車里,1590,420,1170,13,1603,3474,0,46.14,12.09
臺南市,麻豆區,北勢里,456,78,378,5,461,1093,0,42.18,7.14
臺南市,麻豆區,大埕里,1247,358,889,12,1259,2846,0,44.24,12.58
臺南市,麻豆區,南勢里,994,349,645,6,1000,2315,0,43.2,15.08
臺南市,麻豆區,寮廍里,748,152,596,3,751,1645,0,45.65,9.24
臺南市,麻豆區,埤頭里,954,204,750,9,963,2284,0,42.16,8.93
臺南市,麻豆區,海埔里,830,198,632,17,847,2089,0,40.55,9.48
臺南市,麻豆區,港尾里,518,142,376,6,524,1232,0,42.53,11.53
臺南市,麻豆區,麻口里,445,95,350,4,449,1171,0,38.34,8.11
臺南市,麻豆區,安業里,628,147,481,5,633,1297,0,48.8,11.33
臺南市,麻豆區,安正里,377,95,282,2,379,925,0,40.97,10.27
臺南市,麻豆區,新興里,794,208,586,11,805,1871,0,43.03,11.12
臺南市,麻豆區,謝厝寮里,774,157,617,14,788,1633,0,48.25,9.61
臺南市,麻豆區,井東里,752,174,578,8,760,1704,0,44.6,10.21
臺南市,麻豆區,清水里,618,175,443,7,625,1449,0,43.13,12.08
臺南市,麻豆區,合計,16416,4447,11969,170,16586,37508,43610,44.22,11.86
臺南市,下營區,下營里,615,245,370,6,621,1503,0,41.32,16.3
臺南市,下營區,仁里里,701,232,469,6,707,1925,0,36.73,12.05
臺南市,下營區,宅內里,607,230,377,7,614,1601,0,38.35,14.37
臺南市,下營區,後街里,611,229,382,4,615,1555,0,39.55,14.73
臺南市,下營區,新興里,681,237,444,5,686,1945,0,35.27,12.19
臺南市,下營區,營前里,806,282,524,12,818,2079,0,39.35,13.56
臺南市,下營區,開化里,727,203,524,8,735,1817,0,40.45,11.17
臺南市,下營區,西連里,390,101,289,7,397,866,0,45.84,11.66
臺南市,下營區,賀建里,424,129,295,3,427,1269,0,33.65,10.17
臺南市,下營區,茅營里,850,233,617,9,859,2146,0,40.03,10.86
臺南市,下營區,大吉里,562,199,363,12,574,1539,0,37.3,12.93
臺南市,下營區,紅甲里,850,212,638,17,867,2173,0,39.9,9.76
臺南市,下營區,合計,7824,2532,5292,96,7920,20418,23214,38.79,12.4
臺南市,六甲區,六甲里,1061,349,712,9,1070,2866,0,37.33,12.18
臺南市,六甲區,甲東里,956,291,665,15,971,2601,0,37.33,11.19
臺南市,六甲區,甲南里,545,189,356,7,552,1327,0,41.6,14.24
臺南市,六甲區,七甲里,695,205,490,9,704,1910,0,36.86,10.73
臺南市,六甲區,二甲里,1260,402,858,14,1274,3299,0,38.62,12.19
臺南市,六甲區,水林里,770,240,530,6,776,2062,0,37.63,11.64
臺南市,六甲區,中社里,616,210,406,8,624,1583,0,39.42,13.27
臺南市,六甲區,龜港里,474,160,314,6,480,1229,0,39.06,13.02
臺南市,六甲區,菁埔里,265,102,163,3,268,583,0,45.97,17.5
臺南市,六甲區,王爺里,194,58,136,2,196,719,0,27.26,8.07
臺南市,六甲區,大丘里,183,50,133,2,185,580,0,31.9,8.62
臺南市,六甲區,合計,7019,2256,4763,81,7100,18759,21572,37.85,12.03
臺南市,官田區,官田里,809,264,545,8,817,2045,0,39.95,12.91
臺南市,官田區,二鎮里,1317,311,1006,13,1330,3141,0,42.34,9.9
臺南市,官田區,大崎里,145,51,94,1,146,402,0,36.32,12.69
臺南市,官田區,隆田里,781,295,486,12,793,1948,0,40.71,15.14
臺南市,官田區,隆本里,1410,543,867,15,1425,3476,0,41.0,15.62
臺南市,官田區,南廍里,459,227,232,2,461,1243,0,37.09,18.26
臺南市,官田區,社子里,313,70,243,3,316,855,0,36.96,8.19
臺南市,官田區,烏山頭里,523,142,381,2,525,1197,0,43.86,11.86
臺南市,官田區,渡拔里,1078,333,745,22,1100,2498,0,44.04,13.33
臺南市,官田區,東西庄里,802,113,689,12,814,1798,0,45.27,6.28
臺南市,官田區,合計,7637,2349,5288,90,7727,18603,21123,41.54,12.63
臺南市,大內區,石湖里,385,123,262,4,389,992,0,39.21,12.4
臺南市,大內區,石林里,229,54,175,6,235,619,0,37.96,8.72
臺南市,大內區,石城里,523,136,387,6,529,1411,0,37.49,9.64
臺南市,大內區,內江里,328,126,202,2,330,885,0,37.29,14.24
臺南市,大內區,大內里,352,121,231,4,356,744,0,47.85,16.26
臺南市,大內區,內郭里,250,71,179,2,252,598,0,42.14,11.87
臺南市,大內區,頭社里,337,101,236,3,340,969,0,35.09,10.42
臺南市,大內區,環湖里,237,70,167,4,241,722,0,33.38,9.7
臺南市,大內區,二溪里,327,120,207,4,331,822,0,40.27,14.6
臺南市,大內區,曲溪里,222,50,172,4,226,550,0,41.09,9.09
臺南市,大內區,合計,3190,972,2218,39,3229,8312,9096,38.85,11.69
臺南市,佳里區,東寧里,997,338,659,10,1007,2192,0,45.94,15.42
臺南市,佳里區,忠仁里,1081,331,750,8,1089,2827,0,38.52,11.71
臺南市,佳里區,鎮山里,2155,718,1437,15,2170,5534,0,39.21,12.97
臺南市,佳里區,建南里,1603,571,1032,12,1615,4239,0,38.1,13.47
臺南市,佳里區,安西里,2281,800,1481,15,2296,5723,0,40.12,13.98
臺南市,佳里區,六安里,1576,597,979,14,1590,3989,0,39.86,14.97
臺南市,佳里區,佳化里,813,253,560,6,819,2115,0,38.72,11.96
臺南市,佳里區,海澄里,771,237,534,10,781,2153,0,36.27,11.01
臺南市,佳里區,民安里,666,169,497,1,667,1660,0,40.18,10.18
臺南市,佳里區,子龍里,984,262,722,14,998,2328,0,42.87,11.25
臺南市,佳里區,營溪里,398,142,256,10,408,1045,0,39.04,13.59
臺南市,佳里區,文新里,2025,805,1220,4,2029,5063,0,40.08,15.9
臺南市,佳里區,佳興里,897,248,649,11,908,2103,0,43.18,11.79
臺南市,佳里區,下營里,721,219,502,4,725,1786,0,40.59,12.26
臺南市,佳里區,塭內里,1055,265,790,15,1070,2729,0,39.21,9.71
臺南市,佳里區,南勢里,1692,554,1138,9,1701,4415,0,38.53,12.55
臺南市,佳里區,合計,19715,6509,13206,158,19873,49901,58600,39.82,13.04
臺南市,學甲區,仁得里,1588,488,1100,9,1597,3771,0,42.35,12.94
臺南市,學甲區,新榮里,886,272,614,4,890,2308,0,38.56,11.79
臺南市,學甲區,光華里,459,106,353,0,459,1207,0,38.03,8.78
臺南市,學甲區,宅港里,280,89,191,7,287,771,0,37.22,11.54
臺南市,學甲區,慈福里,773,292,481,9,782,1967,0,39.76,14.84
臺南市,學甲區,秀昌里,954,285,669,12,966,2463,0,39.22,11.57
臺南市,學甲區,明宜里,779,196,583,5,784,1887,0,41.55,10.39
臺南市,學甲區,豐和里,446,100,346,5,451,1175,0,38.38,8.51
臺南市,學甲區,平和里,374,65,309,3,377,1001,0,37.66,6.49
臺南市,學甲區,新達里,786,270,516,11,797,2054,0,38.8,13.15
臺南市,學甲區,大灣里,383,104,279,2,385,939,0,41.0,11.08
臺南市,學甲區,三慶里,477,147,330,6,483,1310,0,36.87,11.22
臺南市,學甲區,中洲里,467,135,332,6,473,1367,0,34.6,9.88
臺南市,學甲區,合計,8652,2549,6103,79,8731,22220,25121,39.29,11.47
臺南市,西港區,西港里,1238,356,882,17,1255,3112,0,40.33,11.44
臺南市,西港區,南海里,982,264,718,9,991,2413,0,41.07,10.94
臺南市,西港區,港東里,600,168,432,3,603,1625,0,37.11,10.34
臺南市,西港區,檨林里,546,139,407,4,550,1640,0,33.54,8.48
臺南市,西港區,後營里,497,116,381,10,507,1436,0,35.31,8.08
臺南市,西港區,營西里,472,126,346,4,476,1456,0,32.69,8.65
臺南市,西港區,金砂里,314,79,235,5,319,758,0,42.08,10.42
臺南市,西港區,劉厝里,492,145,347,9,501,1338,0,37.44,10.84
臺南市,西港區,竹林里,557,138,419,4,561,1342,0,41.8,10.28
臺南市,西港區,永樂里,537,136,401,6,543,1352,0,40.16,10.06
臺南市,西港區,新復里,282,108,174,4,286,805,0,35.53,13.42
臺南市,西港區,慶安里,1566,515,1051,19,1585,4193,0,37.8,12.28
臺南市,西港區,合計,8083,2290,5793,94,8177,21470,24521,38.09,10.67
臺南市,七股區,後港里,391,95,296,2,393,998,0,39.38,9.52
臺南市,七股區,大潭里,232,48,184,4,236,648,0,36.42,7.41
臺南市,七股區,篤加里,307,94,213,1,308,820,0,37.56,11.46
臺南市,七股區,頂山里,309,98,211,2,311,809,0,38.44,12.11
臺南市,七股區,西寮里,164,40,124,1,165,444,0,37.16,9.01
臺南市,七股區,塩埕里,153,30,123,2,155,410,0,37.8,7.32
臺南市,七股區,龍山里,609,124,485,7,616,1608,0,38.31,7.71
臺南市,七股區,溪南里,129,48,81,0,129,343,0,37.61,13.99
臺南市,七股區,七股里,346,76,270,1,347,861,0,40.3,8.83
臺南市,七股區,玉成里,275,84,191,6,281,775,0,36.26,10.84
臺南市,七股區,大埕里,884,206,678,8,892,2548,0,35.01,8.08
臺南市,七股區,樹林里,625,141,484,10,635,1894,0,33.53,7.44
臺南市,七股區,中寮里,236,58,178,3,239,683,0,34.99,8.49
臺南市,七股區,竹橋里,479,140,339,11,490,1214,0,40.36,11.53
臺南市,七股區,義合里,709,197,512,8,717,1858,0,38.59,10.6
臺南市,七股區,永吉里,346,119,227,2,348,992,0,35.08,12.0
臺南市,七股區,三股里,444,122,322,2,446,1329,0,33.56,9.18
臺南市,七股區,十份里,431,146,285,4,435,1361,0,31.96,10.73
臺南市,七股區,合計,7069,1866,5203,74,7143,19595,21996,36.45,9.52
臺南市,將軍區,長榮里,435,133,302,4,439,1136,0,38.64,11.71
臺南市,將軍區,玉山里,262,47,215,1,263,821,0,32.03,5.72
臺南市,將軍區,廣山里,183,65,118,4,187,636,0,29.4,10.22
臺南市,將軍區,長沙里,449,100,349,5,454,1312,0,34.6,7.62
臺南市,將軍區,平沙里,429,99,330,6,435,1171,0,37.15,8.45
臺南市,將軍區,鯤鯓里,655,128,527,7,662,1862,0,35.55,6.87
臺南市,將軍區,鯤溟里,272,56,216,6,278,946,0,29.39,5.92
臺南市,將軍區,巷埔里,469,97,372,4,473,1166,0,40.57,8.32
臺南市,將軍區,西甲里,909,258,651,11,920,2358,0,39.02,10.94
臺南市,將軍區,忠嘉里,845,249,596,16,861,2413,0,35.68,10.32
臺南市,將軍區,苓仔寮里,756,202,554,12,768,1964,0,39.1,10.29
臺南市,將軍區,將軍里,547,159,388,3,550,1528,0,35.99,10.41
臺南市,將軍區,合計,6211,1593,4618,79,6290,17313,18966,36.33,9.2
臺南市,北門區,保吉里,385,135,250,4,389,1309,0,29.72,10.31
臺南市,北門區,雙春里,147,54,93,2,149,451,0,33.04,11.97
臺南市,北門區,北門里,271,105,166,1,272,820,0,33.17,12.8
臺南市,北門區,錦湖里,249,95,154,2,251,909,0,27.61,10.45
臺南市,北門區,三光里,392,138,254,8,400,1152,0,34.72,11.98
臺南市,北門區,玉港里,243,65,178,4,247,702,0,35.19,9.26
臺南市,北門區,慈安里,201,67,134,0,201,726,0,27.69,9.23
臺南市,北門區,永隆里,282,103,179,3,285,843,0,33.81,12.22
臺南市,北門區,蚵寮里,429,137,292,3,432,1415,0,30.53,9.68
臺南市,北門區,文山里,433,116,317,7,440,1222,0,36.01,9.49
臺南市,北門區,合計,3032,1015,2017,34,3066,9549,10460,32.11,10.63
臺南市,新化區,武安里,1348,592,756,15,1363,3038,0,44.87,19.49
臺南市,新化區,東榮里,1583,664,919,10,1593,3973,0,40.1,16.71
臺南市,新化區,護國里,1082,427,655,6,1088,2724,0,39.94,15.68
臺南市,新化區,太平里,1833,681,1152,16,1849,4411,0,41.92,15.44
臺南市,新化區,協興里,1285,519,766,15,1300,3203,0,40.59,16.2
臺南市,新化區,唪口里,854,302,552,7,861,2153,0,39.99,14.03
臺南市,新化區,北勢里,563,195,368,3,566,1482,0,38.19,13.16
臺南市,新化區,豐榮里,1198,498,700,22,1220,3226,0,37.82,15.44
臺南市,新化區,全興里,1092,481,611,13,1105,2804,0,39.41,17.15
臺南市,新化區,崙頂里,851,269,582,7,858,2123,0,40.41,12.67
臺南市,新化區,知義里,834,300,534,8,842,2155,0,39.07,13.92
臺南市,新化區,山脚里,573,200,373,6,579,1679,0,34.48,11.91
臺南市,新化區,大坑里,162,37,125,0,162,425,0,38.12,8.71
臺南市,新化區,𦰡拔里,739,307,432,6,745,2087,0,35.7,14.71
臺南市,新化區,羊林里,355,134,221,2,357,899,0,39.71,14.91
臺南市,新化區,礁坑里,379,72,307,5,384,933,0,41.16,7.72
臺南市,新化區,合計,14731,5678,9053,141,14872,37315,43049,39.86,15.22
臺南市,善化區,東關里,439,174,265,5,444,1123,0,39.54,15.49
臺南市,善化區,坐駕里,1557,659,898,18,1575,3901,0,40.37,16.89
臺南市,善化區,光文里,2210,896,1314,18,2228,5414,0,41.15,16.55
臺南市,善化區,文昌里,1014,385,629,8,1022,2685,0,38.06,14.34
臺南市,善化區,南關里,733,231,502,7,740,1791,0,41.32,12.9
臺南市,善化區,文正里,626,208,418,6,632,1601,0,39.48,12.99
臺南市,善化區,胡家里,531,105,426,6,537,1235,0,43.48,8.5
臺南市,善化區,胡厝里,837,256,581,14,851,2010,0,42.34,12.74
臺南市,善化區,什乃里,496,145,351,4,500,1226,0,40.78,11.83
臺南市,善化區,溪美里,840,316,524,9,849,1944,0,43.67,16.26
臺南市,善化區,六分里,284,65,219,2,286,677,0,42.25,9.6
臺南市,善化區,六德里,393,95,298,4,397,1041,0,38.14,9.13
臺南市,善化區,田寮里,671,185,486,9,680,1684,0,40.38,10.99
臺南市,善化區,牛庄里,675,226,449,15,690,1608,0,42.91,14.05
臺南市,善化區,嘉北里,637,191,446,10,647,1587,0,40.77,12.04
臺南市,善化區,嘉南里,429,106,323,1,430,1068,0,40.26,9.93
臺南市,善化區,小新里,1681,618,1063,14,1695,4425,0,38.31,13.97
臺南市,善化區,頂街里,482,183,299,2,484,1117,0,43.33,16.38
臺南市,善化區,昌隆里,776,229,547,14,790,1945,0,40.62,11.77
臺南市,善化區,蓮潭里,1370,569,801,6,1376,3324,0,41.4,17.12
臺南市,善化區,合計,16681,5842,10839,172,16853,41406,51052,40.7,14.11
臺南市,新市區,新市里,1140,416,724,13,1153,2990,0,38.56,13.91
臺南市,新市區,新和里,2655,1033,1622,22,2677,6488,0,41.26,15.92
臺南市,新市區,社內里,1113,353,760,7,1120,2768,0,40.46,12.75
臺南市,新市區,大洲里,313,88,225,5,318,714,0,44.54,12.32
臺南市,新市區,豐華里,317,97,220,3,320,870,0,36.78,11.15
臺南市,新市區,三舍里,610,191,419,3,613,1563,0,39.22,12.22
臺南市,新市區,大營里,1254,493,761,6,1260,3380,0,37.28,14.59
臺南市,新市區,大社里,1726,499,1227,14,1740,4530,0,38.41,11.02
臺南市,新市區,潭頂里,677,197,480,5,682,1790,0,38.1,11.01
臺南市,新市區,港墘里,1163,393,770,17,1180,3330,0,35.44,11.8
臺南市,新市區,永就里,1235,475,760,9,1244,2946,0,42.23,16.12
臺南市,新市區,合計,12203,4235,7968,104,12307,31369,37721,39.23,13.5
臺南市,安定區,蘇林里,905,266,639,19,924,2065,0,44.75,12.88
臺南市,安定區,蘇厝里,780,258,522,5,785,2038,0,38.52,12.66
臺南市,安定區,安定里,568,185,383,2,570,1381,0,41.27,13.4
臺南市,安定區,安加里,892,280,612,10,902,2194,0,41.11,12.76
臺南市,安定區,港尾里,587,190,397,5,592,1485,0,39.87,12.79
臺南市,安定區,中榮里,716,240,476,9,725,1715,0,42.27,13.99
臺南市,安定區,港口里,1190,421,769,11,1201,2901,0,41.4,14.51
臺南市,安定區,港南里,1092,313,779,11,1103,2658,0,41.5,11.78
臺南市,安定區,中沙里,317,106,211,0,317,715,0,44.34,14.83
臺南市,安定區,新吉里,977,279,698,7,984,2448,0,40.2,11.4
臺南市,安定區,海寮里,1033,332,701,13,1046,2574,0,40.64,12.9
臺南市,安定區,文科里,678,192,486,5,683,1609,0,42.45,11.93
臺南市,安定區,嘉同里,924,271,653,13,937,2380,0,39.37,11.39
臺南市,安定區,合計,10659,3333,7326,110,10769,26163,30286,41.16,12.74
臺南市,山上區,明和里,573,209,364,7,580,1662,0,34.9,12.58
臺南市,山上區,南洲里,640,211,429,11,651,1522,0,42.77,13.86
臺南市,山上區,山上里,337,123,214,10,347,961,0,36.11,12.8
臺南市,山上區,新莊里,304,87,217,3,307,930,0,33.01,9.35
臺南市,山上區,玉峯里,196,70,126,3,199,560,0,35.54,12.5
臺南市,山上區,平陽里,137,63,74,1,138,351,0,39.32,17.95
臺南市,山上區,豐德里,121,43,78,5,126,392,0,32.14,10.97
臺南市,山上區,合計,2308,806,1502,40,2348,6378,7053,36.81,12.64
臺南市,玉井區,玉井里,449,240,209,5,454,1202,0,37.77,19.97
臺南市,玉井區,玉田里,1263,671,592,17,1280,3556,0,36.0,18.87
臺南市,玉井區,中正里,485,216,269,6,491,1198,0,40.98,18.03
臺南市,玉井區,竹圍里,479,229,250,7,486,1398,0,34.76,16.38
臺南市,玉井區,沙田里,197,98,99,7,204,497,0,41.05,19.72
臺南市,玉井區,三埔里,176,58,118,1,177,490,0,36.12,11.84
臺南市,玉井區,三和里,292,122,170,3,295,731,0,40.36,16.69
臺南市,玉井區,望明里,497,222,275,4,501,1428,0,35.08,15.55
臺南市,玉井區,層林里,204,74,130,4,208,580,0,35.86,12.76
臺南市,玉井區,豐里里,317,131,186,7,324,945,0,34.29,13.86
臺南市,玉井區,合計,4359,2061,2298,61,4420,12025,13483,36.76,17.14
臺南市,楠西區,楠西里,586,335,251,8,594,1779,0,33.39,18.83
臺南市,楠西區,灣丘里,291,127,164,3,294,1071,0,27.45,11.86
臺南市,楠西區,密枝里,203,107,96,1,204,681,0,29.96,15.71
臺南市,楠西區,照興里,306,133,173,2,308,951,0,32.39,13.99
臺南市,楠西區,鹿田里,312,182,130,5,317,894,0,35.46,20.36
臺南市,楠西區,龜丹里,204,95,109,4,208,639,0,32.55,14.87
臺南市,楠西區,東勢里,729,375,354,10,739,2215,0,33.36,16.93
臺南市,楠西區,合計,2631,1354,1277,33,2664,8230,9115,32.37,16.45
臺南市,南化區,南化里,539,227,312,7,546,1343,0,40.66,16.9
臺南市,南化區,小崙里,216,95,121,3,219,764,0,28.66,12.43
臺南市,南化區,中坑里,118,59,59,1,119,404,0,29.46,14.6
臺南市,南化區,北平里,200,77,123,5,205,547,0,37.48,14.08
臺南市,南化區,東和里,176,75,101,0,176,620,0,28.39,12.1
臺南市,南化區,西埔里,209,96,113,2,211,725,0,29.1,13.24
臺南市,南化區,北寮里,346,166,180,1,347,1130,0,30.71,14.69
臺南市,南化區,玉山里,311,146,165,3,314,1027,0,30.57,14.22
臺南市,南化區,關山里,182,104,78,3,185,948,0,19.51,10.97
臺南市,南化區,合計,2297,1045,1252,25,2322,7508,8305,30.93,13.92
臺南市,左鎮區,光和里,126,50,76,0,126,359,0,35.1,13.93
臺南市,左鎮區,榮和里,226,64,162,5,231,612,0,37.75,10.46
臺南市,左鎮區,左鎮里,157,60,97,5,162,456,0,35.53,13.16
臺南市,左鎮區,中正里,235,115,120,1,236,717,0,32.91,16.04
臺南市,左鎮區,睦光里,119,55,64,2,121,333,0,36.34,16.52
臺南市,左鎮區,內庄里,148,61,87,3,151,355,0,42.54,17.18
臺南市,左鎮區,澄山里,166,32,134,4,170,488,0,34.84,6.56
臺南市,左鎮區,岡林里,137,40,97,0,137,407,0,33.66,9.83
臺南市,左鎮區,草山里,95,35,60,3,98,286,0,34.27,12.24
臺南市,左鎮區,二寮里,90,21,69,0,90,179,0,50.28,11.73
臺南市,左鎮區,合計,1499,533,966,23,1522,4192,4475,36.31,12.71
臺南市,仁德區,太子里,2402,714,1688,21,2423,5421,0,44.7,13.17
臺南市,仁德區,土庫里,1252,318,934,10,1262,2737,0,46.11,11.62
臺南市,仁德區,一甲里,1113,414,699,11,1124,2570,0,43.74,16.11
臺南市,仁德區,仁德里,3048,1224,1824,24,3072,7630,0,40.26,16.04
臺南市,仁德區,仁義里,3928,1539,2389,24,3952,9033,0,43.75,17.04
臺南市,仁德區,新田里,1469,522,947,10,1479,3381,0,43.74,15.44
臺南市,仁德區,後壁里,3797,1422,2375,29,3826,9317,0,41.06,15.26
臺南市,仁德區,上崙里,2349,795,1554,29,2378,6025,0,39.47,13.2
臺南市,仁德區,保安里,1082,400,682,6,1088,2705,0,40.22,14.79
臺南市,仁德區,成功里,2104,1104,1000,27,2131,4809,0,44.31,22.96
臺南市,仁德區,仁和里,688,553,135,11,699,1493,0,46.82,37.04
臺南市,仁德區,仁愛里,529,293,236,5,534,1211,0,44.1,24.19
臺南市,仁德區,二行里,818,297,521,7,825,2102,0,39.25,14.13
臺南市,仁德區,大甲里,879,300,579,16,895,2110,0,42.42,14.22
臺南市,仁德區,中洲里,1071,363,708,18,1089,2612,0,41.69,13.9
臺南市,仁德區,文賢里,926,309,617,9,935,2215,0,42.21,13.95
臺南市,仁德區,合計,27455,10567,16888,257,27712,65371,76229,42.39,16.16
臺南市,歸仁區,南保里,2435,842,1593,12,2447,5856,0,41.79,14.38
臺南市,歸仁區,六甲里,1382,424,958,6,1388,3838,0,36.16,11.05
臺南市,歸仁區,歸仁里,923,373,550,10,933,2285,0,40.83,16.32
臺南市,歸仁區,後市里,1339,454,885,14,1353,3225,0,41.95,14.08
臺南市,歸仁區,辜厝里,1341,501,840,7,1348,3248,0,41.5,15.42
臺南市,歸仁區,許厝里,1324,457,867,13,1337,3254,0,41.09,14.04
臺南市,歸仁區,看西里,932,321,611,7,939,2155,0,43.57,14.9
臺南市,歸仁區,看東里,764,285,479,8,772,1781,0,43.35,16.0
臺南市,歸仁區,崙頂里,1360,438,922,13,1373,3017,0,45.51,14.52
臺南市,歸仁區,沙崙里,276,88,188,3,279,692,0,40.32,12.72
臺南市,歸仁區,大潭里,742,208,534,10,752,1871,0,40.19,11.12
臺南市,歸仁區,武東里,646,235,411,5,651,1767,0,36.84,13.3
臺南市,歸仁區,八甲里,1177,382,795,10,1187,2678,0,44.32,14.26
臺南市,歸仁區,七甲里,1409,478,931,17,1426,3293,0,43.3,14.52
臺南市,歸仁區,媽廟里,843,244,599,10,853,1938,0,44.01,12.59
臺南市,歸仁區,西埔里,738,222,516,7,745,1652,0,45.1,13.44
臺南市,歸仁區,大廟里,1275,424,851,12,1287,3037,0,42.38,13.96
臺南市,歸仁區,南興里,1767,658,1109,20,1787,4221,0,42.34,15.59
臺南市,歸仁區,新厝里,970,314,656,4,974,2447,0,39.8,12.83
臺南市,歸仁區,歸南里,962,310,652,4,966,2218,0,43.55,13.98
臺南市,歸仁區,文化里,1221,438,783,11,1232,2952,0,41.73,14.84
臺南市,歸仁區,合計,23826,8096,15730,203,24029,57425,68074,41.84,14.1
臺南市,關廟區,關廟里,960,330,630,19,979,2249,0,43.53,14.67
臺南市,關廟區,山西里,855,263,592,5,860,2011,0,42.76,13.08
臺南市,關廟區,香洋里,1440,535,905,9,1449,3209,0,45.15,16.67
臺南市,關廟區,北勢里,1041,320,721,14,1055,2473,0,42.66,12.94
臺南市,關廟區,新埔里,368,113,255,7,375,1038,0,36.13,10.89
臺南市,關廟區,新光里,285,76,209,1,286,695,0,41.15,10.94
臺南市,關廟區,五甲里,1270,466,804,12,1282,3182,0,40.29,14.64
臺南市,關廟區,東勢里,1208,407,801,17,1225,3141,0,39.0,12.96
臺南市,關廟區,松腳里,754,222,532,10,764,1949,0,39.2,11.39
臺南市,關廟區,深坑里,592,207,385,6,598,1468,0,40.74,14.1
臺南市,關廟區,布袋里,474,124,350,7,481,1183,0,40.66,10.48
臺南市,關廟區,埤頭里,769,240,529,10,779,1936,0,40.24,12.4
臺南市,關廟區,下湖里,204,73,131,5,209,470,0,44.47,15.53
臺南市,關廟區,花園里,1387,415,972,11,1398,3442,0,40.62,12.06
臺南市,關廟區,南雄里,609,176,433,3,612,1494,0,40.96,11.78
臺南市,關廟區,合計,12216,3967,8249,136,12352,29940,33986,41.26,13.25
臺南市,龍崎區,崎頂里,372,126,246,8,380,990,0,38.38,12.73
臺南市,龍崎區,土崎里,211,63,148,2,213,601,0,35.44,10.48
臺南市,龍崎區,中坑里,53,20,33,0,53,152,0,34.87,13.16
臺南市,龍崎區,楠坑里,160,56,104,0,160,371,0,43.13,15.09
臺南市,龍崎區,牛埔里,127,50,77,3,130,300,0,43.33,16.67
臺南市,龍崎區,大坪里,125,65,60,1,126,286,0,44.06,22.73
臺南市,龍崎區,龍船里,121,70,51,1,122,416,0,29.33,16.83
臺南市,龍崎區,石𥕢里,134,56,78,4,138,429,0,32.17,13.05
臺南市,龍崎區,合計,1303,506,797,19,1322,3545,3720,37.29,14.27
臺南市,永康區,五王里,2207,924,1283,17,2224,5645,0,39.4,16.37
臺南市,永康區,網寮里,2742,1069,1673,23,2765,6942,0,39.83,15.4
臺南市,永康區,永康里,3077,1241,1836,19,3096,8806,0,35.16,14.09
臺南市,永康區,埔園里,2857,1048,1809,21,2878,7154,0,40.23,14.65
臺南市,永康區,大橋里,2332,1025,1307,19,2351,5595,0,42.02,18.32
臺南市,永康區,王行里,1005,306,699,9,1014,2455,0,41.3,12.46
臺南市,永康區,烏竹里,1092,405,687,8,1100,2791,0,39.41,14.51
臺南市,永康區,蔦松里,709,165,544,4,713,1847,0,38.6,8.93
臺南市,永康區,三民里,653,248,405,8,661,1503,0,43.98,16.5
臺南市,永康區,塩行里,2062,689,1373,14,2076,4855,0,42.76,14.19
臺南市,永康區,甲頂里,982,318,664,6,988,2226,0,44.38,14.29
臺南市,永康區,大灣里,1414,424,990,10,1424,3408,0,41.78,12.44
臺南市,永康區,東灣里,1422,410,1012,23,1445,3440,0,42.01,11.92
臺南市,永康區,西灣里,3003,1110,1893,22,3025,7237,0,41.8,15.34
臺南市,永康區,南灣里,1565,461,1104,6,1571,3833,0,40.99,12.03
臺南市,永康區,崑山里,2526,866,1660,18,2544,5820,0,43.71,14.88
臺南市,永康區,北灣里,1653,542,1111,13,1666,4081,0,40.82,13.28
臺南市,永康區,新樹里,824,265,559,8,832,2121,0,39.23,12.49
臺南市,永康區,復興里,710,494,216,8,718,1919,0,37.42,25.74
臺南市,永康區,復國里,3313,1759,1554,29,3342,8455,0,39.53,20.8
臺南市,永康區,建國里,770,467,303,13,783,1905,0,41.1,24.51
臺南市,永康區,神洲里,467,254,213,4,471,1264,0,37.26,20.09
臺南市,永康區,西勢里,2425,874,1551,25,2450,6123,0,40.01,14.27
臺南市,永康區,成功里,831,583,248,17,848,2032,0,41.73,28.69
臺南市,永康區,中興里,1388,713,675,10,1398,3317,0,42.15,21.5
臺南市,永康區,勝利里,2964,1497,1467,25,2989,7661,0,39.02,19.54
臺南市,永康區,龍潭里,2298,734,1564,21,2319,6139,0,37.77,11.96
臺南市,永康區,光復里,196,138,58,1,197,527,0,37.38,26.19
臺南市,永康區,塩洲里,2385,868,1517,14,2399,5686,0,42.19,15.27
臺南市,永康區,二王里,3157,1437,1720,20,3177,7749,0,41.0,18.54
臺南市,永康區,六合里,2252,1009,1243,12,2264,5449,0,41.55,18.52
臺南市,永康區,三合里,1396,607,789,12,1408,3456,0,40.74,17.56
臺南市,永康區,東橋里,2798,1120,1678,20,2818,7184,0,39.23,15.59
臺南市,永康區,安康里,1863,783,1080,17,1880,4806,0,39.12,16.29
臺南市,永康區,西橋里,1240,500,740,13,1253,3018,0,41.52,16.57
臺南市,永康區,尚頂里,1642,571,1071,13,1655,3737,0,44.29,15.28
臺南市,永康區,復華里,3644,1837,1807,25,3669,9242,0,39.7,19.88
臺南市,永康區,正強里,3024,1126,1898,25,3049,7578,0,40.23,14.86
臺南市,永康區,中華里,1329,694,635,12,1341,2787,0,48.12,24.9
臺南市,永康區,北興里,2039,773,1266,14,2053,4977,0,41.25,15.53
臺南市,永康區,龍埔里,1456,566,890,8,1464,3732,0,39.23,15.17
臺南市,永康區,永明里,1852,830,1022,23,1875,4598,0,40.78,18.05
臺南市,永康區,塩興里,1352,535,817,12,1364,3794,0,35.95,14.1
臺南市,永康區,合計,78916,32285,46631,641,79557,196894,235327,40.41,16.4
臺南市,東區,富裕里,965,388,577,6,971,2144,0,45.29,18.1
臺南市,東區,裕農里,1297,575,722,13,1310,2857,0,45.85,20.13
臺南市,東區,大智里,2803,1392,1411,19,2822,6524,0,43.26,21.34
臺南市,東區,崇學里,1286,554,732,12,1298,2838,0,45.74,19.52
臺南市,東區,泉南里,2063,864,1199,21,2084,4536,0,45.94,19.05
臺南市,東區,仁和里,1875,802,1073,15,1890,4489,0,42.1,17.87
臺南市,東區,後甲里,1187,492,695,12,1199,2816,0,42.58,17.47
臺南市,東區,東光里,2196,1055,1141,14,2210,4731,0,46.71,22.3
臺南市,東區,新東里,1155,567,588,4,1159,2370,0,48.9,23.92
臺南市,東區,中西里,1342,605,737,10,1352,2931,0,46.13,20.64
臺南市,東區,東安里,538,210,328,3,541,1309,0,41.33,16.04
臺南市,東區,崇明里,1825,916,909,8,1833,3981,0,46.04,23.01
臺南市,東區,自強里,2183,1032,1151,11,2194,5154,0,42.57,20.02
臺南市,東區,和平里,2115,912,1203,17,2132,5004,0,42.61,18.23
臺南市,東區,路東里,735,375,360,4,739,1574,0,46.95,23.82
臺南市,東區,大德里,653,278,375,5,658,1465,0,44.91,18.98
臺南市,東區,關聖里,2076,1037,1039,12,2088,4496,0,46.44,23.06
臺南市,東區,衛國里,650,283,367,9,659,1504,0,43.82,18.82
臺南市,東區,崇善里,2203,927,1276,10,2213,4969,0,44.54,18.66
臺南市,東區,富強里,1933,799,1134,18,1951,4395,0,44.39,18.18
臺南市,東區,圍下里,861,366,495,7,868,1797,0,48.3,20.37
臺南市,東區,小東里,1834,919,915,9,1843,4122,0,44.71,22.3
臺南市,東區,大學里,516,248,268,5,521,1038,0,50.19,23.89
臺南市,東區,龍山里,2156,965,1191,9,2165,4589,0,47.18,21.03
臺南市,東區,虎尾里,2277,979,1298,15,2292,5079,0,45.13,19.28
臺南市,東區,德高里,1414,566,848,12,1426,3195,0,44.63,17.72
臺南市,東區,莊敬里,1552,734,818,9,1561,3480,0,44.86,21.09
臺南市,東區,大福里,731,305,426,4,735,1609,0,45.68,18.96
臺南市,東區,忠孝里,1936,944,992,20,1956,4148,0,47.16,22.76
臺南市,東區,崇誨里,1110,587,523,4,1114,2346,0,47.49,25.02
臺南市,東區,東明里,1340,622,718,10,1350,2853,0,47.32,21.8
臺南市,東區,崇德里,2072,981,1091,15,2087,4400,0,47.43,22.3
臺南市,東區,東智里,1199,562,637,12,1211,2747,0,44.08,20.46
臺南市,東區,東聖里,933,395,538,6,939,2206,0,42.57,17.91
臺南市,東區,崇成里,1272,603,669,7,1279,2925,0,43.73,20.62
臺南市,東區,東門里,837,354,483,5,842,1800,0,46.78,19.67
臺南市,東區,成大里,835,410,425,5,840,1924,0,43.66,21.31
臺南市,東區,大同里,1249,570,679,5,1254,2848,0,44.03,20.01
臺南市,東區,德光里,1877,880,997,14,1891,3861,0,48.98,22.79
臺南市,東區,崇信里,1560,617,943,7,1567,4399,0,35.62,14.03
臺南市,東區,崇文里,2592,1255,1337,13,2605,5808,0,44.85,21.61
臺南市,東區,復興里,1462,572,890,18,1480,3284,0,45.07,17.42
臺南市,東區,裕聖里,2111,1086,1025,13,2124,4654,0,45.64,23.33
臺南市,東區,南聖里,1132,556,576,8,1140,2522,0,45.2,22.05
臺南市,東區,文聖里,1960,966,994,18,1978,4275,0,46.27,22.6
臺南市,東區,合計,67898,31105,36793,473,68371,151996,183689,44.98,20.46
臺南市,南區,竹溪里,824,402,422,6,830,1623,0,51.14,24.77
臺南市,南區,明德里,548,280,268,4,552,1383,0,39.91,20.25
臺南市,南區,大成里,797,352,445,4,801,1753,0,45.69,20.08
臺南市,南區,廣州里,1074,354,720,14,1088,2226,0,48.88,15.9
臺南市,南區,新昌里,952,382,570,10,962,2173,0,44.27,17.58
臺南市,南區,新興里,1246,469,777,11,1257,2697,0,46.61,17.39
臺南市,南區,田寮里,1377,564,813,7,1384,3096,0,44.7,18.22
臺南市,南區,國宅里,1240,431,809,5,1245,2875,0,43.3,14.99
臺南市,南區,光明里,1769,565,1204,20,1789,4140,0,43.21,13.65
臺南市,南區,明亮里,1591,551,1040,10,1601,3510,0,45.61,15.7
臺南市,南區,喜東里,903,241,662,6,909,2071,0,43.89,11.64
臺南市,南區,喜北里,952,226,726,10,962,2143,0,44.89,10.55
臺南市,南區,喜南里,544,116,428,2,546,1191,0,45.84,9.74
臺南市,南區,省躬里,1477,410,1067,10,1487,3849,0,38.63,10.65
臺南市,南區,興農里,1097,294,803,11,1108,2639,0,41.99,11.14
臺南市,南區,同安里,943,282,661,5,948,2169,0,43.71,13.0
臺南市,南區,佛壇里,1057,248,809,6,1063,2471,0,43.02,10.04
臺南市,南區,大林里,1040,536,504,7,1047,2187,0,47.87,24.51
臺南市,南區,大忠里,2017,880,1137,14,2031,4438,0,45.76,19.83
臺南市,南區,大恩里,1459,666,793,9,1468,3368,0,43.59,19.77
臺南市,南區,新生里,1503,1050,453,17,1520,3347,0,45.41,31.37
臺南市,南區,再興里,1055,392,663,4,1059,2222,0,47.66,17.64
臺南市,南區,明興里,1437,418,1019,8,1445,3277,0,44.1,12.76
臺南市,南區,文華里,1483,563,920,11,1494,3213,0,46.5,17.52
臺南市,南區,金華里,2124,798,1326,15,2139,4948,0,43.23,16.13
臺南市,南區,南都里,932,360,572,11,943,2683,0,35.15,13.42
臺南市,南區,開南里,2369,867,1502,14,2383,5627,0,42.35,15.41
臺南市,南區,彰南里,656,229,427,5,661,1531,0,43.17,14.96
臺南市,南區,建南里,2313,754,1559,13,2326,5014,0,46.39,15.04
臺南市,南區,郡南里,1563,577,986,13,1576,3483,0,45.25,16.57
臺南市,南區,府南里,1930,711,1219,16,1946,4744,0,41.02,14.99
臺南市,南區,文南里,2279,878,1401,13,2292,4978,0,46.04,17.64
臺南市,南區,鯤鯓里,688,249,439,5,693,1717,0,40.36,14.5
臺南市,南區,松安里,813,226,587,10,823,1752,0,46.97,12.9
臺南市,南區,永寧里,771,206,565,8,779,1700,0,45.82,12.12
臺南市,南區,南華里,980,357,623,6,986,2425,0,40.66,14.72
臺南市,南區,鹽埕里,1678,524,1154,9,1687,3641,0,46.33,14.39
臺南市,南區,合計,47481,17408,30073,349,47830,108304,123057,44.16,16.07
臺南市,北區,開元里,1446,634,812,12,1458,3350,0,43.52,18.93
臺南市,北區,東興里,934,508,426,7,941,1911,0,49.24,26.58
臺南市,北區,力行里,1092,548,544,9,1101,2358,0,46.69,23.24
臺南市,北區,振興里,875,349,526,8,883,1929,0,45.78,18.09
臺南市,北區,仁愛里,1088,533,555,10,1098,2173,0,50.53,24.53
臺南市,北區,大豐里,1682,573,1109,10,1692,4183,0,40.45,13.7
臺南市,北區,重興里,881,445,436,6,887,1829,0,48.5,24.33
臺南市,北區,和順里,2203,915,1288,13,2216,4751,0,46.64,19.26
臺南市,北區,正覺里,1381,461,920,14,1395,3128,0,44.6,14.74
臺南市,北區,成功里,1936,714,1222,8,1944,4481,0,43.38,15.93
臺南市,北區,文元里,1443,560,883,11,1454,3391,0,42.88,16.51
臺南市,北區,大港里,2372,910,1462,15,2387,5281,0,45.2,17.23
臺南市,北區,中樓里,653,277,376,8,661,1388,0,47.62,19.96
臺南市,北區,公園里,816,401,415,9,825,1809,0,45.61,22.17
臺南市,北區,元寶里,1600,732,868,7,1607,4041,0,39.77,18.11
臺南市,北區,永祥里,1351,587,764,19,1370,3012,0,45.48,19.49
臺南市,北區,成德里,1905,830,1075,13,1918,4329,0,44.31,19.17
臺南市,北區,文成里,1332,516,816,2,1334,2933,0,45.48,17.59
臺南市,北區,大和里,1552,492,1060,9,1561,3603,0,43.33,13.66
臺南市,北區,賢北里,1651,608,1043,8,1659,3566,0,46.52,17.05
臺南市,北區,長勝里,1700,1059,641,27,1727,3781,0,45.68,28.01
臺南市,北區,合興里,1540,666,874,9,1549,3378,0,45.86,19.72
臺南市,北區,北門里,2189,971,1218,20,2209,5163,0,42.79,18.81
臺南市,北區,小北里,1588,625,963,21,1609,3826,0,42.05,16.34
臺南市,北區,大光里,2035,1235,800,19,2054,4747,0,43.27,26.02
臺南市,北區,大興里,1264,535,729,10,1274,2929,0,43.5,18.27
臺南市,北區,長興里,1129,439,690,6,1135,2655,0,42.75,16.53
臺南市,北區,北華里,1460,538,922,12,1472,3987,0,36.92,13.49
臺南市,北區,華德里,1565,648,917,10,1575,3631,0,43.38,17.85
臺南市,北區,福德里,1954,855,1099,12,1966,4418,0,44.5,19.35
臺南市,北區,立人里,1117,387,730,3,1120,2467,0,45.4,15.69
臺南市,北區,雙安里,1017,461,556,7,1024,2258,0,45.35,20.42
臺南市,北區,元美里,1320,526,794,19,1339,2999,0,44.65,17.54
臺南市,北區,合計,48071,20538,27533,373,48444,109685,129057,44.17,18.72
臺南市,安南區,東和里,1136,420,716,8,1144,2798,0,40.89,15.01
臺南市,安南區,安順里,1902,683,1219,24,1926,4730,0,40.72,14.44
臺南市,安南區,󻕯南里,1800,614,1186,10,1810,4668,0,38.77,13.15
臺南市,安南區,州南里,1973,677,1296,18,1991,5017,0,39.69,13.49
臺南市,安南區,州北里,1815,620,1195,11,1826,4446,0,41.07,13.95
臺南市,安南區,安東里,1183,385,798,6,1189,2762,0,43.05,13.94
臺南市,安南區,安西里,1439,485,954,13,1452,3488,0,41.63,13.9
臺南市,安南區,頂安里,1872,584,1288,16,1888,4518,0,41.79,12.93
臺南市,安南區,安慶里,2501,1023,1478,19,2520,6006,0,41.96,17.03
臺南市,安南區,新順里,2500,906,1594,13,2513,6119,0,41.07,14.81
臺南市,安南區,原佃里,867,310,557,5,872,2171,0,40.17,14.28
臺南市,安南區,總頭里,740,218,522,5,745,1811,0,41.14,12.04
臺南市,安南區,長安里,1835,580,1255,12,1847,4706,0,39.25,12.32
臺南市,安南區,公親里,461,129,332,1,462,1148,0,40.24,11.24
臺南市,安南區,海東里,2006,593,1413,5,2011,5528,0,36.38,10.73
臺南市,安南區,海西里,1094,377,717,3,1097,2803,0,39.14,13.45
臺南市,安南區,海南里,1004,315,689,6,1010,2365,0,42.71,13.32
臺南市,安南區,溪心里,2675,952,1723,22,2697,7823,0,34.48,12.17
臺南市,安南區,塩田里,648,281,367,11,659,1587,0,41.52,17.71
臺南市,安南區,淵東里,1716,726,990,15,1731,4730,0,36.6,15.35
臺南市,安南區,淵西里,1145,377,768,13,1158,3591,0,32.25,10.5
臺南市,安南區,佃東里,1197,388,809,6,1203,3358,0,35.82,11.55
臺南市,安南區,佃西里,718,236,482,3,721,2107,0,34.22,11.2
臺南市,安南區,公󻕯里,447,152,295,3,450,1031,0,43.65,14.74
臺南市,安南區,南興里,647,167,480,6,653,1831,0,35.66,9.12
臺南市,安南區,學東里,794,240,554,9,803,2484,0,32.33,9.66
臺南市,安南區,城東里,526,198,328,3,529,1572,0,33.65,12.6
臺南市,安南區,城北里,589,165,424,7,596,1569,0,37.99,10.52
臺南市,安南區,城中里,401,142,259,4,405,1050,0,38.57,13.52
臺南市,安南區,城南里,1136,345,791,15,1151,3209,0,35.87,10.75
臺南市,安南區,城西里,510,133,377,1,511,1442,0,35.44,9.22
臺南市,安南區,青草里,454,132,322,2,456,1507,0,30.26,8.76
臺南市,安南區,砂崙里,503,144,359,9,512,1292,0,39.63,11.15
臺南市,安南區,鹿耳里,279,112,167,6,285,888,0,32.09,12.61
臺南市,安南區,四草里,740,266,474,3,743,1882,0,39.48,14.13
臺南市,安南區,安和里,893,277,616,5,898,2122,0,42.32,13.05
臺南市,安南區,溪北里,1213,430,783,11,1224,2749,0,44.53,15.64
臺南市,安南區,溪頂里,1883,683,1200,13,1896,4392,0,43.17,15.55
臺南市,安南區,溪墘里,1241,362,879,8,1249,3015,0,41.43,12.01
臺南市,安南區,海佃里,1798,534,1264,13,1811,4278,0,42.33,12.48
臺南市,安南區,幸福里,1560,446,1114,12,1572,3596,0,43.72,12.4
臺南市,安南區,鳳凰里,1660,607,1053,10,1670,4402,0,37.94,13.79
臺南市,安南區,梅花里,1614,557,1057,16,1630,4025,0,40.5,13.84
臺南市,安南區,理想里,1913,564,1349,7,1920,4467,0,42.98,12.63
臺南市,安南區,溪東里,1623,605,1018,10,1633,3943,0,41.42,15.34
臺南市,安南區,淵中里,1258,395,863,11,1269,3321,0,38.21,11.89
臺南市,安南區,布袋里,579,202,377,4,583,1480,0,39.39,13.65
臺南市,安南區,國安里,1145,365,780,11,1156,2718,0,42.53,13.43
臺南市,安南區,安富里,2071,640,1431,12,2083,5393,0,38.62,11.87
臺南市,安南區,大安里,1455,465,990,8,1463,3607,0,40.56,12.89
臺南市,安南區,媽祖宮里,482,191,291,4,486,1456,0,33.38,13.12
臺南市,安南區,合計,63641,21398,42243,468,64109,163001,196238,39.33,13.13
臺南市,安平區,金城里,824,366,458,5,829,2012,0,41.2,18.19
臺南市,安平區,漁光里,197,61,136,3,200,435,0,45.98,14.02
臺南市,安平區,建平里,2098,849,1249,11,2109,5116,0,41.22,16.59
臺南市,安平區,怡平里,1677,708,969,12,1689,4196,0,40.25,16.87
臺南市,安平區,華平里,2015,844,1171,12,2027,4827,0,41.99,17.48
臺南市,安平區,平通里,2711,1147,1564,20,2731,7232,0,37.76,15.86
臺南市,安平區,文平里,2250,976,1274,20,2270,5000,0,45.4,19.52
臺南市,安平區,國平里,3060,1290,1770,18,3078,7593,0,40.54,16.99
臺南市,安平區,育平里,2971,1346,1625,12,2983,7951,0,37.52,16.93
臺南市,安平區,億載里,1309,518,791,7,1316,3031,0,43.42,17.09
臺南市,安平區,平安里,1452,519,933,6,1458,3301,0,44.17,15.72
臺南市,安平區,天妃里,1387,480,907,8,1395,3261,0,42.78,14.72
臺南市,安平區,王城里,1083,372,711,6,1089,2761,0,39.44,13.47
臺南市,安平區,合計,23034,9476,13558,140,23174,56716,67297,40.86,16.71
臺南市,中西區,赤嵌里,1658,577,1081,11,1669,3653,0,45.69,15.8
臺南市,中西區,郡王里,1331,571,760,6,1337,3036,0,44.04,18.81
臺南市,中西區,法華里,1235,553,682,12,1247,2678,0,46.56,20.65
臺南市,中西區,開山里,1001,348,653,9,1010,2406,0,41.98,14.46
臺南市,中西區,永華里,1135,457,678,9,1144,2516,0,45.47,18.16
臺南市,中西區,藥王里,1470,517,953,12,1482,3287,0,45.09,15.73
臺南市,中西區,光賢里,1620,574,1046,13,1633,3479,0,46.94,16.5
臺南市,中西區,大涼里,1123,472,651,10,1133,2515,0,45.05,18.77
臺南市,中西區,西湖里,2631,1140,1491,23,2654,5665,0,46.85,20.12
臺南市,中西區,西賢里,2333,957,1376,12,2345,4932,0,47.55,19.4
臺南市,中西區,城隍里,1651,589,1062,10,1661,3667,0,45.3,16.06
臺南市,中西區,南美里,1371,483,888,6,1377,3143,0,43.81,15.37
臺南市,中西區,南門里,1182,542,640,5,1187,2478,0,47.9,21.87
臺南市,中西區,小西門里,1347,577,770,8,1355,3070,0,44.14,18.79
臺南市,中西區,五條港里,874,327,547,6,880,1972,0,44.62,16.58
臺南市,中西區,兌悅里,1567,512,1055,19,1586,3846,0,41.24,13.31
臺南市,中西區,淺草里,1064,396,668,9,1073,2485,0,43.18,15.94
臺南市,中西區,府前里,826,288,538,9,835,1878,0,44.46,15.34
臺南市,中西區,南廠里,1700,582,1118,12,1712,3913,0,43.75,14.87
臺南市,中西區,西和里,1774,712,1062,15,1789,3847,0,46.5,18.51
臺南市,中西區,合計,28893,11174,17719,216,29109,64466,78163,45.15,17.33
臺南市,合計,合計,648499,243004,405495,5693,654192,1592388,1868739,41.08,15.26
高雄市,鹽埕區,藍橋里,626,209,417,7,633,1261,0,50.2,16.57
高雄市,鹽埕區,慈愛里,156,52,104,0,156,321,0,48.6,16.2
高雄市,鹽埕區,博愛里,326,113,213,5,331,626,0,52.88,18.05
高雄市,鹽埕區,壽星里,538,242,296,8,546,1222,0,44.68,19.8
高雄市,鹽埕區,中山里,601,258,343,2,603,1240,0,48.63,20.81
高雄市,鹽埕區,教仁里,925,368,557,11,936,1941,0,48.22,18.96
高雄市,鹽埕區,新樂里,415,175,240,1,416,805,0,51.68,21.74
高雄市,鹽埕區,中原里,301,97,204,1,302,569,0,53.08,17.05
高雄市,鹽埕區,光明里,578,193,385,7,585,1394,0,41.97,13.85
高雄市,鹽埕區,育仁里,360,137,223,3,363,733,0,49.52,18.69
高雄市,鹽埕區,河濱里,783,294,489,8,791,1581,0,50.03,18.6
高雄市,鹽埕區,沙地里,332,109,223,2,334,721,0,46.32,15.12
高雄市,鹽埕區,南端里,421,158,263,5,426,935,0,45.56,16.9
高雄市,鹽埕區,港都里,500,179,321,4,504,1042,0,48.37,17.18
高雄市,鹽埕區,江西里,490,171,319,0,490,1023,0,47.9,16.72
高雄市,鹽埕區,新豐里,376,155,221,5,381,775,0,49.16,20.0
高雄市,鹽埕區,府北里,862,333,529,6,868,1989,0,43.64,16.74
高雄市,鹽埕區,陸橋里,514,181,333,1,515,1114,0,46.23,16.25
高雄市,鹽埕區,瀨南里,278,92,186,1,279,547,0,51.01,16.82
高雄市,鹽埕區,新化里,270,107,163,5,275,543,0,50.64,19.71
高雄市,鹽埕區,江南里,262,56,206,2,264,569,0,46.4,9.84
高雄市,鹽埕區,合計,9914,3679,6235,84,9998,20951,23272,47.72,17.56
高雄市,鼓山區,鼓峰里,846,471,375,5,851,1923,0,44.25,24.49
高雄市,鼓山區,雄峰里,826,542,284,5,831,1924,0,43.19,28.17
高雄市,鼓山區,前峰里,1947,985,962,15,1962,4040,0,48.56,24.38
高雄市,鼓山區,光榮里,1561,478,1083,7,1568,3318,0,47.26,14.41
高雄市,鼓山區,民族里,637,239,398,7,644,1257,0,51.23,19.01
高雄市,鼓山區,內惟里,486,154,332,2,488,1072,0,45.52,14.37
高雄市,鼓山區,建國里,1080,447,633,9,1089,2405,0,45.28,18.59
高雄市,鼓山區,忠正里,1554,607,947,8,1562,3652,0,42.77,16.62
高雄市,鼓山區,自強里,374,345,29,1,375,703,0,53.34,49.08
高雄市,鼓山區,龍井里,518,202,316,3,521,1210,0,43.06,16.69
高雄市,鼓山區,正德里,858,267,591,6,864,1928,0,44.81,13.85
高雄市,鼓山區,平和里,1604,531,1073,7,1611,3346,0,48.15,15.87
高雄市,鼓山區,民強里,1209,421,788,11,1220,2539,0,48.05,16.58
高雄市,鼓山區,厚生里,1356,471,885,10,1366,2970,0,45.99,15.86
高雄市,鼓山區,龍子里,6592,3030,3562,48,6640,15526,0,42.77,19.52
高雄市,鼓山區,龍水里,9796,4602,5194,37,9833,22850,0,43.03,20.14
高雄市,鼓山區,明誠里,6795,3453,3342,28,6823,16357,0,41.71,21.11
高雄市,鼓山區,華豐里,1645,826,819,11,1656,3836,0,43.17,21.53
高雄市,鼓山區,裕興里,1426,750,676,9,1435,3144,0,45.64,23.85
高雄市,鼓山區,裕豐里,1145,700,445,6,1151,2453,0,46.92,28.54
高雄市,鼓山區,鼓岩里,473,152,321,9,482,1125,0,42.84,13.51
高雄市,鼓山區,樹德里,567,171,396,2,569,1113,0,51.12,15.36
高雄市,鼓山區,寶樹里,519,186,333,5,524,1920,0,27.29,9.69
高雄市,鼓山區,興宗里,559,205,354,6,565,1241,0,45.53,16.52
高雄市,鼓山區,光化里,533,207,326,2,535,1207,0,44.32,17.15
高雄市,鼓山區,山下里,608,276,332,2,610,1306,0,46.71,21.13
高雄市,鼓山區,河邊里,559,227,332,3,562,1301,0,43.2,17.45
高雄市,鼓山區,綠川里,614,214,400,6,620,1361,0,45.55,15.72
高雄市,鼓山區,登山里,256,99,157,2,258,605,0,42.64,16.36
高雄市,鼓山區,峰南里,356,110,246,2,358,778,0,46.02,14.14
高雄市,鼓山區,麗興里,420,137,283,4,424,928,0,45.69,14.76
高雄市,鼓山區,新民里,419,111,308,4,423,955,0,44.29,11.62
高雄市,鼓山區,延平里,363,105,258,3,366,715,0,51.19,14.69
高雄市,鼓山區,維生里,577,202,375,4,581,1190,0,48.82,16.97
高雄市,鼓山區,惠安里,472,135,337,5,477,1102,0,43.28,12.25
高雄市,鼓山區,壽山里,528,149,379,4,532,1307,0,40.7,11.4
高雄市,鼓山區,哨船頭里,428,176,252,4,432,963,0,44.86,18.28
高雄市,鼓山區,桃源里,233,82,151,6,239,527,0,45.35,15.56
高雄市,鼓山區,合計,50739,22465,28274,308,51047,116097,141101,43.97,19.35
高雄市,左營區,進學里,647,310,337,6,653,2636,0,24.77,11.76
高雄市,左營區,尾西里,474,148,326,7,481,973,0,49.43,15.21
高雄市,左營區,頂北里,273,96,177,1,274,512,0,53.52,18.75
高雄市,左營區,中北里,296,65,231,8,304,603,0,50.41,10.78
高雄市,左營區,中南里,245,69,176,0,245,496,0,49.4,13.91
高雄市,左營區,廟東里,408,92,316,4,412,799,0,51.56,11.51
高雄市,左營區,廟北里,402,100,302,6,408,839,0,48.63,11.92
高雄市,左營區,尾南里,326,83,243,2,328,705,0,46.52,11.77
高雄市,左營區,尾北里,1402,532,870,12,1414,3265,0,43.31,16.29
高雄市,左營區,屏山里,637,435,202,15,652,1512,0,43.12,28.77
高雄市,左營區,祥和里,148,113,35,0,148,331,0,44.71,34.14
高雄市,左營區,永清里,189,129,60,2,191,600,0,31.83,21.5
高雄市,左營區,莒光里,732,440,292,3,735,1687,0,43.57,26.08
高雄市,左營區,光輝里,1033,529,504,5,1038,2403,0,43.2,22.01
高雄市,左營區,合群里,1242,1114,128,12,1254,2489,0,50.38,44.76
高雄市,左營區,明建里,289,196,93,2,291,611,0,47.63,32.08
高雄市,左營區,頂西里,447,104,343,3,450,907,0,49.61,11.47
高雄市,左營區,聖后里,366,101,265,2,368,711,0,51.76,14.21
高雄市,左營區,聖西里,156,43,113,0,156,329,0,47.42,13.07
高雄市,左營區,聖南里,253,79,174,2,255,522,0,48.85,15.13
高雄市,左營區,城南里,241,64,177,2,243,491,0,49.49,13.03
高雄市,左營區,路東里,367,112,255,2,369,690,0,53.48,16.23
高雄市,左營區,廍北里,194,38,156,3,197,391,0,50.38,9.72
高雄市,左營區,廍南里,295,96,199,1,296,575,0,51.48,16.7
高雄市,左營區,埤西里,405,167,238,1,406,842,0,48.22,19.83
高雄市,左營區,埤北里,557,343,214,11,568,1260,0,45.08,27.22
高雄市,左營區,埤東里,414,159,255,5,419,920,0,45.54,17.28
高雄市,左營區,海勝里,2708,2210,498,35,2743,5561,0,49.33,39.74
高雄市,左營區,崇實里,1347,813,534,10,1357,3147,0,43.12,25.83
高雄市,左營區,自助里,366,211,155,1,367,907,0,40.46,23.26
高雄市,左營區,果貿里,1268,995,273,6,1274,2680,0,47.54,37.13
高雄市,左營區,果惠里,691,529,162,10,701,1445,0,48.51,36.61
高雄市,左營區,果峰里,663,523,140,6,669,1540,0,43.44,33.96
高雄市,左營區,新下里,5906,2938,2968,42,5948,13601,0,43.73,21.6
高雄市,左營區,新上里,10893,4757,6136,84,10977,25163,0,43.62,18.9
高雄市,左營區,新中里,2180,666,1514,17,2197,4725,0,46.5,14.1
高雄市,左營區,新光里,5754,2672,3082,32,5786,13461,0,42.98,19.85
高雄市,左營區,菜公里,11559,5385,6174,72,11631,28382,0,40.98,18.97
高雄市,左營區,福山里,13779,6786,6993,73,13852,35376,0,39.16,19.18
高雄市,左營區,合計,69552,34242,35310,505,70057,164087,196916,42.7,20.87
高雄市,楠梓區,清豐里,8668,3422,5246,61,8729,21636,0,40.34,15.82
高雄市,楠梓區,東寧里,1755,705,1050,9,1764,4264,0,41.37,16.53
高雄市,楠梓區,五常里,2365,850,1515,12,2377,6356,0,37.4,13.37
高雄市,楠梓區,享平里,1272,451,821,3,1275,3150,0,40.48,14.32
高雄市,楠梓區,中陽里,1330,417,913,14,1344,3252,0,41.33,12.82
高雄市,楠梓區,惠楠里,1046,387,659,4,1050,3163,0,33.2,12.24
高雄市,楠梓區,惠民里,1732,683,1049,18,1750,3884,0,45.06,17.58
高雄市,楠梓區,惠豐里,2013,1015,998,20,2033,4669,0,43.54,21.74
高雄市,楠梓區,錦屏里,1356,342,1014,11,1367,2830,0,48.3,12.08
高雄市,楠梓區,玉屏里,1020,229,791,12,1032,2059,0,50.12,11.12
高雄市,楠梓區,金田里,1668,478,1190,17,1685,3828,0,44.02,12.49
高雄市,楠梓區,稔田里,719,149,570,5,724,1375,0,52.65,10.84
高雄市,楠梓區,瑞屏里,1396,528,868,14,1410,3487,0,40.44,15.14
高雄市,楠梓區,翠屏里,6101,3138,2963,33,6134,16189,0,37.89,19.38
高雄市,楠梓區,宏南里,355,194,161,4,359,657,0,54.64,29.53
高雄市,楠梓區,宏毅里,1055,471,584,5,1060,2064,0,51.36,22.82
高雄市,楠梓區,宏榮里,1082,572,510,4,1086,2417,0,44.93,23.67
高雄市,楠梓區,廣昌里,1273,568,705,7,1280,2885,0,44.37,19.69
高雄市,楠梓區,久昌里,1067,483,584,6,1073,2765,0,38.81,17.47
高雄市,楠梓區,大昌里,775,354,421,6,781,2046,0,38.17,17.3
高雄市,楠梓區,福昌里,963,366,597,8,971,2023,0,48.0,18.09
高雄市,楠梓區,盛昌里,2317,1133,1184,14,2331,5347,0,43.59,21.19
高雄市,楠梓區,泰昌里,561,218,343,6,567,1397,0,40.59,15.6
高雄市,楠梓區,興昌里,1809,759,1050,13,1822,4314,0,42.23,17.59
高雄市,楠梓區,建昌里,1071,495,576,6,1077,2534,0,42.5,19.53
高雄市,楠梓區,宏昌里,1394,654,740,7,1401,3221,0,43.5,20.3
高雄市,楠梓區,和昌里,885,417,468,8,893,1997,0,44.72,20.88
高雄市,楠梓區,慶昌里,1538,746,792,6,1544,3122,0,49.46,23.89
高雄市,楠梓區,隆昌里,1389,651,738,15,1404,3235,0,43.4,20.12
高雄市,楠梓區,秀昌里,947,472,475,5,952,2104,0,45.25,22.43
高雄市,楠梓區,裕昌里,1848,770,1078,15,1863,4652,0,40.05,16.55
高雄市,楠梓區,國昌里,1428,600,828,10,1438,3394,0,42.37,17.68
高雄市,楠梓區,加昌里,3349,1720,1629,22,3371,8252,0,40.85,20.84
高雄市,楠梓區,仁昌里,1937,1001,936,10,1947,4959,0,39.26,20.19
高雄市,楠梓區,藍田里,2978,1360,1618,19,2997,7507,0,39.92,18.12
高雄市,楠梓區,中興里,698,218,480,5,703,1558,0,45.12,13.99
高雄市,楠梓區,中和里,1434,514,920,10,1444,4154,0,34.76,12.37
高雄市,楠梓區,合計,64594,27530,37064,444,65038,156746,189931,41.49,17.56
高雄市,三民區,鼎金里,1545,556,989,7,1552,3804,0,40.8,14.62
高雄市,三民區,鼎盛里,3014,1233,1781,16,3030,7370,0,41.11,16.73
高雄市,三民區,鼎強里,1627,585,1042,9,1636,3793,0,43.13,15.42
高雄市,三民區,鼎力里,1693,647,1046,13,1706,3884,0,43.92,16.66
高雄市,三民區,鼎西里,2837,1054,1783,16,2853,7030,0,40.58,14.99
高雄市,三民區,鼎中里,1588,534,1054,11,1599,3436,0,46.54,15.54
高雄市,三民區,鼎泰里,9199,4245,4954,50,9249,20899,0,44.26,20.31
高雄市,三民區,本館里,3536,1357,2179,18,3554,8380,0,42.41,16.19
高雄市,三民區,本和里,3040,1222,1818,17,3057,6992,0,43.72,17.48
高雄市,三民區,本文里,868,335,533,7,875,1915,0,45.69,17.49
高雄市,三民區,本武里,713,239,474,5,718,1561,0,46.0,15.31
高雄市,三民區,本元里,2191,894,1297,18,2209,4987,0,44.3,17.93
高雄市,三民區,本安里,1928,836,1092,9,1937,4277,0,45.29,19.55
高雄市,三民區,本上里,1978,891,1087,7,1985,4461,0,44.5,19.97
高雄市,三民區,本揚里,3229,1387,1842,17,3246,7143,0,45.44,19.42
高雄市,三民區,寶獅里,1622,652,970,7,1629,3486,0,46.73,18.7
高雄市,三民區,寶德里,2073,799,1274,17,2090,4824,0,43.33,16.56
高雄市,三民區,寶泰里,1524,573,951,12,1536,3831,0,40.09,14.96
高雄市,三民區,寶興里,2741,1078,1663,21,2762,6396,0,43.18,16.85
高雄市,三民區,寶中里,1223,450,773,10,1233,2807,0,43.93,16.03
高雄市,三民區,寶華里,1348,606,742,8,1356,3089,0,43.9,19.62
高雄市,三民區,寶國里,3201,1360,1841,23,3224,7514,0,42.91,18.1
高雄市,三民區,寶民里,1223,526,697,10,1233,3030,0,40.69,17.36
高雄市,三民區,寶慶里,1081,438,643,9,1090,2557,0,42.63,17.13
高雄市,三民區,寶業里,2429,1054,1375,12,2441,5630,0,43.36,18.72
高雄市,三民區,寶盛里,2265,985,1280,16,2281,4748,0,48.04,20.75
高雄市,三民區,寶安里,2807,1256,1551,15,2822,6808,0,41.45,18.45
高雄市,三民區,寶龍里,1889,765,1124,15,1904,3982,0,47.82,19.21
高雄市,三民區,寶珠里,2265,915,1350,8,2273,6719,0,33.83,13.62
高雄市,三民區,寶玉里,3295,1398,1897,14,3309,7920,0,41.78,17.65
高雄市,三民區,灣子里,1509,618,891,5,1514,3836,0,39.47,16.11
高雄市,三民區,灣愛里,1012,357,655,14,1026,2898,0,35.4,12.32
高雄市,三民區,灣中里,2027,717,1310,14,2041,5297,0,38.53,13.54
高雄市,三民區,灣華里,1053,405,648,3,1056,2586,0,40.84,15.66
高雄市,三民區,灣勝里,773,209,564,6,779,1821,0,42.78,11.48
高雄市,三民區,灣利里,1426,420,1006,6,1432,3021,0,47.4,13.9
高雄市,三民區,灣復里,1376,541,835,14,1390,3493,0,39.79,15.49
高雄市,三民區,正興里,4725,2022,2703,27,4752,11804,0,40.26,17.13
高雄市,三民區,正順里,1680,678,1002,5,1685,3743,0,45.02,18.11
高雄市,三民區,灣興里,802,287,515,5,807,1778,0,45.39,16.14
高雄市,三民區,灣成里,1016,391,625,6,1022,2499,0,40.9,15.65
高雄市,三民區,安康里,1025,350,675,8,1033,2682,0,38.52,13.05
高雄市,三民區,安寧里,775,275,500,9,784,1744,0,44.95,15.77
高雄市,三民區,安吉里,1855,776,1079,10,1865,4294,0,43.43,18.07
高雄市,三民區,安發里,1912,754,1158,11,1923,4233,0,45.43,17.81
高雄市,三民區,安東里,1413,491,922,9,1422,2893,0,49.15,16.97
高雄市,三民區,安和里,1155,384,771,13,1168,2309,0,50.58,16.63
高雄市,三民區,達德里,639,211,428,4,643,1208,0,53.23,17.47
高雄市,三民區,達明里,718,250,468,9,727,1482,0,49.06,16.87
高雄市,三民區,達仁里,662,224,438,4,666,1379,0,48.3,16.24
高雄市,三民區,達勇里,403,152,251,3,406,882,0,46.03,17.23
高雄市,三民區,同德里,1305,490,815,9,1314,2589,0,50.75,18.93
高雄市,三民區,德智里,992,381,611,5,997,2030,0,49.11,18.77
高雄市,三民區,德仁里,870,321,549,6,876,1812,0,48.34,17.72
高雄市,三民區,安生里,695,221,474,4,699,1339,0,52.2,16.5
高雄市,三民區,德東里,396,133,263,0,396,748,0,52.94,17.78
高雄市,三民區,德行里,568,191,377,5,573,1023,0,56.01,18.67
高雄市,三民區,精華里,694,251,443,7,701,1448,0,48.41,17.33
高雄市,三民區,民享里,1001,336,665,10,1011,1900,0,53.21,17.68
高雄市,三民區,安宜里,1467,498,969,8,1475,2953,0,49.95,16.86
高雄市,三民區,安泰里,1654,627,1027,21,1675,3633,0,46.11,17.26
高雄市,三民區,安邦里,1729,624,1105,5,1734,3606,0,48.09,17.3
高雄市,三民區,十全里,753,241,512,2,755,1671,0,45.18,14.42
高雄市,三民區,十美里,834,290,544,3,837,1690,0,49.53,17.16
高雄市,三民區,德北里,932,365,567,6,938,1992,0,47.09,18.32
高雄市,三民區,立誠里,336,106,230,3,339,659,0,51.44,16.08
高雄市,三民區,立業里,386,121,265,0,386,914,0,42.23,13.24
高雄市,三民區,港東里,591,199,392,3,594,1341,0,44.3,14.84
高雄市,三民區,港新里,628,258,370,3,631,1337,0,47.2,19.3
高雄市,三民區,港西里,332,123,209,4,336,760,0,44.21,16.18
高雄市,三民區,博愛里,542,220,322,1,543,1126,0,48.22,19.54
高雄市,三民區,博惠里,1833,706,1127,18,1851,3922,0,47.2,18.0
高雄市,三民區,長明里,422,185,237,4,426,1008,0,42.26,18.35
高雄市,三民區,建東里,445,201,244,6,451,1147,0,39.32,17.52
高雄市,三民區,興德里,860,362,498,10,870,1905,0,45.67,19.0
高雄市,三民區,鳳南里,457,130,327,6,463,886,0,52.26,14.67
高雄市,三民區,鳳北里,656,213,443,8,664,1307,0,50.8,16.3
高雄市,三民區,德西里,427,170,257,5,432,998,0,43.29,17.03
高雄市,三民區,豐裕里,973,335,638,8,981,2347,0,41.8,14.27
高雄市,三民區,川東里,530,189,341,1,531,1212,0,43.81,15.59
高雄市,三民區,裕民里,500,184,316,7,507,1226,0,41.35,15.01
高雄市,三民區,力行里,493,179,314,3,496,1046,0,47.42,17.11
高雄市,三民區,千歲里,579,236,343,5,584,1082,0,53.97,21.81
高雄市,三民區,立德里,558,217,341,1,559,1156,0,48.36,18.77
高雄市,三民區,千北里,460,155,305,3,463,1009,0,45.89,15.36
高雄市,三民區,千秋里,880,308,572,5,885,1967,0,44.99,15.66
高雄市,三民區,合計,124706,49148,75558,797,125503,285944,334725,43.89,17.19
高雄市,新興區,浩然里,837,419,418,3,840,1749,0,48.03,23.96
高雄市,新興區,振成里,484,218,266,2,486,1026,0,47.37,21.25
高雄市,新興區,德生里,1305,584,721,7,1312,2842,0,46.16,20.55
高雄市,新興區,振華里,494,221,273,2,496,1011,0,49.06,21.86
高雄市,新興區,正氣里,644,279,365,5,649,1282,0,50.62,21.76
高雄市,新興區,德政里,301,158,143,6,307,626,0,49.04,25.24
高雄市,新興區,仁聲里,419,171,248,2,421,979,0,43.0,17.47
高雄市,新興區,德望里,830,359,471,3,833,1808,0,46.07,19.86
高雄市,新興區,華聲里,407,159,248,3,410,902,0,45.45,17.63
高雄市,新興區,蕉園里,358,153,205,7,365,706,0,51.7,21.67
高雄市,新興區,永寧里,596,243,353,4,600,1289,0,46.55,18.85
高雄市,新興區,玉衡里,316,121,195,2,318,736,0,43.21,16.44
高雄市,新興區,順昌里,854,326,528,3,857,1998,0,42.89,16.32
高雄市,新興區,文昌里,1324,562,762,4,1328,2739,0,48.48,20.52
高雄市,新興區,光耀里,1056,471,585,4,1060,2197,0,48.25,21.44
高雄市,新興區,興昌里,782,355,427,9,791,1572,0,50.32,22.58
高雄市,新興區,開平里,1584,673,911,7,1591,3254,0,48.89,20.68
高雄市,新興區,成功里,588,291,297,2,590,1299,0,45.42,22.4
高雄市,新興區,新江里,456,165,291,4,460,1074,0,42.83,15.36
高雄市,新興區,黎明里,386,153,233,2,388,801,0,48.44,19.1
高雄市,新興區,愛平里,437,175,262,2,439,996,0,44.08,17.57
高雄市,新興區,南港里,985,343,642,11,996,1859,0,53.58,18.45
高雄市,新興區,中東里,1073,482,591,6,1079,2712,0,39.79,17.77
高雄市,新興區,明莊里,305,112,193,4,309,692,0,44.65,16.18
高雄市,新興區,大明里,473,174,299,6,479,1021,0,46.91,17.04
高雄市,新興區,秋山里,414,154,260,5,419,960,0,43.65,16.04
高雄市,新興區,長驛里,388,161,227,4,392,934,0,41.97,17.24
高雄市,新興區,建興里,385,133,252,1,386,919,0,42.0,14.47
高雄市,新興區,建華里,388,133,255,3,391,785,0,49.81,16.94
高雄市,新興區,漢民里,326,121,205,3,329,685,0,48.03,17.66
高雄市,新興區,榮治里,331,157,174,3,334,702,0,47.58,22.36
高雄市,新興區,東坡里,573,185,388,5,578,1152,0,50.17,16.06
高雄市,新興區,合計,20099,8411,11688,134,20233,43307,49925,46.72,19.42
高雄市,前金區,三川里,326,88,238,2,328,658,0,49.85,13.37
高雄市,前金區,草江里,485,212,273,6,491,983,0,49.95,21.57
高雄市,前金區,長城里,580,204,376,6,586,1310,0,44.73,15.57
高雄市,前金區,北金里,372,141,231,1,373,809,0,46.11,17.43
高雄市,前金區,東金里,472,178,294,2,474,957,0,49.53,18.6
高雄市,前金區,新生里,1628,761,867,6,1634,3581,0,45.63,21.25
高雄市,前金區,後金里,308,132,176,3,311,662,0,46.98,19.94
高雄市,前金區,長興里,530,221,309,5,535,1150,0,46.52,19.22
高雄市,前金區,青山里,811,331,480,11,822,1817,0,45.24,18.22
高雄市,前金區,民生里,352,159,193,0,352,778,0,45.24,20.44
高雄市,前金區,復元里,478,205,273,2,480,992,0,48.39,20.67
高雄市,前金區,林投里,403,146,257,3,406,1030,0,39.42,14.17
高雄市,前金區,國民里,412,164,248,2,414,901,0,45.95,18.2
高雄市,前金區,社東里,680,330,350,2,682,1424,0,47.89,23.17
高雄市,前金區,社西里,508,237,271,2,510,1017,0,50.15,23.3
高雄市,前金區,博孝里,465,193,272,2,467,986,0,47.36,19.57
高雄市,前金區,長生里,818,384,434,8,826,1640,0,50.37,23.41
高雄市,前金區,榮復里,487,205,282,4,491,1043,0,47.08,19.65
高雄市,前金區,文西里,451,169,282,2,453,941,0,48.14,17.96
高雄市,前金區,文東里,539,226,313,5,544,1108,0,49.1,20.4
高雄市,前金區,合計,11105,4686,6419,74,11179,23787,26498,47.0,19.7
高雄市,苓雅區,博仁里,338,167,171,3,341,681,0,50.07,24.52
高雄市,苓雅區,苓洲里,626,291,335,4,630,1496,0,42.11,19.45
高雄市,苓雅區,苓昇里,503,224,279,5,508,1147,0,44.29,19.53
高雄市,苓雅區,苓中里,702,268,434,12,714,1552,0,46.01,17.27
高雄市,苓雅區,苓雅里,607,284,323,4,611,1384,0,44.15,20.52
高雄市,苓雅區,苓東里,603,196,407,1,604,1405,0,42.99,13.95
高雄市,苓雅區,城北里,657,272,385,5,662,1540,0,42.99,17.66
高雄市,苓雅區,城西里,260,107,153,0,260,506,0,51.38,21.15
高雄市,苓雅區,城東里,803,345,458,3,806,1861,0,43.31,18.54
高雄市,苓雅區,意誠里,1383,654,729,11,1394,3663,0,38.06,17.85
高雄市,苓雅區,鼓中里,410,155,255,2,412,878,0,46.92,17.65
高雄市,苓雅區,田西里,608,269,339,5,613,1259,0,48.69,21.37
高雄市,苓雅區,人和里,720,288,432,7,727,1714,0,42.42,16.8
高雄市,苓雅區,仁政里,636,281,355,3,639,1191,0,53.65,23.59
高雄市,苓雅區,廣澤里,814,287,527,8,822,1686,0,48.75,17.02
高雄市,苓雅區,美田里,491,220,271,4,495,1085,0,45.62,20.28
高雄市,苓雅區,華堂里,1378,587,791,5,1383,2948,0,46.91,19.91
高雄市,苓雅區,日中里,1004,403,601,1,1005,2080,0,48.32,19.38
高雄市,苓雅區,普照里,1389,577,812,6,1395,2971,0,46.95,19.42
高雄市,苓雅區,和煦里,900,391,509,4,904,1962,0,46.08,19.93
高雄市,苓雅區,晴朗里,752,331,421,6,758,2551,0,29.71,12.98
高雄市,苓雅區,普天里,1568,708,860,9,1577,3394,0,46.46,20.86
高雄市,苓雅區,林富里,1028,467,561,7,1035,2101,0,49.26,22.23
高雄市,苓雅區,林圍里,1061,523,538,5,1066,2233,0,47.74,23.42
高雄市,苓雅區,林安里,651,308,343,0,651,1434,0,45.4,21.48
高雄市,苓雅區,光華里,317,95,222,6,323,666,0,48.5,14.26
高雄市,苓雅區,林興里,559,167,392,1,560,1226,0,45.68,13.62
高雄市,苓雅區,林華里,1212,450,762,7,1219,2632,0,46.31,17.1
高雄市,苓雅區,林西里,664,278,386,3,667,1516,0,44.0,18.34
高雄市,苓雅區,林中里,1249,508,741,10,1259,2734,0,46.05,18.58
高雄市,苓雅區,林泉里,876,436,440,4,880,1845,0,47.7,23.63
高雄市,苓雅區,林南里,1311,686,625,3,1314,2771,0,47.42,24.76
高雄市,苓雅區,中正里,1268,575,693,10,1278,2724,0,46.92,21.11
高雄市,苓雅區,尚義里,693,298,395,7,700,1480,0,47.3,20.14
高雄市,苓雅區,同慶里,983,493,490,12,995,2090,0,47.61,23.59
高雄市,苓雅區,凱旋里,939,510,429,3,942,2096,0,44.94,24.33
高雄市,苓雅區,安祥里,1103,497,606,9,1112,2380,0,46.72,20.88
高雄市,苓雅區,奏捷里,711,334,377,6,717,1489,0,48.15,22.43
高雄市,苓雅區,福壽里,678,208,470,8,686,1389,0,49.39,14.97
高雄市,苓雅區,福南里,783,296,487,14,797,1620,0,49.2,18.27
高雄市,苓雅區,五權里,1098,484,614,6,1104,2086,0,52.92,23.2
高雄市,苓雅區,民主里,1736,735,1001,12,1748,3752,0,46.59,19.59
高雄市,苓雅區,林德里,832,381,451,4,836,1742,0,47.99,21.87
高雄市,苓雅區,林貴里,777,346,431,4,781,1748,0,44.68,19.79
高雄市,苓雅區,林榮里,1669,776,893,6,1675,3776,0,44.36,20.55
高雄市,苓雅區,英明里,818,298,520,5,823,1791,0,45.95,16.64
高雄市,苓雅區,林靖里,732,410,322,11,743,1489,0,49.9,27.54
高雄市,苓雅區,朝陽里,620,246,374,3,623,1371,0,45.44,17.94
高雄市,苓雅區,福隆里,1131,412,719,8,1139,2410,0,47.26,17.1
高雄市,苓雅區,福祥里,527,226,301,3,530,1158,0,45.77,19.52
高雄市,苓雅區,福海里,456,226,230,1,457,1023,0,44.67,22.09
高雄市,苓雅區,福康里,851,293,558,10,861,1787,0,48.18,16.4
高雄市,苓雅區,福人里,822,347,475,7,829,1974,0,42.0,17.58
高雄市,苓雅區,福地里,1074,431,643,6,1080,2537,0,42.57,16.99
高雄市,苓雅區,福居里,1060,363,697,8,1068,2583,0,41.35,14.05
高雄市,苓雅區,福東里,1095,467,628,6,1101,2521,0,43.67,18.52
高雄市,苓雅區,福西里,778,278,500,10,788,1685,0,46.77,16.5
高雄市,苓雅區,永康里,985,456,529,4,989,2051,0,48.22,22.23
高雄市,苓雅區,正文里,990,411,579,7,997,2240,0,44.51,18.35
高雄市,苓雅區,正言里,1202,514,688,6,1208,2641,0,45.74,19.46
高雄市,苓雅區,正大里,1998,955,1043,15,2013,4822,0,41.75,19.81
高雄市,苓雅區,五福里,1638,709,929,10,1648,3581,0,46.02,19.8
高雄市,苓雅區,正心里,1589,707,882,13,1602,3399,0,47.13,20.8
高雄市,苓雅區,正道里,1724,735,989,9,1733,4055,0,42.74,18.13
高雄市,苓雅區,正義里,1160,429,731,4,1164,2329,0,49.98,18.42
高雄市,苓雅區,正仁里,1007,461,546,5,1012,2409,0,42.01,19.14
高雄市,苓雅區,文昌里,1545,574,971,13,1558,3573,0,43.6,16.06
高雄市,苓雅區,建軍里,801,298,503,4,805,1945,0,41.39,15.32
高雄市,苓雅區,衛武里,887,427,460,4,891,1894,0,47.04,22.54
高雄市,苓雅區,合計,64840,27829,37011,427,65267,143752,166008,45.4,19.36
高雄市,前鎮區,草衙里,3586,1133,2453,37,3623,9285,0,39.02,12.2
高雄市,前鎮區,明孝里,981,301,680,7,988,2288,0,43.18,13.16
高雄市,前鎮區,明正里,2219,708,1511,20,2239,4994,0,44.83,14.18
高雄市,前鎮區,明義里,979,347,632,10,989,2203,0,44.89,15.75
高雄市,前鎮區,仁愛里,567,161,406,6,573,1263,0,45.37,12.75
高雄市,前鎮區,德昌里,732,284,448,7,739,1891,0,39.08,15.02
高雄市,前鎮區,平等里,854,279,575,9,863,2883,0,29.93,9.68
高雄市,前鎮區,平昌里,243,55,188,4,247,606,0,40.76,9.08
高雄市,前鎮區,明禮里,622,156,466,11,633,1420,0,44.58,10.99
高雄市,前鎮區,信義里,635,180,455,5,640,1365,0,46.89,13.19
高雄市,前鎮區,信德里,916,305,611,7,923,2203,0,41.9,13.84
高雄市,前鎮區,明道里,446,125,321,3,449,1033,0,43.47,12.1
高雄市,前鎮區,興化里,315,98,217,2,317,656,0,48.32,14.94
高雄市,前鎮區,興仁里,310,69,241,1,311,673,0,46.21,10.25
高雄市,前鎮區,前鎮里,597,175,422,7,604,1293,0,46.71,13.53
高雄市,前鎮區,鎮東里,830,239,591,6,836,1636,0,51.1,14.61
高雄市,前鎮區,鎮榮里,915,266,649,6,921,2041,0,45.12,13.03
高雄市,前鎮區,鎮昌里,851,267,584,13,864,1918,0,45.05,13.92
高雄市,前鎮區,鎮海里,1753,645,1108,11,1764,3979,0,44.33,16.21
高雄市,前鎮區,鎮陽里,399,148,251,4,403,902,0,44.68,16.41
高雄市,前鎮區,興邦里,1250,558,692,7,1257,2779,0,45.23,20.08
高雄市,前鎮區,鎮中里,367,130,237,0,367,802,0,45.76,16.21
高雄市,前鎮區,鎮北里,495,175,320,10,505,1077,0,46.89,16.25
高雄市,前鎮區,忠純里,2526,1751,775,24,2550,5166,0,49.36,33.89
高雄市,前鎮區,忠誠里,985,809,176,13,998,1970,0,50.66,41.07
高雄市,前鎮區,西山里,1465,682,783,11,1476,3261,0,45.26,20.91
高雄市,前鎮區,民權里,1928,980,948,11,1939,3898,0,49.74,25.14
高雄市,前鎮區,建隆里,586,266,320,6,592,1249,0,47.4,21.3
高雄市,前鎮區,振興里,1006,478,528,4,1010,2251,0,44.87,21.24
高雄市,前鎮區,良和里,1358,715,643,4,1362,2750,0,49.53,26.0
高雄市,前鎮區,西甲里,905,332,573,8,913,2053,0,44.47,16.17
高雄市,前鎮區,盛興里,1109,546,563,4,1113,2633,0,42.27,20.74
高雄市,前鎮區,盛豐里,1306,533,773,8,1314,2968,0,44.27,17.96
高雄市,前鎮區,興中里,1299,550,749,11,1310,2985,0,43.89,18.43
高雄市,前鎮區,興東里,2489,1105,1384,16,2505,5492,0,45.61,20.12
高雄市,前鎮區,忠孝里,1376,657,719,9,1385,2994,0,46.26,21.94
高雄市,前鎮區,復國里,1175,442,733,11,1186,2585,0,45.88,17.1
高雄市,前鎮區,竹內里,1240,417,823,13,1253,2634,0,47.57,15.83
高雄市,前鎮區,竹東里,922,357,565,5,927,2104,0,44.06,16.97
高雄市,前鎮區,竹南里,2890,1273,1617,18,2908,6665,0,43.63,19.1
高雄市,前鎮區,竹北里,1002,412,590,5,1007,2331,0,43.2,17.67
高雄市,前鎮區,竹西里,1828,788,1040,12,1840,3965,0,46.41,19.87
高雄市,前鎮區,竹中里,1531,627,904,11,1542,3340,0,46.17,18.77
高雄市,前鎮區,瑞竹里,642,231,411,8,650,1563,0,41.59,14.78
高雄市,前鎮區,瑞南里,1916,652,1264,11,1927,4567,0,42.19,14.28
高雄市,前鎮區,瑞豐里,1084,391,693,10,1094,2650,0,41.28,14.75
高雄市,前鎮區,瑞祥里,1889,732,1157,14,1903,4492,0,42.36,16.3
高雄市,前鎮區,瑞東里,942,307,635,3,945,2252,0,41.96,13.63
高雄市,前鎮區,瑞和里,788,246,542,6,794,1810,0,43.87,13.59
高雄市,前鎮區,瑞平里,1599,593,1006,13,1612,3473,0,46.42,17.07
高雄市,前鎮區,瑞隆里,1491,525,966,14,1505,3408,0,44.16,15.4
高雄市,前鎮區,瑞北里,1351,452,899,15,1366,3140,0,43.5,14.39
高雄市,前鎮區,瑞西里,1062,302,760,11,1073,2484,0,43.2,12.16
高雄市,前鎮區,瑞崗里,1142,394,748,4,1146,2474,0,46.32,15.93
高雄市,前鎮區,瑞興里,1083,339,744,4,1087,2446,0,44.44,13.86
高雄市,前鎮區,瑞誠里,1070,426,644,7,1077,2518,0,42.77,16.92
高雄市,前鎮區,瑞文里,990,304,686,4,994,2355,0,42.21,12.91
高雄市,前鎮區,瑞華里,1956,763,1193,12,1968,4394,0,44.79,17.36
高雄市,前鎮區,瑞昌里,1314,415,899,10,1324,3072,0,43.1,13.51
高雄市,前鎮區,合計,70107,27596,42511,543,70650,159582,184355,44.27,17.29
高雄市,旗津區,旗下里,512,129,383,3,515,1181,0,43.61,10.92
高雄市,旗津區,永安里,384,139,245,4,388,1056,0,36.74,13.16
高雄市,旗津區,振興里,620,171,449,8,628,1544,0,40.67,11.08
高雄市,旗津區,慈愛里,789,233,556,6,795,2240,0,35.49,10.4
高雄市,旗津區,復興里,991,413,578,10,1001,2922,0,34.26,14.13
高雄市,旗津區,中華里,636,177,459,5,641,1497,0,42.82,11.82
高雄市,旗津區,實踐里,506,302,204,7,513,1394,0,36.8,21.66
高雄市,旗津區,北汕里,871,279,592,7,878,2620,0,33.51,10.65
高雄市,旗津區,南汕里,779,193,586,9,788,2021,0,38.99,9.55
高雄市,旗津區,上竹里,1030,211,819,12,1042,2749,0,37.9,7.68
高雄市,旗津區,中洲里,742,194,548,2,744,1802,0,41.29,10.77
高雄市,旗津區,安順里,332,61,271,0,332,863,0,38.47,7.07
高雄市,旗津區,中興里,1012,245,767,7,1019,2457,0,41.47,9.97
高雄市,旗津區,合計,9204,2747,6457,80,9284,24346,27515,38.13,11.28
高雄市,小港區,小港里,978,366,612,9,987,2204,0,44.78,16.61
高雄市,小港區,港口里,1374,626,748,7,1381,3080,0,44.84,20.32
高雄市,小港區,港正里,998,475,523,8,1006,2455,0,40.98,19.35
高雄市,小港區,港墘里,655,248,407,5,660,1658,0,39.81,14.96
高雄市,小港區,港明里,1118,407,711,12,1130,3006,0,37.59,13.54
高雄市,小港區,港后里,1090,394,696,5,1095,2482,0,44.12,15.87
高雄市,小港區,港南里,900,338,562,4,904,2715,0,33.3,12.45
高雄市,小港區,港興里,1013,369,644,7,1020,2209,0,46.17,16.7
高雄市,小港區,鳳宮里,995,332,663,4,999,2601,0,38.41,12.76
高雄市,小港區,店鎮里,2247,796,1451,20,2267,5620,0,40.34,14.16
高雄市,小港區,大苓里,1051,413,638,10,1061,2419,0,43.86,17.07
高雄市,小港區,二苓里,1417,461,956,6,1423,3563,0,39.94,12.94
高雄市,小港區,三苓里,1188,452,736,7,1195,2779,0,43.0,16.26
高雄市,小港區,正苓里,1467,616,851,16,1483,3906,0,37.97,15.77
高雄市,小港區,順苓里,1722,691,1031,9,1731,4344,0,39.85,15.91
高雄市,小港區,六苓里,1084,409,675,8,1092,2502,0,43.65,16.35
高雄市,小港區,宏亮里,1212,466,746,6,1218,3165,0,38.48,14.72
高雄市,小港區,山東里,1143,531,612,5,1148,2869,0,40.01,18.51
高雄市,小港區,青島里,1007,605,402,8,1015,2305,0,44.03,26.25
高雄市,小港區,濟南里,1666,780,886,10,1676,4066,0,41.22,19.18
高雄市,小港區,泰山里,1335,484,851,9,1344,3176,0,42.32,15.24
高雄市,小港區,山明里,4227,1476,2751,32,4259,11217,0,37.97,13.16
高雄市,小港區,高松里,1592,565,1027,14,1606,4154,0,38.66,13.6
高雄市,小港區,松金里,1004,347,657,8,1012,2549,0,39.7,13.61
高雄市,小港區,松山里,1330,527,803,12,1342,3066,0,43.77,17.19
高雄市,小港區,大坪里,1117,384,733,11,1128,2844,0,39.66,13.5
高雄市,小港區,坪頂里,2186,767,1419,12,2198,6006,0,36.6,12.77
高雄市,小港區,孔宅里,1930,704,1226,19,1949,4655,0,41.87,15.12
高雄市,小港區,廈莊里,1478,577,901,18,1496,3839,0,38.97,15.03
高雄市,小港區,合作里,1147,400,747,4,1151,2569,0,44.8,15.57
高雄市,小港區,桂林里,3077,1075,2002,17,3094,7687,0,40.25,13.98
高雄市,小港區,中厝里,1359,500,859,12,1371,3630,0,37.77,13.77
高雄市,小港區,鳳鳴里,1215,423,792,14,1229,3132,0,39.24,13.51
高雄市,小港區,龍鳳里,1188,398,790,9,1197,3059,0,39.13,13.01
高雄市,小港區,鳳森里,896,232,664,8,904,2196,0,41.17,10.56
高雄市,小港區,鳳林里,1208,334,874,6,1214,3013,0,40.29,11.09
高雄市,小港區,鳳興里,929,265,664,6,935,2483,0,37.66,10.67
高雄市,小港區,鳳源里,1340,309,1031,14,1354,3605,0,37.56,8.57
高雄市,小港區,合計,52883,19542,33341,391,53274,132828,156580,40.11,14.71
高雄市,鳳山區,縣口里,174,72,102,2,176,406,0,43.35,17.73
高雄市,鳳山區,成功里,280,104,176,1,281,599,0,46.91,17.36
高雄市,鳳山區,光明里,573,215,358,5,578,1288,0,44.88,16.69
高雄市,鳳山區,興中里,428,220,208,2,430,847,0,50.77,25.97
高雄市,鳳山區,南興里,414,162,252,1,415,864,0,48.03,18.75
高雄市,鳳山區,和德里,967,445,522,3,970,2199,0,44.11,20.24
高雄市,鳳山區,鳳崗里,490,244,246,4,494,1023,0,48.29,23.85
高雄市,鳳山區,中和里,1587,811,776,13,1600,3304,0,48.43,24.55
高雄市,鳳山區,鎮北里,3713,1483,2230,31,3744,10134,0,36.94,14.63
高雄市,鳳山區,縣衙里,359,169,190,2,361,800,0,45.13,21.13
高雄市,鳳山區,文英里,1515,616,899,7,1522,3583,0,42.48,17.19
高雄市,鳳山區,鎮西里,2155,917,1238,18,2173,4831,0,44.98,18.98
高雄市,鳳山區,鎮東里,953,397,556,6,959,2419,0,39.64,16.41
高雄市,鳳山區,埤頂里,2513,1212,1301,11,2524,5862,0,43.06,20.68
高雄市,鳳山區,中正里,1872,1507,365,20,1892,4101,0,46.14,36.75
高雄市,鳳山區,鎮南里,1969,730,1239,18,1987,4690,0,42.37,15.57
高雄市,鳳山區,老爺里,2795,932,1863,17,2812,6676,0,42.12,13.96
高雄市,鳳山區,瑞竹里,2122,1001,1121,13,2135,5045,0,42.32,19.84
高雄市,鳳山區,忠義里,2051,971,1080,17,2068,4468,0,46.28,21.73
高雄市,鳳山區,誠義里,1686,883,803,11,1697,3708,0,45.77,23.81
高雄市,鳳山區,新興里,715,274,441,4,719,3408,0,21.1,8.04
高雄市,鳳山區,海光里,1257,707,550,7,1264,2855,0,44.27,24.76
高雄市,鳳山區,忠誠里,1494,560,934,10,1504,3386,0,44.42,16.54
高雄市,鳳山區,新甲里,1339,516,823,15,1354,2970,0,45.59,17.37
高雄市,鳳山區,武漢里,2008,769,1239,11,2019,4656,0,43.36,16.52
高雄市,鳳山區,正義里,2609,886,1723,22,2631,6047,0,43.51,14.65
高雄市,鳳山區,一甲里,1257,397,860,12,1269,3158,0,40.18,12.57
高雄市,鳳山區,福興里,2330,791,1539,21,2351,5638,0,41.7,14.03
高雄市,鳳山區,東門里,2221,1225,996,20,2241,5295,0,42.32,23.14
高雄市,鳳山區,瑞興里,2012,1034,978,20,2032,4791,0,42.41,21.58
高雄市,鳳山區,天興里,1504,536,968,9,1513,3443,0,43.94,15.57
高雄市,鳳山區,新強里,2310,945,1365,10,2320,5183,0,44.76,18.23
高雄市,鳳山區,國泰里,1593,705,888,10,1603,3682,0,43.54,19.15
高雄市,鳳山區,鳳東里,2678,1172,1506,20,2698,6156,0,43.83,19.04
高雄市,鳳山區,新富里,1645,753,892,9,1654,3986,0,41.5,18.89
高雄市,鳳山區,國光里,1479,675,804,9,1488,3202,0,46.47,21.08
高雄市,鳳山區,國隆里,1066,356,710,7,1073,2412,0,44.49,14.76
高雄市,鳳山區,文德里,3796,1861,1935,19,3815,8807,0,43.32,21.13
高雄市,鳳山區,過埤里,5110,2093,3017,21,5131,13720,0,37.4,15.26
高雄市,鳳山區,曹公里,875,416,459,8,883,1878,0,47.02,22.15
高雄市,鳳山區,興仁里,1516,663,853,15,1531,3300,0,46.39,20.09
高雄市,鳳山區,五福里,1322,487,835,11,1333,2954,0,45.13,16.49
高雄市,鳳山區,忠孝里,2446,1140,1306,13,2459,5599,0,43.92,20.36
高雄市,鳳山區,生明里,890,498,392,9,899,1995,0,45.06,24.96
高雄市,鳳山區,和興里,2039,878,1161,17,2056,4606,0,44.64,19.06
高雄市,鳳山區,協和里,1472,801,671,9,1481,3154,0,46.96,25.4
高雄市,鳳山區,文山里,2714,1058,1656,19,2733,6154,0,44.41,17.19
高雄市,鳳山區,福誠里,1961,741,1220,19,1980,4554,0,43.48,16.27
高雄市,鳳山區,誠德里,1008,556,452,17,1025,2537,0,40.4,21.92
高雄市,鳳山區,三民里,505,230,275,7,512,1040,0,49.23,22.12
高雄市,鳳山區,北門里,1669,655,1014,13,1682,3969,0,42.38,16.5
高雄市,鳳山區,富甲里,730,276,454,8,738,1831,0,40.31,15.07
高雄市,鳳山區,南成里,3523,1208,2315,20,3543,8197,0,43.22,14.74
高雄市,鳳山區,文華里,3602,1919,1683,32,3634,8181,0,44.42,23.46
高雄市,鳳山區,大德里,1703,591,1112,15,1718,4349,0,39.5,13.59
高雄市,鳳山區,武松里,1045,411,634,8,1053,2612,0,40.31,15.74
高雄市,鳳山區,文衡里,1684,754,930,10,1694,4036,0,41.97,18.68
高雄市,鳳山區,文福里,4076,1921,2155,25,4101,9452,0,43.39,20.32
高雄市,鳳山區,誠信里,812,532,280,7,819,2046,0,40.03,26.0
高雄市,鳳山區,誠智里,1073,605,468,7,1080,2686,0,40.21,22.52
高雄市,鳳山區,國富里,1180,561,619,6,1186,2531,0,46.86,22.17
高雄市,鳳山區,武慶里,1008,385,623,9,1017,2292,0,44.37,16.8
高雄市,鳳山區,海洋里,1670,693,977,13,1683,3737,0,45.04,18.54
高雄市,鳳山區,新武里,1043,362,681,10,1053,2353,0,44.75,15.38
高雄市,鳳山區,新樂里,1816,759,1057,5,1821,4273,0,42.62,17.76
高雄市,鳳山區,新泰里,1637,729,908,11,1648,4006,0,41.14,18.2
高雄市,鳳山區,中崙里,1065,461,604,7,1072,2454,0,43.68,18.79
高雄市,鳳山區,中榮里,1745,748,997,8,1753,4441,0,39.47,16.84
高雄市,鳳山區,中民里,1830,667,1163,18,1848,4469,0,41.35,14.93
高雄市,鳳山區,二甲里,1918,695,1223,15,1933,4472,0,43.22,15.54
高雄市,鳳山區,龍成里,1134,361,773,4,1138,2740,0,41.53,13.18
高雄市,鳳山區,富榮里,986,386,600,6,992,2367,0,41.91,16.31
高雄市,鳳山區,善美里,2060,759,1301,18,2078,5524,0,37.62,13.74
高雄市,鳳山區,南和里,1099,392,707,12,1111,2597,0,42.78,15.09
高雄市,鳳山區,福祥里,1098,333,765,4,1102,2652,0,41.55,12.56
高雄市,鳳山區,保安里,2640,1007,1633,19,2659,6389,0,41.62,15.76
高雄市,鳳山區,合計,127633,54984,72649,912,128545,302069,358785,42.55,18.2
高雄市,林園區,東林里,1020,327,693,7,1027,2799,0,36.69,11.68
高雄市,林園區,林園里,1248,442,806,13,1261,3070,0,41.07,14.4
高雄市,林園區,溪州里,1537,487,1050,16,1553,4129,0,37.61,11.79
高雄市,林園區,潭頭里,1064,399,665,14,1078,2749,0,39.21,14.51
高雄市,林園區,中厝里,1236,472,764,18,1254,2981,0,42.07,15.83
高雄市,林園區,中門里,988,322,666,13,1001,2474,0,40.46,13.02
高雄市,林園區,頂厝里,1769,538,1231,22,1791,4546,0,39.4,11.83
高雄市,林園區,港埔里,753,208,545,9,762,1795,0,42.45,11.59
高雄市,林園區,西溪里,1302,326,976,16,1318,3401,0,38.75,9.59
高雄市,林園區,港嘴里,704,177,527,9,713,1671,0,42.67,10.59
高雄市,林園區,北汕里,526,184,342,4,530,1576,0,33.63,11.68
高雄市,林園區,林內里,714,317,397,9,723,1960,0,36.89,16.17
高雄市,林園區,王公里,1614,567,1047,16,1630,4087,0,39.88,13.87
高雄市,林園區,林家里,479,162,317,3,482,1274,0,37.83,12.72
高雄市,林園區,龔厝里,856,255,601,3,859,1939,0,44.3,13.15
高雄市,林園區,鳳芸里,715,173,542,6,721,1726,0,41.77,10.02
高雄市,林園區,中芸里,693,151,542,8,701,1767,0,39.67,8.55
高雄市,林園區,東汕里,319,82,237,2,321,883,0,36.35,9.29
高雄市,林園區,西汕里,264,64,200,0,264,729,0,36.21,8.78
高雄市,林園區,仁愛里,1202,360,842,10,1212,2918,0,41.54,12.34
高雄市,林園區,文賢里,1012,384,628,11,1023,2393,0,42.75,16.05
高雄市,林園區,廣應里,1338,437,901,12,1350,3366,0,40.11,12.98
高雄市,林園區,五福里,854,268,586,7,861,2660,0,32.37,10.08
高雄市,林園區,中汕里,763,149,614,14,777,2268,0,34.26,6.57
高雄市,林園區,合計,22970,7251,15719,242,23212,59161,69161,39.24,12.26
高雄市,大寮區,拷潭里,587,155,432,10,597,1391,0,42.92,11.14
高雄市,大寮區,內坑里,2101,786,1315,19,2120,5790,0,36.61,13.58
高雄市,大寮區,大寮里,2389,765,1624,37,2426,6676,0,36.34,11.46
高雄市,大寮區,上寮里,984,261,723,8,992,2414,0,41.09,10.81
高雄市,大寮區,三隆里,1869,607,1262,21,1890,4615,0,40.95,13.15
高雄市,大寮區,琉球里,1974,582,1392,14,1988,4639,0,42.85,12.55
高雄市,大寮區,翁園里,1752,441,1311,16,1768,3885,0,45.51,11.35
高雄市,大寮區,前庄里,1087,448,639,10,1097,2318,0,47.33,19.33
高雄市,大寮區,中庄里,4181,1505,2676,38,4219,10756,0,39.22,13.99
高雄市,大寮區,後庄里,3086,1223,1863,26,3112,7626,0,40.81,16.04
高雄市,大寮區,義仁里,750,222,528,10,760,1803,0,42.15,12.31
高雄市,大寮區,新厝里,596,180,416,3,599,1666,0,35.95,10.8
高雄市,大寮區,過溪里,994,322,672,9,1003,2472,0,40.57,13.03
高雄市,大寮區,潮寮里,1179,319,860,18,1197,2917,0,41.04,10.94
高雄市,大寮區,會結里,592,194,398,3,595,1538,0,38.69,12.61
高雄市,大寮區,會社里,2338,985,1353,24,2362,6229,0,37.92,15.81
高雄市,大寮區,山頂里,2968,1446,1522,26,2994,7455,0,40.16,19.4
高雄市,大寮區,忠義里,244,157,87,4,248,541,0,45.84,29.02
高雄市,大寮區,永芳里,2771,1015,1756,18,2789,6812,0,40.94,14.9
高雄市,大寮區,義和里,956,293,663,11,967,2201,0,43.93,13.31
高雄市,大寮區,溪寮里,677,223,454,5,682,1545,0,44.14,14.43
高雄市,大寮區,江山里,822,260,562,6,828,1851,0,44.73,14.05
高雄市,大寮區,昭明里,1399,411,988,13,1412,3723,0,37.93,11.04
高雄市,大寮區,光武里,42,28,14,4,46,111,0,41.44,25.23
高雄市,大寮區,中興里,2761,1652,1109,30,2791,6664,0,41.88,24.79
高雄市,大寮區,合計,39099,14480,24619,383,39482,97638,112129,40.44,14.83
高雄市,大樹區,竹寮里,1119,435,684,7,1126,2680,0,42.01,16.23
高雄市,大樹區,九曲里,1906,751,1155,20,1926,5186,0,37.14,14.48
高雄市,大樹區,久堂里,1733,680,1053,20,1753,4079,0,42.98,16.67
高雄市,大樹區,水安里,1024,308,716,12,1036,2313,0,44.79,13.32
高雄市,大樹區,水寮里,1015,298,717,6,1021,2219,0,46.01,13.43
高雄市,大樹區,檨腳里,1347,412,935,10,1357,3451,0,39.32,11.94
高雄市,大樹區,興山里,420,87,333,1,421,1026,0,41.03,8.48
高雄市,大樹區,和山里,403,114,289,3,406,994,0,40.85,11.47
高雄市,大樹區,姑山里,435,109,326,5,440,962,0,45.74,11.33
高雄市,大樹區,大坑里,564,168,396,7,571,1434,0,39.82,11.72
高雄市,大樹區,井腳里,651,159,492,6,657,1505,0,43.65,10.56
高雄市,大樹區,小坪里,562,172,390,12,574,1311,0,43.78,13.12
高雄市,大樹區,龍目里,765,138,627,10,775,1752,0,44.24,7.88
高雄市,大樹區,大樹里,1000,266,734,10,1010,2492,0,40.53,10.67
高雄市,大樹區,三和里,379,142,237,1,380,994,0,38.23,14.29
高雄市,大樹區,溪埔里,623,165,458,10,633,1539,0,41.13,10.72
高雄市,大樹區,興田里,749,306,443,10,759,1855,0,40.92,16.5
高雄市,大樹區,統嶺里,264,82,182,2,266,670,0,39.7,12.24
高雄市,大樹區,合計,14959,4792,10167,152,15111,36462,41549,41.44,13.14
高雄市,大社區,嘉誠里,318,127,191,3,321,899,0,35.71,14.13
高雄市,大社區,保社里,1414,503,911,16,1430,3267,0,43.77,15.4
高雄市,大社區,大社里,2051,713,1338,11,2062,4936,0,41.77,14.44
高雄市,大社區,翠屏里,691,201,490,8,699,1648,0,42.42,12.2
高雄市,大社區,三奶里,1174,370,804,14,1188,2706,0,43.9,13.67
高雄市,大社區,觀音里,2409,760,1649,28,2437,5416,0,45.0,14.03
高雄市,大社區,神農里,1917,675,1242,13,1930,4948,0,39.01,13.64
高雄市,大社區,中里里,1330,445,885,18,1348,3171,0,42.51,14.03
高雄市,大社區,保安里,1310,411,899,18,1328,3118,0,42.59,13.18
高雄市,大社區,合計,12614,4205,8409,129,12743,30109,34208,42.32,13.97
高雄市,仁武區,大灣里,1837,655,1182,8,1845,4416,0,41.78,14.83
高雄市,仁武區,灣內里,3146,1158,1988,26,3172,7950,0,39.9,14.57
高雄市,仁武區,考潭里,1214,472,742,10,1224,2625,0,46.63,17.98
高雄市,仁武區,烏林里,1364,494,870,17,1381,3764,0,36.69,13.12
高雄市,仁武區,仁福里,323,107,216,9,332,849,0,39.1,12.6
高雄市,仁武區,仁武里,2038,663,1375,17,2055,5452,0,37.69,12.16
高雄市,仁武區,文武里,3766,1316,2450,27,3793,9055,0,41.89,14.53
高雄市,仁武區,竹後里,1015,230,785,10,1025,2172,0,47.19,10.59
高雄市,仁武區,八卦里,7048,2794,4254,43,7091,17709,0,40.04,15.78
高雄市,仁武區,高楠里,1087,399,688,14,1101,2610,0,42.18,15.29
高雄市,仁武區,後安里,1067,286,781,6,1073,2542,0,42.21,11.25
高雄市,仁武區,中華里,646,260,386,4,650,1606,0,40.47,16.19
高雄市,仁武區,五和里,2000,744,1256,10,2010,5171,0,38.87,14.39
高雄市,仁武區,仁和里,1701,655,1046,11,1712,3838,0,44.61,17.07
高雄市,仁武區,赤山里,2849,1123,1726,22,2871,6762,0,42.46,16.61
高雄市,仁武區,仁慈里,1064,421,643,9,1073,2202,0,48.73,19.12
高雄市,仁武區,合計,32165,11777,20388,243,32408,78723,92846,41.17,14.96
高雄市,鳥松區,鳥松里,4426,1760,2666,32,4458,10418,0,42.79,16.89
高雄市,鳥松區,夢裡里,2309,954,1355,14,2323,4917,0,47.24,19.4
高雄市,鳥松區,大華里,4823,2138,2685,16,4839,9866,0,49.05,21.67
高雄市,鳥松區,坔埔里,1637,564,1073,6,1643,3551,0,46.27,15.88
高雄市,鳥松區,仁美里,2751,856,1895,22,2773,6496,0,42.69,13.18
高雄市,鳥松區,大竹里,334,97,237,3,337,678,0,49.71,14.31
高雄市,鳥松區,華美里,1732,643,1089,11,1743,3874,0,44.99,16.6
高雄市,鳥松區,合計,18012,7012,11000,104,18116,39800,44727,45.52,17.62
高雄市,岡山區,平安里,470,193,277,6,476,1073,0,44.36,17.99
高雄市,岡山區,岡山里,1679,661,1018,4,1683,4363,0,38.57,15.15
高雄市,岡山區,壽天里,1435,650,785,13,1448,3149,0,45.98,20.64
高雄市,岡山區,維仁里,416,150,266,4,420,985,0,42.64,15.23
高雄市,岡山區,後紅里,1692,794,898,18,1710,4134,0,41.36,19.21
高雄市,岡山區,大遼里,636,186,450,8,644,1366,0,47.14,13.62
高雄市,岡山區,忠孝里,1326,1020,306,11,1337,2810,0,47.58,36.3
高雄市,岡山區,和平里,152,67,85,2,154,300,0,51.33,22.33
高雄市,岡山區,前峰里,1188,463,725,10,1198,2809,0,42.65,16.48
高雄市,岡山區,劉厝里,706,224,482,8,714,1401,0,50.96,15.99
高雄市,岡山區,協和里,1612,671,941,23,1635,3572,0,45.77,18.78
高雄市,岡山區,後協里,2229,1051,1178,17,2246,5458,0,41.15,19.26
高雄市,岡山區,信義里,657,372,285,4,661,1556,0,42.48,23.91
高雄市,岡山區,潭底里,337,87,250,3,340,761,0,44.68,11.43
高雄市,岡山區,三和里,365,78,287,4,369,867,0,42.56,9.0
高雄市,岡山區,仁壽里,1502,623,879,11,1513,3290,0,45.99,18.94
高雄市,岡山區,碧紅里,1543,628,915,10,1553,3822,0,40.63,16.43
高雄市,岡山區,程香里,1718,794,924,13,1731,4091,0,42.31,19.41
高雄市,岡山區,竹圍里,2652,1068,1584,20,2672,6810,0,39.24,15.68
高雄市,岡山區,台上里,2311,877,1434,14,2325,5811,0,40.01,15.09
高雄市,岡山區,灣裡里,769,286,483,4,773,1862,0,41.51,15.36
高雄市,岡山區,白米里,783,307,476,5,788,1933,0,40.77,15.88
高雄市,岡山區,石潭里,887,317,570,5,892,1850,0,48.22,17.14
高雄市,岡山區,福興里,472,182,290,3,475,1048,0,45.32,17.37
高雄市,岡山區,本洲里,679,236,443,3,682,1683,0,40.52,14.02
高雄市,岡山區,嘉興里,1397,397,1000,11,1408,3339,0,42.17,11.89
高雄市,岡山區,嘉峰里,776,277,499,9,785,1747,0,44.93,15.86
高雄市,岡山區,華崗里,749,141,608,8,757,1567,0,48.31,9.0
高雄市,岡山區,大莊里,362,134,228,4,366,984,0,37.2,13.62
高雄市,岡山區,協榮里,869,463,406,1,870,2090,0,41.63,22.15
高雄市,岡山區,為隨里,290,93,197,3,293,631,0,46.43,14.74
高雄市,岡山區,壽峰里,964,445,519,8,972,2230,0,43.59,19.96
高雄市,岡山區,仁義里,985,880,105,10,995,1809,0,55.0,48.65
高雄市,岡山區,合計,34608,14815,19793,277,34885,81201,96433,42.96,18.24
高雄市,橋頭區,橋頭里,944,353,591,7,951,2052,0,46.35,17.2
高雄市,橋頭區,橋南里,542,170,372,4,546,1060,0,51.51,16.04
高雄市,橋頭區,仕隆里,1130,362,768,8,1138,2289,0,49.72,15.81
高雄市,橋頭區,仕豐里,1252,463,789,10,1262,2597,0,48.59,17.83
高雄市,橋頭區,芋寮里,559,168,391,3,562,1196,0,46.99,14.05
高雄市,橋頭區,東林里,1075,304,771,11,1086,2294,0,47.34,13.25
高雄市,橋頭區,西林里,653,168,485,4,657,1371,0,47.92,12.25
高雄市,橋頭區,白樹里,1439,511,928,14,1453,3241,0,44.83,15.77
高雄市,橋頭區,筆秀里,726,203,523,8,734,1506,0,48.74,13.48
高雄市,橋頭區,新莊里,1865,763,1102,7,1872,4359,0,42.95,17.5
高雄市,橋頭區,甲北里,929,324,605,17,946,2139,0,44.23,15.15
高雄市,橋頭區,甲南里,1071,354,717,14,1085,2401,0,45.19,14.74
高雄市,橋頭區,頂鹽里,589,188,401,8,597,1340,0,44.55,14.03
高雄市,橋頭區,中崎里,283,61,222,2,285,662,0,43.05,9.21
高雄市,橋頭區,仕和里,1763,549,1214,16,1779,3625,0,49.08,15.14
高雄市,橋頭區,德松里,666,215,451,8,674,1442,0,46.74,14.91
高雄市,橋頭區,三德里,353,77,276,3,356,776,0,45.88,9.92
高雄市,橋頭區,合計,15839,5233,10606,144,15983,34350,39528,46.53,15.23
高雄市,燕巢區,尖山里,435,136,299,0,435,1096,0,39.69,12.41
高雄市,燕巢區,瓊林里,911,296,615,11,922,2055,0,44.87,14.4
高雄市,燕巢區,安招里,1388,471,917,24,1412,3308,0,42.68,14.24
高雄市,燕巢區,角宿里,1144,436,708,14,1158,2690,0,43.05,16.21
高雄市,燕巢區,鳳雄里,1051,362,689,8,1059,2471,0,42.86,14.65
高雄市,燕巢區,金山里,165,79,86,6,171,464,0,36.85,17.03
高雄市,燕巢區,東燕里,874,309,565,8,882,2315,0,38.1,13.35
高雄市,燕巢區,南燕里,1500,642,858,13,1513,3871,0,39.09,16.58
高雄市,燕巢區,西燕里,1279,465,814,11,1290,3315,0,38.91,14.03
高雄市,燕巢區,橫山里,700,249,451,8,708,1874,0,37.78,13.29
高雄市,燕巢區,深水里,890,299,591,10,900,2396,0,37.56,12.48
高雄市,燕巢區,合計,10337,3744,6593,113,10450,25855,29312,40.42,14.48
高雄市,田寮區,鹿埔里,142,50,92,0,142,347,0,40.92,14.41
高雄市,田寮區,南安里,366,108,258,8,374,1016,0,36.81,10.63
高雄市,田寮區,大同里,142,27,115,1,143,364,0,39.29,7.42
高雄市,田寮區,田寮里,128,32,96,1,129,364,0,35.44,8.79
高雄市,田寮區,七星里,224,54,170,3,227,594,0,38.22,9.09
高雄市,田寮區,崇德里,342,137,205,6,348,914,0,38.07,14.99
高雄市,田寮區,西德里,255,89,166,6,261,777,0,33.59,11.45
高雄市,田寮區,三和里,110,42,68,2,112,333,0,33.63,12.61
高雄市,田寮區,古亭里,159,42,117,3,162,484,0,33.47,8.68
高雄市,田寮區,新興里,452,112,340,7,459,1164,0,39.43,9.62
高雄市,田寮區,合計,2320,693,1627,37,2357,6357,6860,37.08,10.9
高雄市,阿蓮區,石安里,485,129,356,4,489,1283,0,38.11,10.05
高雄市,阿蓮區,中路里,823,180,643,12,835,1973,0,42.32,9.12
高雄市,阿蓮區,峯山里,460,123,337,5,465,1209,0,38.46,10.17
高雄市,阿蓮區,港後里,870,360,510,7,877,2122,0,41.33,16.97
高雄市,阿蓮區,崗山里,271,109,162,8,279,761,0,36.66,14.32
高雄市,阿蓮區,阿蓮里,1787,596,1191,21,1808,4888,0,36.99,12.19
高雄市,阿蓮區,清蓮里,951,296,655,12,963,2590,0,37.18,11.43
高雄市,阿蓮區,和蓮里,915,275,640,13,928,2291,0,40.51,12.0
高雄市,阿蓮區,青旗里,563,205,358,4,567,1541,0,36.79,13.3
高雄市,阿蓮區,復安里,630,210,420,10,640,1648,0,38.83,12.74
高雄市,阿蓮區,玉庫里,455,102,353,11,466,1043,0,44.68,9.78
高雄市,阿蓮區,南蓮里,1134,450,684,6,1140,2960,0,38.51,15.2
高雄市,阿蓮區,合計,9344,3035,6309,113,9457,24309,28170,38.9,12.49
高雄市,路竹區,竹滬里,1150,430,720,9,1159,3254,0,35.62,13.21
高雄市,路竹區,頂寮里,468,171,297,7,475,1144,0,41.52,14.95
高雄市,路竹區,新達里,442,151,291,7,449,1195,0,37.57,12.64
高雄市,路竹區,後鄉里,436,140,296,1,437,1098,0,39.8,12.75
高雄市,路竹區,北嶺里,568,193,375,6,574,1220,0,47.05,15.82
高雄市,路竹區,社西里,897,344,553,12,909,2211,0,41.11,15.56
高雄市,路竹區,甲北里,818,295,523,8,826,2084,0,39.64,14.16
高雄市,路竹區,甲南里,1198,533,665,13,1211,3276,0,36.97,16.27
高雄市,路竹區,下坑里,964,306,658,12,976,2623,0,37.21,11.67
高雄市,路竹區,竹園里,655,202,453,7,662,1825,0,36.27,11.07
高雄市,路竹區,竹東里,1384,563,821,10,1394,3439,0,40.54,16.37
高雄市,路竹區,竹西里,869,365,504,7,876,2163,0,40.5,16.87
高雄市,路竹區,文北里,1149,396,753,8,1157,2976,0,38.88,13.31
高雄市,路竹區,文南里,1013,424,589,10,1023,2337,0,43.77,18.14
高雄市,路竹區,三爺里,358,110,248,2,360,841,0,42.81,13.08
高雄市,路竹區,鴨寮里,770,274,496,9,779,1908,0,40.83,14.36
高雄市,路竹區,社東里,681,220,461,8,689,1711,0,40.27,12.86
高雄市,路竹區,社中里,330,106,224,3,333,846,0,39.36,12.53
高雄市,路竹區,竹南里,1168,470,698,8,1176,2643,0,44.49,17.78
高雄市,路竹區,社南里,1809,730,1079,24,1833,4526,0,40.5,16.13
高雄市,路竹區,合計,17127,6423,10704,171,17298,43320,51490,39.93,14.83
高雄市,湖內區,海山里,475,160,315,5,480,1070,0,44.86,14.95
高雄市,湖內區,劉家里,392,121,271,3,395,981,0,40.27,12.33
高雄市,湖內區,太爺里,358,96,262,2,360,768,0,46.88,12.5
高雄市,湖內區,公舘里,856,306,550,6,862,2214,0,38.93,13.82
高雄市,湖內區,葉厝里,1026,277,749,7,1033,2648,0,39.01,10.46
高雄市,湖內區,大湖里,1441,564,877,10,1451,3677,0,39.46,15.34
高雄市,湖內區,田尾里,399,151,248,4,403,997,0,40.42,15.15
高雄市,湖內區,湖內里,1477,576,901,10,1487,3781,0,39.33,15.23
高雄市,湖內區,海埔里,716,191,525,9,725,1752,0,41.38,10.9
高雄市,湖內區,文賢里,482,152,330,3,485,1198,0,40.48,12.69
高雄市,湖內區,中賢里,765,207,558,7,772,2155,0,35.82,9.61
高雄市,湖內區,逸賢里,423,121,302,7,430,1133,0,37.95,10.68
高雄市,湖內區,忠興里,275,86,189,2,277,700,0,39.57,12.29
高雄市,湖內區,湖東里,932,396,536,15,947,2739,0,34.57,14.46
高雄市,湖內區,合計,10017,3404,6613,90,10107,25813,29772,39.15,13.19
高雄市,茄萣區,福德里,421,109,312,3,424,955,0,44.4,11.41
高雄市,茄萣區,萬福里,333,109,224,4,337,854,0,39.46,12.76
高雄市,茄萣區,白雲里,685,266,419,4,689,1718,0,40.1,15.48
高雄市,茄萣區,嘉賜里,1454,473,981,7,1461,3784,0,38.61,12.5
高雄市,茄萣區,嘉安里,670,241,429,1,671,1771,0,37.89,13.61
高雄市,茄萣區,嘉定里,420,114,306,3,423,1100,0,38.45,10.36
高雄市,茄萣區,保定里,1116,332,784,5,1121,2955,0,37.94,11.24
高雄市,茄萣區,光定里,307,104,203,1,308,919,0,33.51,11.32
高雄市,茄萣區,大定里,340,117,223,4,344,1060,0,32.45,11.04
高雄市,茄萣區,吉定里,433,118,315,5,438,1114,0,39.32,10.59
高雄市,茄萣區,嘉樂里,760,269,491,9,769,2061,0,37.31,13.05
高雄市,茄萣區,嘉泰里,382,105,277,2,384,1067,0,35.99,9.84
高雄市,茄萣區,嘉福里,310,98,212,6,316,966,0,32.71,10.14
高雄市,茄萣區,和協里,458,143,315,3,461,1116,0,41.31,12.81
高雄市,茄萣區,崎漏里,1661,622,1039,23,1684,4679,0,35.99,13.29
高雄市,茄萣區,合計,9750,3220,6530,80,9830,26119,29883,37.64,12.33
高雄市,永安區,永安里,639,260,379,3,642,1558,0,41.21,16.69
高雄市,永安區,永華里,736,278,458,5,741,1799,0,41.19,15.45
高雄市,永安區,新港里,888,283,605,4,892,2291,0,38.93,12.35
高雄市,永安區,鹽田里,141,39,102,1,142,374,0,37.97,10.43
高雄市,永安區,保寧里,949,386,563,4,953,2564,0,37.17,15.05
高雄市,永安區,維新里,1255,435,820,11,1266,3396,0,37.28,12.81
高雄市,永安區,合計,4608,1681,2927,28,4636,11982,13609,38.69,14.03
高雄市,彌陀區,光和里,498,162,336,7,505,1250,0,40.4,12.96
高雄市,彌陀區,彌靖里,779,281,498,8,787,1846,0,42.63,15.22
高雄市,彌陀區,彌仁里,214,100,114,1,215,533,0,40.34,18.76
高雄市,彌陀區,彌壽里,343,161,182,2,345,738,0,46.75,21.82
高雄市,彌陀區,彌陀里,735,308,427,8,743,1710,0,43.45,18.01
高雄市,彌陀區,舊港里,622,234,388,7,629,1565,0,40.19,14.95
高雄市,彌陀區,文安里,670,230,440,11,681,1681,0,40.51,13.68
高雄市,彌陀區,鹽埕里,805,308,497,5,810,2007,0,40.36,15.35
高雄市,彌陀區,過港里,357,142,215,7,364,918,0,39.65,15.47
高雄市,彌陀區,海尾里,294,124,170,3,297,804,0,36.94,15.42
高雄市,彌陀區,漯底里,453,216,237,5,458,1134,0,40.39,19.05
高雄市,彌陀區,南寮里,804,314,490,6,810,2085,0,38.85,15.06
高雄市,彌陀區,合計,6574,2580,3994,70,6644,16271,18759,40.83,15.86
高雄市,梓官區,梓信里,911,252,659,5,916,2095,0,43.72,12.03
高雄市,梓官區,梓義里,825,268,557,5,830,2030,0,40.89,13.2
高雄市,梓官區,梓和里,1095,342,753,4,1099,2213,0,49.66,15.45
高雄市,梓官區,梓平里,659,194,465,11,670,1476,0,45.39,13.14
高雄市,梓官區,中崙里,561,168,393,2,563,1154,0,48.79,14.56
高雄市,梓官區,赤崁里,767,218,549,7,774,1791,0,43.22,12.17
高雄市,梓官區,禮蚵里,799,209,590,7,806,2055,0,39.22,10.17
高雄市,梓官區,智蚵里,1122,386,736,8,1130,2858,0,39.54,13.51
高雄市,梓官區,信蚵里,876,317,559,6,882,2313,0,38.13,13.71
高雄市,梓官區,同安里,386,125,261,3,389,970,0,40.1,12.89
高雄市,梓官區,大舍里,1528,474,1054,14,1542,3701,0,41.66,12.81
高雄市,梓官區,赤東里,906,251,655,11,917,2221,0,41.29,11.3
高雄市,梓官區,赤西里,342,121,221,4,346,801,0,43.2,15.11
高雄市,梓官區,茄苳里,905,312,593,10,915,2258,0,40.52,13.82
高雄市,梓官區,典寶里,1301,489,812,10,1311,2972,0,44.11,16.45
高雄市,梓官區,合計,12983,4126,8857,107,13090,30908,35292,42.35,13.35
高雄市,旗山區,太平里,835,336,499,6,841,2165,0,38.85,15.52
高雄市,旗山區,大德里,919,422,497,12,931,2273,0,40.96,18.57
高雄市,旗山區,湄洲里,579,214,365,6,585,1578,0,37.07,13.56
高雄市,旗山區,圓富里,585,232,353,10,595,1802,0,33.02,12.87
高雄市,旗山區,中正里,456,213,243,4,460,1418,0,32.44,15.02
高雄市,旗山區,大林里,414,191,223,7,421,1338,0,31.46,14.28
高雄市,旗山區,上洲里,386,93,293,1,387,1008,0,38.39,9.23
高雄市,旗山區,新光里,317,115,202,9,326,759,0,42.95,15.15
高雄市,旗山區,南勝里,841,250,591,13,854,2092,0,40.82,11.95
高雄市,旗山區,中寮里,67,19,48,1,68,179,0,37.99,10.61
高雄市,旗山區,東平里,806,320,486,11,817,1924,0,42.46,16.63
高雄市,旗山區,東昌里,389,175,214,3,392,983,0,39.88,17.8
高雄市,旗山區,竹峰里,568,254,314,9,577,1544,0,37.37,16.45
高雄市,旗山區,瑞吉里,755,278,477,6,761,1999,0,38.07,13.91
高雄市,旗山區,永和里,1108,408,700,12,1120,3245,0,34.51,12.57
高雄市,旗山區,三協里,834,322,512,5,839,2216,0,37.86,14.53
高雄市,旗山區,鯤洲里,324,69,255,4,328,705,0,46.52,9.79
高雄市,旗山區,大山里,482,148,334,5,487,1254,0,38.84,11.8
高雄市,旗山區,中洲里,326,91,235,4,330,797,0,41.41,11.42
高雄市,旗山區,南洲里,523,164,359,7,530,1262,0,42.0,13.0
高雄市,旗山區,廣福里,219,112,107,7,226,611,0,36.99,18.33
高雄市,旗山區,合計,11733,4426,7307,142,11875,31152,35449,38.12,14.21
高雄市,美濃區,福安里,982,457,525,12,994,2547,0,39.03,17.94
高雄市,美濃區,合和里,833,448,385,9,842,2321,0,36.28,19.3
高雄市,美濃區,祿興里,967,496,471,15,982,2552,0,38.48,19.44
高雄市,美濃區,中壇里,702,339,363,4,706,1978,0,35.69,17.14
高雄市,美濃區,德興里,539,320,219,7,546,1462,0,37.35,21.89
高雄市,美濃區,龍山里,685,335,350,14,699,2113,0,33.08,15.85
高雄市,美濃區,獅山里,963,417,546,6,969,2433,0,39.83,17.14
高雄市,美濃區,龍肚里,531,247,284,6,537,1382,0,38.86,17.87
高雄市,美濃區,廣德里,468,202,266,5,473,1299,0,36.41,15.55
高雄市,美濃區,興隆里,425,180,245,7,432,1158,0,37.31,15.54
高雄市,美濃區,中圳里,754,395,359,10,764,2066,0,36.98,19.12
高雄市,美濃區,東門里,429,187,242,2,431,1184,0,36.4,15.79
高雄市,美濃區,泰安里,611,312,299,4,615,1527,0,40.28,20.43
高雄市,美濃區,瀰濃里,791,363,428,5,796,2186,0,36.41,16.61
高雄市,美濃區,清水里,662,320,342,3,665,1720,0,38.66,18.6
高雄市,美濃區,吉洋里,680,301,379,11,691,1826,0,37.84,16.48
高雄市,美濃區,吉和里,495,255,240,7,502,1334,0,37.63,19.12
高雄市,美濃區,吉東里,593,219,374,5,598,1779,0,33.61,12.31
高雄市,美濃區,廣林里,508,231,277,14,522,1436,0,36.35,16.09
高雄市,美濃區,合計,12618,6024,6594,146,12764,34303,38209,37.21,17.56
高雄市,六龜區,新威里,228,80,148,4,232,714,0,32.49,11.2
高雄市,六龜區,新興里,192,62,130,3,195,649,0,30.05,9.55
高雄市,六龜區,新寮里,236,83,153,6,242,626,0,38.66,13.26
高雄市,六龜區,新發里,225,83,142,1,226,926,0,24.41,8.96
高雄市,六龜區,荖濃里,328,118,210,6,334,1359,0,24.58,8.68
高雄市,六龜區,六龜里,237,79,158,5,242,942,0,25.69,8.39
高雄市,六龜區,義寶里,351,154,197,4,355,1029,0,34.5,14.97
高雄市,六龜區,興龍里,222,64,158,5,227,785,0,28.92,8.15
高雄市,六龜區,中興里,459,253,206,11,470,1363,0,34.48,18.56
高雄市,六龜區,寶來里,241,92,149,6,247,858,0,28.79,10.72
高雄市,六龜區,文武里,370,146,224,6,376,1379,0,27.27,10.59
高雄市,六龜區,大津里,124,41,83,2,126,303,0,41.58,13.53
高雄市,六龜區,合計,3213,1255,1958,59,3272,10933,12236,29.93,11.48
高雄市,甲仙區,東安里,109,58,51,3,112,445,0,25.17,13.03
高雄市,甲仙區,西安里,352,231,121,4,356,835,0,42.63,27.66
高雄市,甲仙區,和安里,232,142,90,2,234,668,0,35.03,21.26
高雄市,甲仙區,大田里,441,213,228,7,448,1557,0,28.77,13.68
高雄市,甲仙區,寶隆里,219,72,147,5,224,651,0,34.41,11.06
高雄市,甲仙區,關山里,200,83,117,4,204,587,0,34.75,14.14
高雄市,甲仙區,小林里,130,61,69,2,132,514,0,25.68,11.87
高雄市,甲仙區,合計,1683,860,823,27,1710,5257,5798,32.53,16.36
高雄市,杉林區,杉林里,166,57,109,3,169,597,0,28.31,9.55
高雄市,杉林區,木梓里,155,49,106,3,158,655,0,24.12,7.48
高雄市,杉林區,集來里,325,100,225,4,329,1230,0,26.75,8.13
高雄市,杉林區,新庄里,480,226,254,9,489,1464,0,33.4,15.44
高雄市,杉林區,上平里,462,218,244,10,472,1537,0,30.71,14.18
高雄市,杉林區,月眉里,548,279,269,10,558,1603,0,34.81,17.4
高雄市,杉林區,月美里,382,146,236,10,392,1207,0,32.48,12.1
高雄市,杉林區,大愛里,519,211,308,4,523,1965,0,26.62,10.74
高雄市,杉林區,合計,3037,1286,1751,53,3090,10258,11365,30.12,12.54
高雄市,內門區,溝坪里,246,91,155,3,249,931,0,26.75,9.77
高雄市,內門區,金竹里,203,63,140,6,209,627,0,33.33,10.05
高雄市,內門區,永富里,285,115,170,7,292,955,0,30.58,12.04
高雄市,內門區,永吉里,119,56,63,1,120,413,0,29.06,13.56
高雄市,內門區,永興里,119,46,73,2,121,384,0,31.51,11.98
高雄市,內門區,石坑里,117,44,73,1,118,493,0,23.94,8.92
高雄市,內門區,內門里,364,160,204,4,368,963,0,38.21,16.61
高雄市,內門區,內豊里,365,145,220,4,369,1176,0,31.38,12.33
高雄市,內門區,觀亭里,559,253,306,8,567,1682,0,33.71,15.04
高雄市,內門區,中埔里,176,99,77,1,177,537,0,32.96,18.44
高雄市,內門區,內東里,279,99,180,6,285,765,0,37.25,12.94
高雄市,內門區,內南里,102,47,55,1,103,403,0,25.56,11.66
高雄市,內門區,東埔里,150,50,100,2,152,474,0,32.07,10.55
高雄市,內門區,三平里,196,63,133,5,201,638,0,31.5,9.87
高雄市,內門區,木柵里,184,51,133,4,188,589,0,31.92,8.66
高雄市,內門區,內興里,164,28,136,4,168,602,0,27.91,4.65
高雄市,內門區,瑞山里,117,59,58,5,122,318,0,38.36,18.55
高雄市,內門區,光興里,194,81,113,0,194,645,0,30.08,12.56
高雄市,內門區,合計,3939,1550,2389,64,4003,12595,13870,31.78,12.31
高雄市,茂林區,茂林里,225,179,46,1,226,712,0,31.74,25.14
高雄市,茂林區,萬山里,132,94,38,4,136,356,0,38.2,26.4
高雄市,茂林區,多納里,148,123,25,2,150,491,0,30.55,25.05
高雄市,茂林區,合計,505,396,109,7,512,1559,1879,32.84,25.4
高雄市,桃源區,桃源里,141,114,27,5,146,766,0,19.06,14.88
高雄市,桃源區,寶山里,101,78,23,4,105,458,0,22.93,17.03
高雄市,桃源區,建山里,100,70,30,0,100,587,0,17.04,11.93
高雄市,桃源區,高中里,133,102,31,0,133,620,0,21.45,16.45
高雄市,桃源區,勤和里,44,25,19,2,46,212,0,21.7,11.79
高雄市,桃源區,復興里,61,56,5,1,62,287,0,21.6,19.51
高雄市,桃源區,拉芙蘭里,70,37,33,2,72,230,0,31.3,16.09
高雄市,桃源區,梅山里,71,53,18,1,72,255,0,28.24,20.78
高雄市,桃源區,合計,721,535,186,15,736,3415,4205,21.55,15.67
高雄市,那瑪夏區,達卡努瓦里,334,266,68,5,339,1343,0,25.24,19.81
高雄市,那瑪夏區,瑪雅里,202,167,35,0,202,602,0,33.55,27.74
高雄市,那瑪夏區,南沙魯里,153,66,87,0,153,482,0,31.74,13.69
高雄市,那瑪夏區,合計,689,499,190,5,694,2427,3141,28.59,20.56
高雄市,合計,合計,986840,398161,588679,7700,994540,2353773,2755491,42.25,16.92
新竹縣,竹北市,斗崙里,3000,1813,1187,13,3013,6791,0,44.37,26.7
新竹縣,竹北市,鹿場里,4846,2896,1950,36,4882,10611,0,46.01,27.29
新竹縣,竹北市,東平里,5447,2973,2474,30,5477,11738,0,46.66,25.33
新竹縣,竹北市,中興里,3790,2239,1551,36,3826,8015,0,47.74,27.94
新竹縣,竹北市,隘口里,1317,795,522,3,1320,2974,0,44.38,26.73
新竹縣,竹北市,東海里,1100,740,360,11,1111,2997,0,37.07,24.69
新竹縣,竹北市,竹北里,2896,1791,1105,18,2914,7661,0,38.04,23.38
新竹縣,竹北市,竹仁里,3531,2243,1288,25,3556,8745,0,40.66,25.65
新竹縣,竹北市,竹義里,2079,1247,832,15,2094,5860,0,35.73,21.28
新竹縣,竹北市,泰和里,2238,1397,841,15,2253,5932,0,37.98,23.55
新竹縣,竹北市,新社里,2681,1649,1032,32,2713,7074,0,38.35,23.31
新竹縣,竹北市,聯興里,1773,1052,721,20,1793,4441,0,40.37,23.69
新竹縣,竹北市,麻園里,752,404,348,5,757,1986,0,38.12,20.34
新竹縣,竹北市,溪州里,1038,543,495,8,1046,2468,0,42.38,22.0
新竹縣,竹北市,白地里,802,417,385,11,813,2202,0,36.92,18.94
新竹縣,竹北市,新港里,497,192,305,6,503,1218,0,41.3,15.76
新竹縣,竹北市,大義里,638,268,370,6,644,1607,0,40.07,16.68
新竹縣,竹北市,崇義里,751,294,457,5,756,1914,0,39.5,15.36
新竹縣,竹北市,大眉里,695,385,310,6,701,1741,0,40.26,22.11
新竹縣,竹北市,尚義里,622,243,379,7,629,1683,0,37.37,14.44
新竹縣,竹北市,十興里,3055,1774,1281,16,3071,6632,0,46.31,26.75
新竹縣,竹北市,新國里,2311,1324,987,20,2331,6000,0,38.85,22.07
新竹縣,竹北市,新庄里,400,235,165,4,404,1064,0,37.97,22.09
新竹縣,竹北市,北崙里,1649,1047,602,16,1665,3833,0,43.44,27.32
新竹縣,竹北市,新崙里,2523,1474,1049,24,2547,6255,0,40.72,23.57
新竹縣,竹北市,福德里,1347,843,504,11,1358,3262,0,41.63,25.84
新竹縣,竹北市,東興里,2848,1555,1293,24,2872,7126,0,40.3,21.82
新竹縣,竹北市,北興里,2188,1229,959,12,2200,5571,0,39.49,22.06
新竹縣,竹北市,興安里,1477,951,526,8,1485,3538,0,41.97,26.88
新竹縣,竹北市,文化里,1497,944,553,16,1513,3337,0,45.34,28.29
新竹縣,竹北市,中崙里,2828,1747,1081,11,2839,6155,0,46.13,28.38
新竹縣,竹北市,合計,62616,36704,25912,470,63086,150431,203904,41.94,24.4
新竹縣,竹東鎮,上坪里,100,72,28,0,100,303,0,33.0,23.76
新竹縣,竹東鎮,瑞峰里,135,81,54,2,137,402,0,34.08,20.15
新竹縣,竹東鎮,軟橋里,133,90,43,1,134,369,0,36.31,24.39
新竹縣,竹東鎮,員崠里,836,618,218,3,839,2251,0,37.27,27.45
新竹縣,竹東鎮,東寧里,1252,904,348,11,1263,3227,0,39.14,28.01
新竹縣,竹東鎮,上舘里,3269,2343,926,33,3302,9255,0,35.68,25.32
新竹縣,竹東鎮,大鄉里,1599,1136,463,20,1619,4597,0,35.22,24.71
新竹縣,竹東鎮,東華里,310,209,101,1,311,643,0,48.37,32.5
新竹縣,竹東鎮,商華里,986,728,258,8,994,3051,0,32.58,23.86
新竹縣,竹東鎮,竹東里,578,352,226,10,588,1321,0,44.51,26.65
新竹縣,竹東鎮,榮樂里,596,410,186,2,598,1352,0,44.23,30.33
新竹縣,竹東鎮,鷄林里,1362,946,416,12,1374,3726,0,36.88,25.39
新竹縣,竹東鎮,仁愛里,1272,860,412,10,1282,3284,0,39.04,26.19
新竹縣,竹東鎮,五豐里,2419,1660,759,14,2433,7516,0,32.37,22.09
新竹縣,竹東鎮,三重里,2377,1589,788,15,2392,6371,0,37.55,24.94
新竹縣,竹東鎮,頭重里,1890,1238,652,21,1911,4492,0,42.54,27.56
新竹縣,竹東鎮,員山里,778,492,286,4,782,1905,0,41.05,25.83
新竹縣,竹東鎮,柯湖里,231,142,89,4,235,585,0,40.17,24.27
新竹縣,竹東鎮,二重里,4409,2822,1587,36,4445,11579,0,38.39,24.37
新竹縣,竹東鎮,中山里,644,479,165,7,651,1672,0,38.94,28.65
新竹縣,竹東鎮,中正里,833,534,299,14,847,2198,0,38.54,24.29
新竹縣,竹東鎮,南華里,434,291,143,2,436,1002,0,43.51,29.04
新竹縣,竹東鎮,榮華里,2718,1942,776,27,2745,6974,0,39.36,27.85
新竹縣,竹東鎮,忠孝里,558,387,171,8,566,1533,0,36.92,25.24
新竹縣,竹東鎮,陸豐里,245,166,79,3,248,579,0,42.83,28.67
新竹縣,竹東鎮,合計,29964,20491,9473,268,30232,80187,96850,37.7,25.55
新竹縣,新埔鎮,內立里,410,230,180,7,417,1106,0,37.7,20.8
新竹縣,新埔鎮,寶石里,366,228,138,7,373,857,0,43.52,26.6
新竹縣,新埔鎮,文山里,1817,1163,654,12,1829,4469,0,40.93,26.02
新竹縣,新埔鎮,五埔里,724,454,270,7,731,1976,0,36.99,22.98
新竹縣,新埔鎮,四座里,1386,772,614,7,1393,3266,0,42.65,23.64
新竹縣,新埔鎮,旱坑里,684,416,268,5,689,1753,0,39.3,23.73
新竹縣,新埔鎮,田新里,1259,820,439,8,1267,3147,0,40.26,26.06
新竹縣,新埔鎮,新埔里,402,251,151,5,407,964,0,42.22,26.04
新竹縣,新埔鎮,新生里,251,138,113,2,253,558,0,45.34,24.73
新竹縣,新埔鎮,新民里,453,321,132,4,457,1011,0,45.2,31.75
新竹縣,新埔鎮,上寮里,700,436,264,15,715,1823,0,39.22,23.92
新竹縣,新埔鎮,下寮里,1050,632,418,13,1063,2507,0,42.4,25.21
新竹縣,新埔鎮,南平里,430,246,184,6,436,977,0,44.63,25.18
新竹縣,新埔鎮,北平里,257,147,110,3,260,642,0,40.5,22.9
新竹縣,新埔鎮,巨埔里,490,241,249,7,497,1082,0,45.93,22.27
新竹縣,新埔鎮,照門里,476,269,207,10,486,1332,0,36.49,20.2
新竹縣,新埔鎮,清水里,189,99,90,1,190,403,0,47.15,24.57
新竹縣,新埔鎮,鹿鳴里,276,130,146,4,280,701,0,39.94,18.54
新竹縣,新埔鎮,新北里,241,134,107,3,244,570,0,42.81,23.51
新竹縣,新埔鎮,合計,11861,7127,4734,126,11987,29144,32991,41.13,24.45
新竹縣,關西鎮,東興里,222,165,57,2,224,472,0,47.46,34.96
新竹縣,關西鎮,西安里,768,556,212,3,771,1896,0,40.66,29.32
新竹縣,關西鎮,南雄里,291,199,92,3,294,677,0,43.43,29.39
新竹縣,關西鎮,北斗里,1446,961,485,18,1464,3579,0,40.91,26.85
新竹縣,關西鎮,仁安里,400,245,155,7,407,960,0,42.4,25.52
新竹縣,關西鎮,北山里,322,185,137,2,324,756,0,42.86,24.47
新竹縣,關西鎮,南山里,352,213,139,7,359,1025,0,35.02,20.78
新竹縣,關西鎮,東安里,1308,852,456,13,1321,3726,0,35.45,22.87
新竹縣,關西鎮,東光里,446,275,171,7,453,1248,0,36.3,22.04
新竹縣,關西鎮,新富里,170,93,77,3,173,529,0,32.7,17.58
新竹縣,關西鎮,金山里,208,137,71,1,209,549,0,38.07,24.95
新竹縣,關西鎮,錦山里,286,194,92,2,288,904,0,31.86,21.46
新竹縣,關西鎮,玉山里,129,68,61,3,132,431,0,30.63,15.78
新竹縣,關西鎮,大同里,345,163,182,5,350,787,0,44.47,20.71
新竹縣,關西鎮,石光里,654,407,247,8,662,1735,0,38.16,23.46
新竹縣,關西鎮,上林里,324,210,114,7,331,798,0,41.48,26.32
新竹縣,關西鎮,新力里,213,155,58,4,217,537,0,40.41,28.86
新竹縣,關西鎮,南和里,309,182,127,11,320,799,0,40.05,22.78
新竹縣,關西鎮,東山里,325,186,139,5,330,824,0,40.05,22.57
新竹縣,關西鎮,南新里,316,210,106,3,319,889,0,35.88,23.62
新竹縣,關西鎮,東平里,405,242,163,8,413,926,0,44.6,26.13
新竹縣,關西鎮,合計,9239,5898,3341,122,9361,24047,27521,38.93,24.53
新竹縣,湖口鄉,孝勢村,519,349,170,4,523,1181,0,44.28,29.55
新竹縣,湖口鄉,仁勢村,379,235,144,3,382,855,0,44.68,27.49
新竹縣,湖口鄉,愛勢村,1556,988,568,25,1581,3959,0,39.93,24.96
新竹縣,湖口鄉,信勢村,1943,1266,677,19,1962,5246,0,37.4,24.13
新竹縣,湖口鄉,中勢村,1245,799,446,13,1258,3221,0,39.06,24.81
新竹縣,湖口鄉,德盛村,1673,1059,614,12,1685,4921,0,34.24,21.52
新竹縣,湖口鄉,和興村,1024,604,420,4,1028,2816,0,36.51,21.45
新竹縣,湖口鄉,長嶺村,1115,722,393,12,1127,3163,0,35.63,22.83
新竹縣,湖口鄉,長安村,370,220,150,2,372,1045,0,35.6,21.05
新竹縣,湖口鄉,湖口村,1059,669,390,15,1074,2753,0,39.01,24.3
新竹縣,湖口鄉,湖鏡村,1003,746,257,14,1017,2452,0,41.48,30.42
新竹縣,湖口鄉,湖南村,610,414,196,2,612,1495,0,40.94,27.69
新竹縣,湖口鄉,波羅村,745,450,295,7,752,2217,0,33.92,20.3
新竹縣,湖口鄉,鳳凰村,1626,1058,568,14,1640,5086,0,32.25,20.8
新竹縣,湖口鄉,鳳山村,1172,857,315,10,1182,3248,0,36.39,26.39
新竹縣,湖口鄉,中興村,1887,1370,517,17,1904,6149,0,30.96,22.28
新竹縣,湖口鄉,信義村,1414,888,526,14,1428,3854,0,37.05,23.04
新竹縣,湖口鄉,中正村,1341,846,495,17,1358,3485,0,38.97,24.28
新竹縣,湖口鄉,東興村,1466,914,552,11,1477,4375,0,33.76,20.89
新竹縣,湖口鄉,勝利村,1361,948,413,17,1378,4199,0,32.82,22.58
新竹縣,湖口鄉,合計,23508,15402,8106,232,23740,65720,79420,36.12,23.44
新竹縣,新豐鄉,福興村,401,230,171,8,409,1086,0,37.66,21.18
新竹縣,新豐鄉,後湖村,626,347,279,10,636,1798,0,35.37,19.3
新竹縣,新豐鄉,青埔村,649,400,249,9,658,1867,0,35.24,21.42
新竹縣,新豐鄉,埔和村,1020,469,551,4,1024,2772,0,36.94,16.92
新竹縣,新豐鄉,瑞興村,573,344,229,6,579,1847,0,31.35,18.62
新竹縣,新豐鄉,坡頭村,307,123,184,6,313,833,0,37.58,14.77
新竹縣,新豐鄉,中崙村,1090,688,402,16,1106,3202,0,34.54,21.49
新竹縣,新豐鄉,重興村,1763,1129,634,15,1778,5247,0,33.89,21.52
新竹縣,新豐鄉,新豐村,728,328,400,5,733,2073,0,35.36,15.82
新竹縣,新豐鄉,員山村,986,661,325,6,992,2634,0,37.66,25.09
新竹縣,新豐鄉,松林村,1709,1124,585,14,1723,4372,0,39.41,25.71
新竹縣,新豐鄉,上坑村,574,373,201,9,583,1508,0,38.66,24.73
新竹縣,新豐鄉,鳳坑村,398,244,154,5,403,1044,0,38.6,23.37
新竹縣,新豐鄉,忠孝村,1342,871,471,13,1355,3558,0,38.08,24.48
新竹縣,新豐鄉,山崎村,1707,1106,601,16,1723,4427,0,38.92,24.98
新竹縣,新豐鄉,松柏村,2023,1291,732,15,2038,5803,0,35.12,22.25
新竹縣,新豐鄉,崎頂村,992,634,358,17,1009,2708,0,37.26,23.41
新竹縣,新豐鄉,合計,16888,10362,6526,174,17062,46779,57654,36.47,22.15
新竹縣,芎林鄉,五龍村,199,147,52,1,200,491,0,40.73,29.94
新竹縣,芎林鄉,華龍村,167,118,49,2,169,384,0,44.01,30.73
新竹縣,芎林鄉,秀湖村,366,280,86,2,368,934,0,39.4,29.98
新竹縣,芎林鄉,永興村,156,118,38,3,159,409,0,38.88,28.85
新竹縣,芎林鄉,石潭村,1016,678,338,9,1025,2655,0,38.61,25.54
新竹縣,芎林鄉,新鳳村,588,377,211,9,597,1577,0,37.86,23.91
新竹縣,芎林鄉,中坑村,239,168,71,4,243,626,0,38.82,26.84
新竹縣,芎林鄉,水坑村,308,197,111,6,314,779,0,40.31,25.29
新竹縣,芎林鄉,文林村,927,647,280,9,936,2349,0,39.85,27.54
新竹縣,芎林鄉,芎林村,657,414,243,8,665,1559,0,42.66,26.56
新竹縣,芎林鄉,上山村,1995,1272,723,11,2006,4643,0,43.2,27.4
新竹縣,芎林鄉,下山村,484,308,176,3,487,1098,0,44.35,28.05
新竹縣,芎林鄉,合計,7102,4724,2378,67,7169,17504,19888,40.96,26.99
新竹縣,橫山鄉,橫山村,1219,855,364,19,1238,3300,0,37.52,25.91
新竹縣,橫山鄉,田寮村,341,217,124,6,347,847,0,40.97,25.62
新竹縣,橫山鄉,南昌村,78,56,22,2,80,180,0,44.44,31.11
新竹縣,橫山鄉,豐鄉村,75,42,33,2,77,203,0,37.93,20.69
新竹縣,橫山鄉,豐田村,119,78,41,3,122,320,0,38.13,24.38
新竹縣,橫山鄉,內灣村,343,247,96,7,350,882,0,39.68,28.0
新竹縣,橫山鄉,福興村,164,106,58,2,166,419,0,39.62,25.3
新竹縣,橫山鄉,沙坑村,410,265,145,8,418,938,0,44.56,28.25
新竹縣,橫山鄉,新興村,624,464,160,10,634,1488,0,42.61,31.18
新竹縣,橫山鄉,大肚村,605,469,136,7,612,1628,0,37.59,28.81
新竹縣,橫山鄉,力行村,340,250,90,2,342,802,0,42.64,31.17
新竹縣,橫山鄉,合計,4318,3049,1269,68,4386,11007,12408,39.85,27.7
新竹縣,北埔鄉,北埔村,412,275,137,3,415,1117,0,37.15,24.62
新竹縣,北埔鄉,南興村,416,292,124,6,422,1142,0,36.95,25.57
新竹縣,北埔鄉,埔尾村,934,636,298,9,943,2547,0,37.02,24.97
新竹縣,北埔鄉,水磜村,279,172,107,3,282,818,0,34.47,21.03
新竹縣,北埔鄉,南埔村,179,131,48,2,181,363,0,49.86,36.09
新竹縣,北埔鄉,大林村,270,203,67,2,272,720,0,37.78,28.19
新竹縣,北埔鄉,大湖村,185,133,52,2,187,541,0,34.57,24.58
新竹縣,北埔鄉,南坑村,142,93,49,2,144,325,0,44.31,28.62
新竹縣,北埔鄉,外坪村,121,71,50,1,122,297,0,41.08,23.91
新竹縣,北埔鄉,合計,2938,2006,932,30,2968,7870,8864,37.71,25.49
新竹縣,寶山鄉,雙溪村,1011,636,375,11,1022,2659,0,38.44,23.92
新竹縣,寶山鄉,大崎村,873,562,311,6,879,2006,0,43.82,28.02
新竹縣,寶山鄉,三峰村,397,266,131,7,404,1015,0,39.8,26.21
新竹縣,寶山鄉,新城村,427,262,165,3,430,1168,0,36.82,22.43
新竹縣,寶山鄉,深井村,324,208,116,3,327,794,0,41.18,26.2
新竹縣,寶山鄉,寶斗村,231,152,79,2,233,731,0,31.87,20.79
新竹縣,寶山鄉,山湖村,248,164,84,1,249,541,0,46.03,30.31
新竹縣,寶山鄉,寶山村,344,228,116,3,347,847,0,40.97,26.92
新竹縣,寶山鄉,油田村,250,168,82,2,252,578,0,43.6,29.07
新竹縣,寶山鄉,雙新村,1036,662,374,5,1041,2676,0,38.9,24.74
新竹縣,寶山鄉,合計,5141,3308,1833,43,5184,13015,14570,39.83,25.42
新竹縣,峨眉鄉,峨眉村,369,260,109,6,375,815,0,46.01,31.9
新竹縣,峨眉鄉,中盛村,271,157,114,2,273,665,0,41.05,23.61
新竹縣,峨眉鄉,石井村,242,162,80,0,242,563,0,42.98,28.77
新竹縣,峨眉鄉,富興村,493,332,161,3,496,1340,0,37.01,24.78
新竹縣,峨眉鄉,七星村,247,154,93,2,249,605,0,41.16,25.45
新竹縣,峨眉鄉,湖光村,328,188,140,5,333,850,0,39.18,22.12
新竹縣,峨眉鄉,合計,1950,1253,697,18,1968,4838,5323,40.68,25.9
新竹縣,尖石鄉,義興村,167,121,46,2,169,587,0,28.79,20.61
新竹縣,尖石鄉,嘉樂村,268,206,62,3,271,818,0,33.13,25.18
新竹縣,尖石鄉,新樂村,313,262,51,5,318,1210,0,26.28,21.65
新竹縣,尖石鄉,梅花村,201,166,35,3,204,626,0,32.59,26.52
新竹縣,尖石鄉,錦屏村,257,212,45,1,258,1161,0,22.22,18.26
新竹縣,尖石鄉,玉峰村,241,161,80,3,244,1329,0,18.36,12.11
新竹縣,尖石鄉,秀巒村,261,192,69,4,265,1629,0,16.27,11.79
新竹縣,尖石鄉,合計,1708,1320,388,21,1729,7360,9561,23.49,17.93
新竹縣,五峰鄉,大隘村,345,297,48,5,350,1281,0,27.32,23.19
新竹縣,五峰鄉,花園村,204,156,48,2,206,711,0,28.97,21.94
新竹縣,五峰鄉,竹林村,100,77,23,0,100,377,0,26.53,20.42
新竹縣,五峰鄉,桃山村,356,254,102,6,362,1367,0,26.48,18.58
新竹縣,五峰鄉,合計,1005,784,221,13,1018,3736,4431,27.25,20.99
新竹縣,合計,合計,178238,112428,65810,1652,179890,461638,573385,38.97,24.35
苗栗縣,苗栗市,中苗里,479,344,135,0,479,1116,0,42.92,30.82
苗栗縣,苗栗市,建功里,1700,1222,478,6,1706,4048,0,42.14,30.19
苗栗縣,苗栗市,青苗里,360,240,120,5,365,1005,0,36.32,23.88
苗栗縣,苗栗市,玉清里,1032,762,270,7,1039,2166,0,47.97,35.18
苗栗縣,苗栗市,玉華里,1537,1123,414,9,1546,3579,0,43.2,31.38
苗栗縣,苗栗市,維新里,1497,1088,409,14,1511,3590,0,42.09,30.31
苗栗縣,苗栗市,維祥里,1230,896,334,6,1236,3260,0,37.91,27.48
苗栗縣,苗栗市,綠苗里,321,226,95,2,323,805,0,40.12,28.07
苗栗縣,苗栗市,高苗里,1210,826,384,2,1212,3216,0,37.69,25.68
苗栗縣,苗栗市,玉苗里,362,221,141,6,368,856,0,42.99,25.82
苗栗縣,苗栗市,大同里,229,151,78,5,234,497,0,47.08,30.38
苗栗縣,苗栗市,新苗里,355,216,139,2,357,841,0,42.45,25.68
苗栗縣,苗栗市,勝利里,1646,1142,504,12,1658,3843,0,43.14,29.72
苗栗縣,苗栗市,恭敬里,504,342,162,4,508,1333,0,38.11,25.66
苗栗縣,苗栗市,上苗里,669,431,238,10,679,1503,0,45.18,28.68
苗栗縣,苗栗市,北苗里,2074,1434,640,16,2090,5025,0,41.59,28.54
苗栗縣,苗栗市,清華里,1390,960,430,8,1398,3087,0,45.29,31.1
苗栗縣,苗栗市,嘉盛里,1384,980,404,9,1393,3365,0,41.4,29.12
苗栗縣,苗栗市,福星里,1578,1068,510,9,1587,4152,0,38.22,25.72
苗栗縣,苗栗市,新川里,441,294,147,3,444,1166,0,38.08,25.21
苗栗縣,苗栗市,文山里,1606,1133,473,7,1613,4041,0,39.92,28.04
苗栗縣,苗栗市,福麗里,2053,1446,607,12,2065,5344,0,38.64,27.06
苗栗縣,苗栗市,水源里,940,650,290,8,948,2448,0,38.73,26.55
苗栗縣,苗栗市,新英里,572,394,178,4,576,1664,0,34.62,23.68
苗栗縣,苗栗市,福安里,1259,886,373,8,1267,3443,0,36.8,25.73
苗栗縣,苗栗市,嘉新里,1239,892,347,15,1254,2769,0,45.29,32.21
苗栗縣,苗栗市,南勢里,646,450,196,4,650,1926,0,33.75,23.36
苗栗縣,苗栗市,文聖里,1265,871,394,10,1275,3556,0,35.85,24.49
苗栗縣,苗栗市,合計,29578,20688,8890,203,29781,73644,87384,40.44,28.09
苗栗縣,苑裡鎮,苑東里,820,396,424,7,827,2145,0,38.55,18.46
苗栗縣,苑裡鎮,苑南里,603,273,330,2,605,1435,0,42.16,19.02
苗栗縣,苑裡鎮,苑北里,362,153,209,4,366,878,0,41.69,17.43
苗栗縣,苑裡鎮,西平里,574,229,345,4,578,1612,0,35.86,14.21
苗栗縣,苑裡鎮,苑港里,419,126,293,4,423,1191,0,35.52,10.58
苗栗縣,苑裡鎮,西勢里,710,299,411,5,715,1961,0,36.46,15.25
苗栗縣,苑裡鎮,海岸里,340,134,206,6,346,1037,0,33.37,12.92
苗栗縣,苑裡鎮,房裡里,771,346,425,6,777,2186,0,35.54,15.83
苗栗縣,苑裡鎮,客庄里,1518,698,820,11,1529,3952,0,38.69,17.66
苗栗縣,苑裡鎮,中正里,712,306,406,5,717,2128,0,33.69,14.38
苗栗縣,苑裡鎮,苑坑里,284,100,184,1,285,912,0,31.25,10.96
苗栗縣,苑裡鎮,水坡里,224,83,141,0,224,628,0,35.67,13.22
苗栗縣,苑裡鎮,新復里,534,251,283,7,541,1353,0,39.99,18.55
苗栗縣,苑裡鎮,山脚里,484,227,257,2,486,1350,0,36.0,16.81
苗栗縣,苑裡鎮,舊社里,624,295,329,9,633,1788,0,35.4,16.5
苗栗縣,苑裡鎮,福田里,426,194,232,4,430,1235,0,34.82,15.71
苗栗縣,苑裡鎮,石鎮里,186,97,89,1,187,546,0,34.25,17.77
苗栗縣,苑裡鎮,蕉埔里,276,149,127,1,277,770,0,35.97,19.35
苗栗縣,苑裡鎮,社苓里,775,335,440,5,780,2413,0,32.32,13.88
苗栗縣,苑裡鎮,泰田里,567,207,360,7,574,1649,0,34.81,12.55
苗栗縣,苑裡鎮,上舘里,559,275,284,11,570,1604,0,35.54,17.14
苗栗縣,苑裡鎮,玉田里,555,244,311,7,562,1758,0,31.97,13.88
苗栗縣,苑裡鎮,南勢里,222,82,140,3,225,680,0,33.09,12.06
苗栗縣,苑裡鎮,山柑里,440,213,227,3,443,1419,0,31.22,15.01
苗栗縣,苑裡鎮,田心里,661,322,339,4,665,1872,0,35.52,17.2
苗栗縣,苑裡鎮,合計,13646,6034,7612,119,13765,38502,44437,35.75,15.67
苗栗縣,通霄鎮,通東里,407,188,219,4,411,1064,0,38.63,17.67
苗栗縣,通霄鎮,通西里,790,371,419,8,798,1916,0,41.65,19.36
苗栗縣,通霄鎮,平元里,722,330,392,6,728,1805,0,40.33,18.28
苗栗縣,通霄鎮,梅南里,515,212,303,8,523,1531,0,34.16,13.85
苗栗縣,通霄鎮,圳頭里,247,108,139,3,250,676,0,36.98,15.98
苗栗縣,通霄鎮,通南里,874,419,455,7,881,2637,0,33.41,15.89
苗栗縣,通霄鎮,城北里,222,108,114,5,227,658,0,34.5,16.41
苗栗縣,通霄鎮,城南里,312,137,175,10,322,903,0,35.66,15.17
苗栗縣,通霄鎮,南和里,292,123,169,2,294,769,0,38.23,15.99
苗栗縣,通霄鎮,福興里,225,119,106,4,229,622,0,36.82,19.13
苗栗縣,通霄鎮,坪頂里,394,213,181,6,400,1189,0,33.64,17.91
苗栗縣,通霄鎮,五南里,441,218,223,5,446,1325,0,33.66,16.45
苗栗縣,通霄鎮,五北里,458,194,264,4,462,1379,0,33.5,14.07
苗栗縣,通霄鎮,內湖里,528,261,267,4,532,1822,0,29.2,14.32
苗栗縣,通霄鎮,楓樹里,145,79,66,0,145,415,0,34.94,19.04
苗栗縣,通霄鎮,烏眉里,293,190,103,3,296,856,0,34.58,22.2
苗栗縣,通霄鎮,福龍里,124,86,38,0,124,385,0,32.21,22.34
苗栗縣,通霄鎮,福源里,225,117,108,5,230,770,0,29.87,15.19
苗栗縣,通霄鎮,通灣里,627,310,317,6,633,2187,0,28.94,14.17
苗栗縣,通霄鎮,新埔里,337,119,218,3,340,1078,0,31.54,11.04
苗栗縣,通霄鎮,內島里,222,94,128,1,223,709,0,31.45,13.26
苗栗縣,通霄鎮,白東里,427,226,201,3,430,1405,0,30.6,16.09
苗栗縣,通霄鎮,白西里,229,112,117,2,231,709,0,32.58,15.8
苗栗縣,通霄鎮,平安里,674,307,367,11,685,2009,0,34.1,15.28
苗栗縣,通霄鎮,合計,9730,4641,5089,110,9840,28819,32701,34.14,16.1
苗栗縣,竹南鎮,竹南里,811,482,329,4,815,1893,0,43.05,25.46
苗栗縣,竹南鎮,照南里,1436,780,656,18,1454,3293,0,44.15,23.69
苗栗縣,竹南鎮,正南里,968,503,465,5,973,2715,0,35.84,18.53
苗栗縣,竹南鎮,新南里,2005,1166,839,16,2021,4759,0,42.47,24.5
苗栗縣,竹南鎮,大厝里,2099,1317,782,24,2123,5205,0,40.79,25.3
苗栗縣,竹南鎮,營盤里,1328,695,633,12,1340,3484,0,38.46,19.95
苗栗縣,竹南鎮,聖福里,1363,808,555,12,1375,3366,0,40.85,24.0
苗栗縣,竹南鎮,竹興里,1049,584,465,7,1056,3259,0,32.4,17.92
苗栗縣,竹南鎮,龍鳳里,753,423,330,3,756,2041,0,37.04,20.73
苗栗縣,竹南鎮,山佳里,1657,1019,638,16,1673,4916,0,34.03,20.73
苗栗縣,竹南鎮,中港里,404,233,171,4,408,1080,0,37.78,21.57
苗栗縣,竹南鎮,中華里,1161,653,508,5,1166,2759,0,42.26,23.67
苗栗縣,竹南鎮,中英里,538,314,224,1,539,1520,0,35.46,20.66
苗栗縣,竹南鎮,中美里,720,423,297,5,725,1941,0,37.35,21.79
苗栗縣,竹南鎮,開元里,437,241,196,4,441,1207,0,36.54,19.97
苗栗縣,竹南鎮,海口里,1356,772,584,5,1361,4107,0,33.14,18.8
苗栗縣,竹南鎮,港墘里,826,438,388,8,834,2198,0,37.94,19.93
苗栗縣,竹南鎮,公舘里,375,245,130,6,381,1138,0,33.48,21.53
苗栗縣,竹南鎮,大埔里,1554,870,684,16,1570,4771,0,32.91,18.24
苗栗縣,竹南鎮,頂埔里,794,403,391,16,810,2066,0,39.21,19.51
苗栗縣,竹南鎮,崎頂里,1401,797,604,16,1417,3817,0,37.12,20.88
苗栗縣,竹南鎮,公義里,364,193,171,5,369,1009,0,36.57,19.13
苗栗縣,竹南鎮,佳興里,1191,634,557,20,1211,3241,0,37.37,19.56
苗栗縣,竹南鎮,天文里,841,532,309,4,845,2154,0,39.23,24.7
苗栗縣,竹南鎮,龍山里,908,477,431,10,918,2327,0,39.45,20.5
苗栗縣,竹南鎮,合計,26339,15002,11337,242,26581,70266,87307,37.83,21.35
苗栗縣,頭份市,流東里,710,480,230,7,717,2182,0,32.86,22.0
苗栗縣,頭份市,珊湖里,621,424,197,3,624,1710,0,36.49,24.8
苗栗縣,頭份市,斗煥里,1084,778,306,9,1093,2890,0,37.82,26.92
苗栗縣,頭份市,新華里,1419,1041,378,8,1427,3743,0,38.12,27.81
苗栗縣,頭份市,興隆里,1629,1112,517,14,1643,4464,0,36.81,24.91
苗栗縣,頭份市,上埔里,918,667,251,10,928,2565,0,36.18,26.0
苗栗縣,頭份市,土牛里,370,230,140,3,373,1018,0,36.64,22.59
苗栗縣,頭份市,頭份里,1179,811,368,12,1191,3264,0,36.49,24.85
苗栗縣,頭份市,忠孝里,1289,928,361,12,1301,3066,0,42.43,30.27
苗栗縣,頭份市,仁愛里,577,375,202,3,580,1574,0,36.85,23.82
苗栗縣,頭份市,信義里,335,224,111,6,341,977,0,34.9,22.93
苗栗縣,頭份市,和平里,488,305,183,5,493,1036,0,47.59,29.44
苗栗縣,頭份市,民族里,791,575,216,9,800,2007,0,39.86,28.65
苗栗縣,頭份市,東庄里,1542,1044,498,6,1548,4392,0,35.25,23.77
苗栗縣,頭份市,後庄里,1722,1092,630,10,1732,4339,0,39.92,25.17
苗栗縣,頭份市,山下里,1539,1032,507,13,1552,4022,0,38.59,25.66
苗栗縣,頭份市,蟠桃里,1179,796,383,8,1187,3306,0,35.9,24.08
苗栗縣,頭份市,田寮里,1413,942,471,5,1418,3987,0,35.57,23.63
苗栗縣,頭份市,蘆竹里,503,287,216,4,507,1289,0,39.33,22.27
苗栗縣,頭份市,上興里,646,421,225,8,654,2144,0,30.5,19.64
苗栗縣,頭份市,下興里,886,596,290,9,895,2511,0,35.64,23.74
苗栗縣,頭份市,尖山里,521,363,158,6,527,1295,0,40.69,28.03
苗栗縣,頭份市,尖下里,918,646,272,4,922,2511,0,36.72,25.73
苗栗縣,頭份市,廣興里,367,258,109,5,372,878,0,42.37,29.38
苗栗縣,頭份市,濫坑里,825,591,234,12,837,2216,0,37.77,26.67
苗栗縣,頭份市,民權里,863,529,334,4,867,2277,0,38.08,23.23
苗栗縣,頭份市,民生里,824,552,272,9,833,2362,0,35.27,23.37
苗栗縣,頭份市,建國里,1382,931,451,9,1391,3387,0,41.07,27.49
苗栗縣,頭份市,成功里,1317,956,361,13,1330,3570,0,37.25,26.78
苗栗縣,頭份市,自強里,782,516,266,2,784,1951,0,40.18,26.45
苗栗縣,頭份市,合興里,921,625,296,5,926,2514,0,36.83,24.86
苗栗縣,頭份市,文化里,1343,839,504,11,1354,3515,0,38.52,23.87
苗栗縣,頭份市,中興里,1013,684,329,3,1016,2774,0,36.63,24.66
苗栗縣,頭份市,合計,31916,21650,10266,247,32163,85736,104902,37.51,25.25
苗栗縣,後龍鎮,南龍里,461,248,213,5,466,1399,0,33.31,17.73
苗栗縣,後龍鎮,中龍里,314,163,151,4,318,731,0,43.5,22.3
苗栗縣,後龍鎮,北龍里,499,242,257,5,504,1248,0,40.38,19.39
苗栗縣,後龍鎮,大庄里,1474,828,646,8,1482,4216,0,35.15,19.64
苗栗縣,後龍鎮,溪洲里,690,399,291,11,701,2258,0,31.05,17.67
苗栗縣,後龍鎮,豐富里,510,351,159,6,516,1219,0,42.33,28.79
苗栗縣,後龍鎮,校椅里,394,261,133,4,398,1026,0,38.79,25.44
苗栗縣,後龍鎮,埔頂里,844,470,374,17,861,2669,0,32.26,17.61
苗栗縣,後龍鎮,新民里,493,289,204,3,496,1304,0,38.04,22.16
苗栗縣,後龍鎮,復興里,239,119,120,4,243,679,0,35.79,17.53
苗栗縣,後龍鎮,東明里,445,220,225,4,449,1462,0,30.71,15.05
苗栗縣,後龍鎮,大山里,495,240,255,5,500,1503,0,33.27,15.97
苗栗縣,後龍鎮,灣寶里,375,169,206,13,388,1231,0,31.52,13.73
苗栗縣,後龍鎮,海寶里,308,145,163,3,311,957,0,32.5,15.15
苗栗縣,後龍鎮,外埔里,301,183,118,4,305,982,0,31.06,18.64
苗栗縣,後龍鎮,海埔里,268,128,140,6,274,897,0,30.55,14.27
苗栗縣,後龍鎮,秀水里,240,119,121,3,243,682,0,35.63,17.45
苗栗縣,後龍鎮,水尾里,338,166,172,5,343,1023,0,33.53,16.23
苗栗縣,後龍鎮,龍津里,207,106,101,6,213,591,0,36.04,17.94
苗栗縣,後龍鎮,龍坑里,411,181,230,2,413,1251,0,33.01,14.47
苗栗縣,後龍鎮,福寧里,214,111,103,2,216,718,0,30.08,15.46
苗栗縣,後龍鎮,中和里,301,163,138,9,310,1010,0,30.69,16.14
苗栗縣,後龍鎮,南港里,358,173,185,3,361,1188,0,30.39,14.56
苗栗縣,後龍鎮,合計,10179,5474,4705,132,10311,30244,34941,34.09,18.1
苗栗縣,卓蘭鎮,中街里,317,165,152,1,318,698,0,45.56,23.64
苗栗縣,卓蘭鎮,新厝里,598,323,275,8,606,1479,0,40.97,21.84
苗栗縣,卓蘭鎮,上新里,757,357,400,4,761,1991,0,38.22,17.93
苗栗縣,卓蘭鎮,豐田里,351,166,185,6,357,937,0,38.1,17.72
苗栗縣,卓蘭鎮,西坪里,238,134,104,1,239,674,0,35.46,19.88
苗栗縣,卓蘭鎮,景山里,271,162,109,4,275,923,0,29.79,17.55
苗栗縣,卓蘭鎮,老庄里,745,374,371,5,750,1876,0,39.98,19.94
苗栗縣,卓蘭鎮,新榮里,422,195,227,7,429,1056,0,40.63,18.47
苗栗縣,卓蘭鎮,內灣里,744,365,379,0,744,2071,0,35.92,17.62
苗栗縣,卓蘭鎮,苗豐里,266,127,139,4,270,702,0,38.46,18.09
苗栗縣,卓蘭鎮,坪林里,346,194,152,3,349,1067,0,32.71,18.18
苗栗縣,卓蘭鎮,西坪里、坪林里,254,160,94,3,257,715,0,35.94,22.38
苗栗縣,卓蘭鎮,合計,5309,2722,2587,46,5355,14189,16007,37.74,19.18
苗栗縣,大湖鄉,大湖村,635,464,171,3,638,1539,0,41.46,30.15
苗栗縣,大湖鄉,明湖村,255,203,52,2,257,557,0,46.14,36.45
苗栗縣,大湖鄉,靜湖村,594,456,138,9,603,1714,0,35.18,26.6
苗栗縣,大湖鄉,富興村,389,243,146,7,396,1323,0,29.93,18.37
苗栗縣,大湖鄉,大南村,171,131,40,4,175,529,0,33.08,24.76
苗栗縣,大湖鄉,大寮村,424,299,125,3,427,1155,0,36.97,25.89
苗栗縣,大湖鄉,南湖村,219,143,76,3,222,599,0,37.06,23.87
苗栗縣,大湖鄉,義和村,430,277,153,6,436,1448,0,30.11,19.13
苗栗縣,大湖鄉,東興村,233,161,72,4,237,739,0,32.07,21.79
苗栗縣,大湖鄉,武榮村,183,135,48,1,184,484,0,38.02,27.89
苗栗縣,大湖鄉,栗林村,280,187,93,2,282,988,0,28.54,18.93
苗栗縣,大湖鄉,新開村,300,174,126,3,303,993,0,30.51,17.52
苗栗縣,大湖鄉,合計,4113,2873,1240,47,4160,12068,13686,34.47,23.81
苗栗縣,公館鄉,館中村,646,399,247,2,648,1507,0,43.0,26.48
苗栗縣,公館鄉,館東村,934,662,272,5,939,2286,0,41.08,28.96
苗栗縣,公館鄉,館南村,1259,862,397,15,1274,3412,0,37.34,25.26
苗栗縣,公館鄉,大坑村,348,211,137,6,354,921,0,38.44,22.91
苗栗縣,公館鄉,中義村,762,500,262,13,775,2259,0,34.31,22.13
苗栗縣,公館鄉,玉泉村,924,605,319,3,927,2296,0,40.37,26.35
苗栗縣,公館鄉,石墻村,523,373,150,1,524,1448,0,36.19,25.76
苗栗縣,公館鄉,福基村,394,286,108,3,397,995,0,39.9,28.74
苗栗縣,公館鄉,福星村,781,527,254,16,797,2019,0,39.47,26.1
苗栗縣,公館鄉,開礦村,105,78,27,1,106,280,0,37.86,27.86
苗栗縣,公館鄉,福德村,161,88,73,1,162,339,0,47.79,25.96
苗栗縣,公館鄉,五谷村,863,548,315,11,874,2213,0,39.49,24.76
苗栗縣,公館鄉,玉谷村,531,363,168,9,540,1453,0,37.16,24.98
苗栗縣,公館鄉,鶴岡村,647,453,194,3,650,1579,0,41.17,28.69
苗栗縣,公館鄉,鶴山村,534,344,190,6,540,1427,0,37.84,24.11
苗栗縣,公館鄉,仁安村,481,325,156,1,482,1270,0,37.95,25.59
苗栗縣,公館鄉,尖山村,539,336,203,3,542,1415,0,38.3,23.75
苗栗縣,公館鄉,南河村,87,72,15,2,89,213,0,41.78,33.8
苗栗縣,公館鄉,北河村,103,67,36,1,104,329,0,31.61,20.36
苗栗縣,公館鄉,合計,10622,7099,3523,102,10724,27661,32119,38.77,25.66
苗栗縣,銅鑼鄉,福興村,407,364,43,5,412,940,0,43.83,38.72
苗栗縣,銅鑼鄉,銅鑼村,1726,1198,528,12,1738,4334,0,40.1,27.64
苗栗縣,銅鑼鄉,朝陽村,681,487,194,5,686,1617,0,42.42,30.12
苗栗縣,銅鑼鄉,樟樹村,406,276,130,7,413,1247,0,33.12,22.13
苗栗縣,銅鑼鄉,九湖村,416,296,120,6,422,1142,0,36.95,25.92
苗栗縣,銅鑼鄉,竹森村,330,241,89,1,331,1021,0,32.42,23.6
苗栗縣,銅鑼鄉,中平村,1104,722,382,11,1115,3115,0,35.79,23.18
苗栗縣,銅鑼鄉,興隆村,188,120,68,3,191,540,0,35.37,22.22
苗栗縣,銅鑼鄉,盛隆村,143,96,47,2,145,411,0,35.28,23.36
苗栗縣,銅鑼鄉,新隆村,228,154,74,2,230,525,0,43.81,29.33
苗栗縣,銅鑼鄉,合計,5629,3954,1675,54,5683,14892,17039,38.16,26.55
苗栗縣,南庄鄉,東村,417,307,110,4,421,1102,0,38.2,27.86
苗栗縣,南庄鄉,西村,222,156,66,3,225,609,0,36.95,25.62
苗栗縣,南庄鄉,南江村,369,281,88,5,374,1283,0,29.15,21.9
苗栗縣,南庄鄉,田美村,274,183,91,3,277,793,0,34.93,23.08
苗栗縣,南庄鄉,獅山村,264,181,83,4,268,793,0,33.8,22.82
苗栗縣,南庄鄉,南富村,468,337,131,4,472,1037,0,45.52,32.5
苗栗縣,南庄鄉,員林村,383,267,116,2,385,986,0,39.05,27.08
苗栗縣,南庄鄉,蓬萊村,230,190,40,4,234,838,0,27.92,22.67
苗栗縣,南庄鄉,東河村,227,189,38,5,232,912,0,25.44,20.72
苗栗縣,南庄鄉,合計,2854,2091,763,34,2888,8353,9430,34.57,25.03
苗栗縣,頭屋鄉,頭屋村,982,707,275,6,988,2420,0,40.83,29.21
苗栗縣,頭屋鄉,象山村,684,447,237,9,693,1786,0,38.8,25.03
苗栗縣,頭屋鄉,北坑村,243,183,60,3,246,687,0,35.81,26.64
苗栗縣,頭屋鄉,獅潭村,652,469,183,8,660,1635,0,40.37,28.69
苗栗縣,頭屋鄉,曲洞村,397,272,125,2,399,848,0,47.05,32.08
苗栗縣,頭屋鄉,飛鳳村,162,115,47,3,165,377,0,43.77,30.5
苗栗縣,頭屋鄉,明德村,427,298,129,3,430,968,0,44.42,30.79
苗栗縣,頭屋鄉,鳴鳳村,125,79,46,3,128,302,0,42.38,26.16
苗栗縣,頭屋鄉,合計,3672,2570,1102,37,3709,9023,10112,41.11,28.48
苗栗縣,三義鄉,廣盛村,1588,1108,480,18,1606,3909,0,41.08,28.34
苗栗縣,三義鄉,双湖村,688,471,217,7,695,1787,0,38.89,26.36
苗栗縣,三義鄉,双潭村,485,329,156,5,490,1321,0,37.09,24.91
苗栗縣,三義鄉,勝興村,1321,857,464,21,1342,3286,0,40.84,26.08
苗栗縣,三義鄉,西湖村,570,434,136,7,577,1427,0,40.43,30.41
苗栗縣,三義鄉,龍騰村,170,131,39,0,170,402,0,42.29,32.59
苗栗縣,三義鄉,鯉魚潭村,465,232,233,7,472,1241,0,38.03,18.69
苗栗縣,三義鄉,合計,5287,3562,1725,65,5352,13373,15480,40.02,26.64
苗栗縣,西湖鄉,高埔村,229,187,42,5,234,595,0,39.33,31.43
苗栗縣,西湖鄉,下埔村,197,156,41,1,198,564,0,35.11,27.66
苗栗縣,西湖鄉,五湖村,279,208,71,4,283,790,0,35.82,26.33
苗栗縣,西湖鄉,四湖村,205,158,47,2,207,627,0,33.01,25.2
苗栗縣,西湖鄉,金獅村,182,137,45,0,182,482,0,37.76,28.42
苗栗縣,西湖鄉,龍洞村,148,97,51,4,152,446,0,34.08,21.75
苗栗縣,西湖鄉,三湖村,315,218,97,3,318,871,0,36.51,25.03
苗栗縣,西湖鄉,湖東村,338,239,99,5,343,1112,0,30.85,21.49
苗栗縣,西湖鄉,二湖村,214,148,66,3,217,646,0,33.59,22.91
苗栗縣,西湖鄉,合計,2107,1548,559,27,2134,6133,6635,34.8,25.24
苗栗縣,造橋鄉,造橋村,757,535,222,5,762,2010,0,37.91,26.62
苗栗縣,造橋鄉,平興村,174,128,46,2,176,442,0,39.82,28.96
苗栗縣,造橋鄉,豐湖村,377,258,119,4,381,969,0,39.32,26.63
苗栗縣,造橋鄉,大西村,1200,796,404,12,1212,3315,0,36.56,24.01
苗栗縣,造橋鄉,錦水村,183,125,58,2,185,479,0,38.62,26.1
苗栗縣,造橋鄉,大龍村,191,129,62,1,192,485,0,39.59,26.6
苗栗縣,造橋鄉,朝陽村,436,241,195,4,440,1252,0,35.14,19.25
苗栗縣,造橋鄉,談文村,290,188,102,3,293,837,0,35.01,22.46
苗栗縣,造橋鄉,龍昇村,299,157,142,4,303,943,0,32.13,16.65
苗栗縣,造橋鄉,合計,3907,2557,1350,37,3944,10732,12084,36.75,23.83
苗栗縣,三灣鄉,三灣村,769,537,232,6,775,2118,0,36.59,25.35
苗栗縣,三灣鄉,內灣村,268,190,78,5,273,613,0,44.54,31.0
苗栗縣,三灣鄉,銅鏡村,318,228,90,7,325,822,0,39.54,27.74
苗栗縣,三灣鄉,頂寮村,72,47,25,2,74,227,0,32.6,20.7
苗栗縣,三灣鄉,北埔村,162,99,63,4,166,517,0,32.11,19.15
苗栗縣,三灣鄉,大河村,201,140,61,3,204,523,0,39.01,26.77
苗栗縣,三灣鄉,大坪村,181,117,64,3,184,391,0,47.06,29.92
苗栗縣,三灣鄉,永和村,160,125,35,4,164,368,0,44.57,33.97
苗栗縣,三灣鄉,合計,2131,1483,648,34,2165,5579,6259,38.81,26.58
苗栗縣,獅潭鄉,百壽村,94,80,14,1,95,322,0,29.5,24.84
苗栗縣,獅潭鄉,永興村,202,142,60,6,208,531,0,39.17,26.74
苗栗縣,獅潭鄉,新店村,318,222,96,6,324,869,0,37.28,25.55
苗栗縣,獅潭鄉,和興村,199,135,64,1,200,539,0,37.11,25.05
苗栗縣,獅潭鄉,豐林村,201,154,47,4,205,548,0,37.41,28.1
苗栗縣,獅潭鄉,新豐村,124,91,33,2,126,323,0,39.01,28.17
苗栗縣,獅潭鄉,竹木村,279,201,78,2,281,650,0,43.23,30.92
苗栗縣,獅潭鄉,合計,1417,1025,392,22,1439,3782,4094,38.05,27.1
苗栗縣,泰安鄉,八卦村,85,65,20,1,86,336,0,25.6,19.35
苗栗縣,泰安鄉,錦水村,313,263,50,3,316,1070,0,29.53,24.58
苗栗縣,泰安鄉,清安村,288,232,56,5,293,871,0,33.64,26.64
苗栗縣,泰安鄉,大興村,190,168,22,2,192,480,0,40.0,35.0
苗栗縣,泰安鄉,中興村,131,109,22,0,131,501,0,26.15,21.76
苗栗縣,泰安鄉,梅園村,135,109,26,2,137,481,0,28.48,22.66
苗栗縣,泰安鄉,象鼻村,180,146,34,3,183,666,0,27.48,21.92
苗栗縣,泰安鄉,士林村,197,178,19,6,203,590,0,34.41,30.17
苗栗縣,泰安鄉,合計,1519,1270,249,22,1541,4995,5695,30.85,25.43
苗栗縣,合計,合計,169955,106243,63712,1580,171535,457991,540312,37.45,23.2
彰化縣,彰化市,文化里,530,273,257,6,536,1253,0,42.78,21.79
彰化縣,彰化市,下廍里,2125,1092,1033,13,2138,4972,0,43.0,21.96
彰化縣,彰化市,興北里,678,331,347,4,682,1603,0,42.55,20.65
彰化縣,彰化市,信義里,375,180,195,5,380,760,0,50.0,23.68
彰化縣,彰化市,民生里,575,305,270,4,579,1331,0,43.5,22.92
彰化縣,彰化市,陽明里,747,350,397,6,753,1723,0,43.7,20.31
彰化縣,彰化市,萬安里,1719,840,879,14,1733,3835,0,45.19,21.9
彰化縣,彰化市,新興里,2259,1072,1187,23,2282,5212,0,43.78,20.57
彰化縣,彰化市,新華里,769,402,367,5,774,1718,0,45.05,23.4
彰化縣,彰化市,龍山里,833,403,430,2,835,1895,0,44.06,21.27
彰化縣,彰化市,中山里,346,205,141,1,347,762,0,45.54,26.9
彰化縣,彰化市,中正里,644,336,308,5,649,1377,0,47.13,24.4
彰化縣,彰化市,永福里,396,165,231,2,398,862,0,46.17,19.14
彰化縣,彰化市,光復里,262,101,161,4,266,642,0,41.43,15.73
彰化縣,彰化市,光華里,360,165,195,2,362,706,0,51.27,23.37
彰化縣,彰化市,萬壽里,382,135,247,2,384,864,0,44.44,15.63
彰化縣,彰化市,中央里,374,156,218,3,377,748,0,50.4,20.86
彰化縣,彰化市,富貴里,392,161,231,1,393,863,0,45.54,18.66
彰化縣,彰化市,民權里,466,207,259,4,470,1067,0,44.05,19.4
彰化縣,彰化市,西興里,1472,746,726,7,1479,3304,0,44.76,22.58
彰化縣,彰化市,西勢里,1554,855,699,15,1569,3585,0,43.77,23.85
彰化縣,彰化市,忠孝里,529,269,260,3,532,1129,0,47.12,23.83
彰化縣,彰化市,忠權里,1329,699,630,15,1344,3158,0,42.56,22.13
彰化縣,彰化市,五權里,1525,789,736,15,1540,4175,0,36.89,18.9
彰化縣,彰化市,長樂里,456,179,277,4,460,930,0,49.46,19.25
彰化縣,彰化市,東芳里,1387,672,715,16,1403,3505,0,40.03,19.17
彰化縣,彰化市,南安里,886,446,440,7,893,2137,0,41.79,20.87
彰化縣,彰化市,南美里,733,354,379,6,739,1884,0,39.23,18.79
彰化縣,彰化市,莿桐里,1322,630,692,13,1335,3079,0,43.36,20.46
彰化縣,彰化市,磚磘里,1268,671,597,8,1276,3285,0,38.84,20.43
彰化縣,彰化市,平和里,1681,837,844,16,1697,4235,0,40.07,19.76
彰化縣,彰化市,桃源里,963,485,478,5,968,2424,0,39.93,20.01
彰化縣,彰化市,卦山里,1091,606,485,11,1102,2437,0,45.22,24.87
彰化縣,彰化市,東興里,676,327,349,7,683,1511,0,45.2,21.64
彰化縣,彰化市,大同里,451,213,238,7,458,974,0,47.02,21.87
彰化縣,彰化市,永生里,543,262,281,4,547,1169,0,46.79,22.41
彰化縣,彰化市,華陽里,745,428,317,7,752,1770,0,42.49,24.18
彰化縣,彰化市,華北里,634,338,296,6,640,1426,0,44.88,23.7
彰化縣,彰化市,南瑶里,3241,1639,1602,15,3256,7458,0,43.66,21.98
彰化縣,彰化市,成功里,654,333,321,6,660,1470,0,44.9,22.65
彰化縣,彰化市,延和里,2087,1072,1015,16,2103,4938,0,42.59,21.71
彰化縣,彰化市,南興里,3132,1597,1535,22,3154,7515,0,41.97,21.25
彰化縣,彰化市,西安里,1220,614,606,11,1231,2775,0,44.36,22.13
彰化縣,彰化市,彰安里,1252,585,667,14,1266,2845,0,44.5,20.56
彰化縣,彰化市,光南里,639,332,307,2,641,1419,0,45.17,23.4
彰化縣,彰化市,介壽里,958,590,368,6,964,2598,0,37.11,22.71
彰化縣,彰化市,延平里,3771,1973,1798,23,3794,8962,0,42.33,22.02
彰化縣,彰化市,建寶里,1017,572,445,11,1028,2240,0,45.89,25.54
彰化縣,彰化市,福安里,447,207,240,12,459,981,0,46.79,21.1
彰化縣,彰化市,大竹里,1314,658,656,10,1324,3193,0,41.47,20.61
彰化縣,彰化市,竹中里,637,343,294,7,644,1653,0,38.96,20.75
彰化縣,彰化市,安溪里,788,409,379,7,795,1899,0,41.86,21.54
彰化縣,彰化市,香山里,1300,623,677,20,1320,3295,0,40.06,18.91
彰化縣,彰化市,牛埔里,1238,559,679,17,1255,2951,0,42.53,18.94
彰化縣,彰化市,福山里,2716,1249,1467,28,2744,6731,0,40.77,18.56
彰化縣,彰化市,中庄里,962,449,513,10,972,2426,0,40.07,18.51
彰化縣,彰化市,三村里,434,205,229,5,439,1183,0,37.11,17.33
彰化縣,彰化市,國聖里,1019,481,538,11,1030,2414,0,42.67,19.93
彰化縣,彰化市,寶廍里,481,220,261,7,488,1222,0,39.93,18.0
彰化縣,彰化市,茄苳里,383,191,192,5,388,936,0,41.45,20.41
彰化縣,彰化市,茄南里,1243,635,608,12,1255,2915,0,43.05,21.78
彰化縣,彰化市,阿夷里,3345,1778,1567,23,3368,8423,0,39.99,21.11
彰化縣,彰化市,古夷里,928,416,512,6,934,2377,0,39.29,17.5
彰化縣,彰化市,復興里,1776,923,853,18,1794,4046,0,44.34,22.81
彰化縣,彰化市,和調里,1127,595,532,5,1132,2634,0,42.98,22.59
彰化縣,彰化市,石牌里,419,210,209,4,423,1132,0,37.37,18.55
彰化縣,彰化市,福田里,470,230,240,3,473,1249,0,37.87,18.41
彰化縣,彰化市,竹巷里,321,144,177,2,323,840,0,38.45,17.14
彰化縣,彰化市,田中里,359,178,181,1,360,885,0,40.68,20.11
彰化縣,彰化市,快官里,457,222,235,4,461,1114,0,41.38,19.93
彰化縣,彰化市,台鳳里,1667,938,729,9,1676,4349,0,38.54,21.57
彰化縣,彰化市,崙平里,2258,1185,1073,12,2270,5297,0,42.85,22.37
彰化縣,彰化市,向陽里,2181,1205,976,14,2195,5234,0,41.94,23.02
彰化縣,彰化市,合計,79718,40245,39473,656,80374,189909,229765,42.32,21.19
彰化縣,鹿港鎮,大有里,465,183,282,4,469,1109,0,42.29,16.5
彰化縣,鹿港鎮,中興里,219,77,142,2,221,506,0,43.68,15.22
彰化縣,鹿港鎮,洛津里,314,122,192,1,315,847,0,37.19,14.4
彰化縣,鹿港鎮,順興里,378,154,224,1,379,906,0,41.83,17.0
彰化縣,鹿港鎮,頂厝里,2882,1250,1632,22,2904,7832,0,37.08,15.96
彰化縣,鹿港鎮,東崎里,1816,787,1029,15,1831,5195,0,35.25,15.15
彰化縣,鹿港鎮,埔崙里,1927,752,1175,20,1947,5046,0,38.59,14.9
彰化縣,鹿港鎮,東石里,1594,565,1029,18,1612,4391,0,36.71,12.87
彰化縣,鹿港鎮,郭厝里,217,80,137,1,218,521,0,41.84,15.36
彰化縣,鹿港鎮,新宮里,397,128,269,3,400,837,0,47.79,15.29
彰化縣,鹿港鎮,玉順里,447,157,290,5,452,1126,0,40.14,13.94
彰化縣,鹿港鎮,景福里,469,232,237,6,475,1084,0,43.82,21.4
彰化縣,鹿港鎮,泰興里,497,208,289,2,499,1130,0,44.16,18.41
彰化縣,鹿港鎮,長興里,124,58,66,0,124,267,0,46.44,21.72
彰化縣,鹿港鎮,龍山里,278,111,167,6,284,618,0,45.95,17.96
彰化縣,鹿港鎮,興化里,250,99,151,1,251,574,0,43.73,17.25
彰化縣,鹿港鎮,菜園里,405,117,288,8,413,877,0,47.09,13.34
彰化縣,鹿港鎮,街尾里,997,393,604,10,1007,2170,0,46.41,18.11
彰化縣,鹿港鎮,頂番里,1328,705,623,12,1340,3879,0,34.54,18.17
彰化縣,鹿港鎮,頭崙里,902,446,456,14,916,2598,0,35.26,17.17
彰化縣,鹿港鎮,廖厝里,1329,701,628,10,1339,4105,0,32.62,17.08
彰化縣,鹿港鎮,溝墘里,1453,765,688,18,1471,4124,0,35.67,18.55
彰化縣,鹿港鎮,草中里,1168,636,532,8,1176,3189,0,36.88,19.94
彰化縣,鹿港鎮,頭南里,716,397,319,12,728,2191,0,33.23,18.12
彰化縣,鹿港鎮,山崙里,1059,475,584,9,1068,3032,0,35.22,15.67
彰化縣,鹿港鎮,海埔里,1184,498,686,10,1194,3575,0,33.4,13.93
彰化縣,鹿港鎮,詔安里,664,278,386,9,673,2076,0,32.42,13.39
彰化縣,鹿港鎮,洋厝里,900,373,527,16,916,2425,0,37.77,15.38
彰化縣,鹿港鎮,永安里,1570,661,909,15,1585,4383,0,36.16,15.08
彰化縣,鹿港鎮,合計,25949,11408,14541,258,26207,70613,86115,37.11,16.16
彰化縣,和美鎮,竹營里,2148,1115,1033,12,2160,6113,0,35.33,18.24
彰化縣,和美鎮,和東里,1645,807,838,13,1658,4323,0,38.35,18.67
彰化縣,和美鎮,和南里,181,103,78,0,181,398,0,45.48,25.88
彰化縣,和美鎮,和北里,624,305,319,6,630,1796,0,35.08,16.98
彰化縣,和美鎮,和西里,1216,584,632,13,1229,3164,0,38.84,18.46
彰化縣,和美鎮,四張里,1016,496,520,10,1026,2785,0,36.84,17.81
彰化縣,和美鎮,頭前里,546,279,267,4,550,1672,0,32.89,16.69
彰化縣,和美鎮,還社里,340,179,161,3,343,847,0,40.5,21.13
彰化縣,和美鎮,面前里,803,408,395,7,810,2119,0,38.23,19.25
彰化縣,和美鎮,鎮平里,1059,533,526,11,1070,2869,0,37.3,18.58
彰化縣,和美鎮,大霞里,466,237,229,2,468,1464,0,31.97,16.19
彰化縣,和美鎮,源埤里,615,308,307,10,625,1857,0,33.66,16.59
彰化縣,和美鎮,南佃里,813,388,425,5,818,2204,0,37.11,17.6
彰化縣,和美鎮,雅溝里,459,201,258,4,463,1318,0,35.13,15.25
彰化縣,和美鎮,山犁里,2005,1016,989,10,2015,5228,0,38.54,19.43
彰化縣,和美鎮,嘉犁里,728,385,343,4,732,1959,0,37.37,19.65
彰化縣,和美鎮,鐵山里,1065,499,566,8,1073,2669,0,40.2,18.7
彰化縣,和美鎮,詔安里,765,369,396,8,773,2034,0,38.0,18.14
彰化縣,和美鎮,柑井里,1187,550,637,14,1201,3450,0,34.81,15.94
彰化縣,和美鎮,竹園里,355,140,215,9,364,868,0,41.94,16.13
彰化縣,和美鎮,新庄里,970,489,481,13,983,2388,0,41.16,20.48
彰化縣,和美鎮,犁盛里,916,407,509,12,928,2277,0,40.76,17.87
彰化縣,和美鎮,中寮里,359,167,192,9,368,1109,0,33.18,15.06
彰化縣,和美鎮,中圍里,1055,495,560,5,1060,2845,0,37.26,17.4
彰化縣,和美鎮,糖友里,1554,825,729,15,1569,4308,0,36.42,19.15
彰化縣,和美鎮,塗厝里,591,319,272,4,595,1748,0,34.04,18.25
彰化縣,和美鎮,地潭里,245,141,104,2,247,842,0,29.33,16.75
彰化縣,和美鎮,湖內里,450,184,266,2,452,1196,0,37.79,15.38
彰化縣,和美鎮,嘉寶里,629,307,322,3,632,2038,0,31.01,15.06
彰化縣,和美鎮,月眉里,1124,512,612,13,1137,3033,0,37.49,16.88
彰化縣,和美鎮,好修里,566,257,309,4,570,1548,0,36.82,16.6
彰化縣,和美鎮,仁愛里,893,448,445,6,899,2716,0,33.1,16.49
彰化縣,和美鎮,合計,27388,13453,13935,241,27629,75185,89825,36.75,17.89
彰化縣,線西鄉,線西村,435,274,161,1,436,1187,0,36.73,23.08
彰化縣,線西鄉,頂庄村,826,503,323,13,839,2276,0,36.86,22.1
彰化縣,線西鄉,寓埔村,776,423,353,12,788,2324,0,33.91,18.2
彰化縣,線西鄉,塭仔村,440,222,218,3,443,1240,0,35.73,17.9
彰化縣,線西鄉,溝內村,383,194,189,3,386,1223,0,31.56,15.86
彰化縣,線西鄉,下犁村,679,323,356,10,689,1914,0,36.0,16.88
彰化縣,線西鄉,頂犁村,798,439,359,5,803,2519,0,31.88,17.43
彰化縣,線西鄉,德興村,504,275,229,7,511,1348,0,37.91,20.4
彰化縣,線西鄉,合計,4841,2653,2188,54,4895,14031,16573,34.89,18.91
彰化縣,伸港鄉,曾家村,529,243,286,7,536,1748,0,30.66,13.9
彰化縣,伸港鄉,蚵寮村,418,130,288,3,421,1157,0,36.39,11.24
彰化縣,伸港鄉,埤墘村,483,243,240,3,486,1484,0,32.75,16.37
彰化縣,伸港鄉,溪底村,694,308,386,3,697,2048,0,34.03,15.04
彰化縣,伸港鄉,泉州村,673,381,292,8,681,1990,0,34.22,19.15
彰化縣,伸港鄉,泉厝村,456,234,222,5,461,1273,0,36.21,18.38
彰化縣,伸港鄉,海尾村,663,338,325,8,671,1826,0,36.75,18.51
彰化縣,伸港鄉,全興村,499,335,164,7,506,1714,0,29.52,19.54
彰化縣,伸港鄉,定興村,844,443,401,13,857,2652,0,32.32,16.7
彰化縣,伸港鄉,新港村,1718,831,887,8,1726,5173,0,33.37,16.06
彰化縣,伸港鄉,什股村,623,372,251,3,626,2344,0,26.71,15.87
彰化縣,伸港鄉,大同村,959,454,505,3,962,2622,0,36.69,17.32
彰化縣,伸港鄉,七嘉村,984,505,479,5,989,3002,0,32.94,16.82
彰化縣,伸港鄉,汴頭村,724,379,345,12,736,2240,0,32.86,16.92
彰化縣,伸港鄉,合計,10267,5196,5071,88,10355,31273,37802,33.11,16.61
彰化縣,福興鄉,番社村,529,164,365,2,531,1480,0,35.88,11.08
彰化縣,福興鄉,社尾村,491,196,295,4,495,1453,0,34.07,13.49
彰化縣,福興鄉,大崙村,449,211,238,6,455,1237,0,36.78,17.06
彰化縣,福興鄉,外埔村,505,218,287,8,513,1505,0,34.09,14.49
彰化縣,福興鄉,外中村,423,163,260,2,425,1168,0,36.39,13.96
彰化縣,福興鄉,元中村,450,188,262,5,455,1273,0,35.74,14.77
彰化縣,福興鄉,三汴村,533,207,326,10,543,1360,0,39.93,15.22
彰化縣,福興鄉,萬豐村,365,144,221,4,369,832,0,44.35,17.31
彰化縣,福興鄉,番婆村,725,360,365,6,731,2397,0,30.5,15.02
彰化縣,福興鄉,橋頭村,932,446,486,11,943,2653,0,35.54,16.81
彰化縣,福興鄉,秀厝村,813,350,463,10,823,2550,0,32.27,13.73
彰化縣,福興鄉,鎮平村,369,194,175,4,373,1172,0,31.83,16.55
彰化縣,福興鄉,三和村,380,123,257,7,387,1047,0,36.96,11.75
彰化縣,福興鄉,麥厝村,628,250,378,16,644,2180,0,29.54,11.47
彰化縣,福興鄉,廈粘村,584,293,291,9,593,1856,0,31.95,15.79
彰化縣,福興鄉,頂粘村,644,350,294,11,655,2276,0,28.78,15.38
彰化縣,福興鄉,福寶村,331,187,144,5,336,1276,0,26.33,14.66
彰化縣,福興鄉,二港村,458,193,265,3,461,1275,0,36.16,15.14
彰化縣,福興鄉,福興村,1292,554,738,11,1303,3643,0,35.77,15.21
彰化縣,福興鄉,福南村,817,368,449,12,829,2581,0,32.12,14.26
彰化縣,福興鄉,同安村,749,330,419,4,753,2364,0,31.85,13.96
彰化縣,福興鄉,西勢村,693,324,369,7,700,1917,0,36.52,16.9
彰化縣,福興鄉,合計,13160,5813,7347,157,13317,39495,46114,33.72,14.72
彰化縣,秀水鄉,秀水村,685,288,397,6,691,1676,0,41.23,17.18
彰化縣,秀水鄉,安溪村,853,363,490,7,860,2038,0,42.2,17.81
彰化縣,秀水鄉,莊雅村,1037,570,467,10,1047,2642,0,39.63,21.57
彰化縣,秀水鄉,金興村,635,331,304,9,644,1828,0,35.23,18.11
彰化縣,秀水鄉,陝西村,506,277,229,2,508,1438,0,35.33,19.26
彰化縣,秀水鄉,安東村,1486,736,750,14,1500,3871,0,38.75,19.01
彰化縣,秀水鄉,鶴鳴村,1269,598,671,10,1279,3154,0,40.55,18.96
彰化縣,秀水鄉,馬興村,895,393,502,9,904,2279,0,39.67,17.24
彰化縣,秀水鄉,義興村,510,256,254,4,514,1479,0,34.75,17.31
彰化縣,秀水鄉,福安村,1687,833,854,10,1697,4523,0,37.52,18.42
彰化縣,秀水鄉,埔崙村,846,395,451,6,852,1939,0,43.94,20.37
彰化縣,秀水鄉,曾厝村,633,322,311,7,640,1677,0,38.16,19.2
彰化縣,秀水鄉,金陵村,668,275,393,5,673,1737,0,38.74,15.83
彰化縣,秀水鄉,下崙村,772,323,449,7,779,2170,0,35.9,14.88
彰化縣,秀水鄉,合計,12482,5960,6522,106,12588,32451,38830,38.79,18.37
彰化縣,花壇鄉,花壇村,1326,683,643,11,1337,3179,0,42.06,21.48
彰化縣,花壇鄉,金墩村,681,340,341,8,689,1758,0,39.19,19.34
彰化縣,花壇鄉,中庄村,920,470,450,7,927,2329,0,39.8,20.18
彰化縣,花壇鄉,劉厝村,455,198,257,9,464,1069,0,43.41,18.52
彰化縣,花壇鄉,崙雅村,559,254,305,5,564,1419,0,39.75,17.9
彰化縣,花壇鄉,南口村,747,385,362,16,763,1892,0,40.33,20.35
彰化縣,花壇鄉,中口村,295,140,155,2,297,721,0,41.19,19.42
彰化縣,花壇鄉,北口村,730,370,360,7,737,1803,0,40.88,20.52
彰化縣,花壇鄉,長沙村,1887,1039,848,21,1908,4928,0,38.72,21.08
彰化縣,花壇鄉,文德村,1132,570,562,14,1146,3092,0,37.06,18.43
彰化縣,花壇鄉,白沙村,1707,909,798,20,1727,4602,0,37.53,19.75
彰化縣,花壇鄉,岩竹村,516,225,291,7,523,1340,0,39.03,16.79
彰化縣,花壇鄉,橋頭村,1159,631,528,8,1167,3298,0,35.39,19.13
彰化縣,花壇鄉,灣雅村,312,179,133,0,312,890,0,35.06,20.11
彰化縣,花壇鄉,灣東村,338,166,172,4,342,932,0,36.7,17.81
彰化縣,花壇鄉,三春村,664,362,302,6,670,1906,0,35.15,18.99
彰化縣,花壇鄉,永春村,578,318,260,5,583,1888,0,30.88,16.84
彰化縣,花壇鄉,長春村,492,274,218,8,500,1605,0,31.15,17.07
彰化縣,花壇鄉,合計,14498,7513,6985,158,14656,38651,45018,37.92,19.44
彰化縣,芬園鄉,舊社村,590,297,293,6,596,1743,0,34.19,17.04
彰化縣,芬園鄉,大埔村,471,238,233,5,476,1387,0,34.32,17.16
彰化縣,芬園鄉,竹林村,674,334,340,10,684,1754,0,39.0,19.04
彰化縣,芬園鄉,社口村,863,421,442,8,871,2452,0,35.52,17.17
彰化縣,芬園鄉,茄荖村,894,383,511,8,902,2344,0,38.48,16.34
彰化縣,芬園鄉,嘉興村,648,352,296,19,667,1622,0,41.12,21.7
彰化縣,芬園鄉,芬園村,303,142,161,1,304,877,0,34.66,16.19
彰化縣,芬園鄉,縣庄村,414,152,262,3,417,1142,0,36.51,13.31
彰化縣,芬園鄉,圳墘村,217,88,129,6,223,647,0,34.47,13.6
彰化縣,芬園鄉,溪頭村,628,259,369,8,636,1646,0,38.64,15.74
彰化縣,芬園鄉,進芬村,346,168,178,3,349,965,0,36.17,17.41
彰化縣,芬園鄉,同安村,381,154,227,8,389,1139,0,34.15,13.52
彰化縣,芬園鄉,中崙村,256,97,159,7,263,854,0,30.8,11.36
彰化縣,芬園鄉,大竹村,326,100,226,3,329,966,0,34.06,10.35
彰化縣,芬園鄉,楓坑村,201,103,98,5,206,576,0,35.76,17.88
彰化縣,芬園鄉,合計,7212,3288,3924,100,7312,20114,22927,36.35,16.35
彰化縣,員林市,東和里,409,233,176,5,414,1051,0,39.39,22.17
彰化縣,員林市,民生里,1082,562,520,7,1089,2683,0,40.59,20.95
彰化縣,員林市,中正里,1309,685,624,7,1316,3068,0,42.89,22.33
彰化縣,員林市,仁美里,1099,574,525,8,1107,2540,0,43.58,22.6
彰化縣,員林市,新興里,335,149,186,4,339,695,0,48.78,21.44
彰化縣,員林市,和平里,1102,567,535,10,1112,2785,0,39.93,20.36
彰化縣,員林市,光明里,349,178,171,2,351,754,0,46.55,23.61
彰化縣,員林市,中山里,288,146,142,0,288,571,0,50.44,25.57
彰化縣,員林市,黎明里,684,335,349,5,689,1808,0,38.11,18.53
彰化縣,員林市,惠來里,2272,1106,1166,19,2291,5571,0,41.12,19.85
彰化縣,員林市,三義里,951,497,454,10,961,2460,0,39.07,20.2
彰化縣,員林市,新生里,1747,861,886,14,1761,4122,0,42.72,20.89
彰化縣,員林市,南平里,2124,1071,1053,12,2136,5313,0,40.2,20.16
彰化縣,員林市,南興里,1826,964,862,16,1842,4646,0,39.65,20.75
彰化縣,員林市,源潭里,572,239,333,6,578,1675,0,34.51,14.27
彰化縣,員林市,大埔里,739,368,371,12,751,2088,0,35.97,17.62
彰化縣,員林市,三條里,1054,529,525,15,1069,2693,0,39.7,19.64
彰化縣,員林市,三和里,2370,1267,1103,18,2388,6107,0,39.1,20.75
彰化縣,員林市,三橋里,1188,628,560,11,1199,2880,0,41.63,21.81
彰化縣,員林市,中央里,686,333,353,14,700,1929,0,36.29,17.26
彰化縣,員林市,溝皂里,1052,520,532,15,1067,2485,0,42.94,20.93
彰化縣,員林市,大饒里,1375,697,678,12,1387,3290,0,42.16,21.19
彰化縣,員林市,大明里,890,382,508,12,902,2363,0,38.17,16.17
彰化縣,員林市,萬年里,1524,816,708,15,1539,3631,0,42.39,22.47
彰化縣,員林市,崙雅里,873,481,392,11,884,2304,0,38.37,20.88
彰化縣,員林市,振興里,1026,565,461,1,1027,2698,0,38.07,20.94
彰化縣,員林市,林厝里,966,463,503,18,984,2788,0,35.29,16.61
彰化縣,員林市,出水里,584,222,362,5,589,1640,0,35.91,13.54
彰化縣,員林市,湖水里,430,155,275,5,435,1187,0,36.65,13.06
彰化縣,員林市,大峯里,279,163,116,2,281,713,0,39.41,22.86
彰化縣,員林市,鎮興里,714,335,379,6,720,1974,0,36.47,16.97
彰化縣,員林市,浮圳里,770,369,401,9,779,2175,0,35.82,16.97
彰化縣,員林市,西東里,717,288,429,6,723,1938,0,37.31,14.86
彰化縣,員林市,南東里,610,280,330,4,614,1738,0,35.33,16.11
彰化縣,員林市,中東里,606,323,283,7,613,1748,0,35.07,18.48
彰化縣,員林市,東北里,829,397,432,14,843,2262,0,37.27,17.55
彰化縣,員林市,三愛里,1241,657,584,11,1252,2953,0,42.4,22.25
彰化縣,員林市,三信里,988,542,446,6,994,2262,0,43.94,23.96
彰化縣,員林市,三多里,1108,548,560,7,1115,2449,0,45.53,22.38
彰化縣,員林市,仁愛里,564,295,269,2,566,1328,0,42.62,22.21
彰化縣,員林市,忠孝里,822,435,387,5,827,2178,0,37.97,19.97
彰化縣,員林市,合計,40154,20225,19929,368,40522,101543,123460,39.91,19.92
彰化縣,溪湖鎮,光平里,491,237,254,2,493,1156,0,42.65,20.5
彰化縣,溪湖鎮,平和里,296,153,143,0,296,623,0,47.51,24.56
彰化縣,溪湖鎮,太平里,645,342,303,1,646,1780,0,36.29,19.21
彰化縣,溪湖鎮,光華里,177,103,74,1,178,420,0,42.38,24.52
彰化縣,溪湖鎮,東寮里,1192,664,528,7,1199,3356,0,35.73,19.79
彰化縣,溪湖鎮,西寮里,841,451,390,12,853,2176,0,39.2,20.73
彰化縣,溪湖鎮,大突里,1179,679,500,7,1186,3446,0,34.42,19.7
彰化縣,溪湖鎮,北勢里,450,209,241,4,454,1421,0,31.95,14.71
彰化縣,溪湖鎮,汴頭里,994,487,507,12,1006,3018,0,33.33,16.14
彰化縣,溪湖鎮,大竹里,908,485,423,7,915,2433,0,37.61,19.93
彰化縣,溪湖鎮,湖西里,829,429,400,4,833,2297,0,36.26,18.68
彰化縣,溪湖鎮,田中里,285,113,172,5,290,814,0,35.63,13.88
彰化縣,溪湖鎮,河東里,608,291,317,4,612,1829,0,33.46,15.91
彰化縣,溪湖鎮,中山里,759,402,357,5,764,2278,0,33.54,17.65
彰化縣,溪湖鎮,中竹里,299,131,168,1,300,817,0,36.72,16.03
彰化縣,溪湖鎮,東溪里,459,179,280,1,460,1353,0,34.0,13.23
彰化縣,溪湖鎮,西溪里,702,355,347,6,708,1836,0,38.56,19.34
彰化縣,溪湖鎮,湖東里,1604,789,815,12,1616,4595,0,35.17,17.17
彰化縣,溪湖鎮,頂庄里,207,110,97,0,207,641,0,32.29,17.16
彰化縣,溪湖鎮,忠覺里,474,252,222,4,478,1250,0,38.24,20.16
彰化縣,溪湖鎮,湳底里,237,114,123,3,240,694,0,34.58,16.43
彰化縣,溪湖鎮,大庭里,443,242,201,6,449,1362,0,32.97,17.77
彰化縣,溪湖鎮,媽厝里,386,147,239,4,390,1250,0,31.2,11.76
彰化縣,溪湖鎮,西勢里,704,322,382,10,714,2168,0,32.93,14.85
彰化縣,溪湖鎮,番婆里,567,268,299,3,570,1713,0,33.27,15.65
彰化縣,溪湖鎮,合計,15736,7954,7782,121,15857,44726,54577,35.45,17.78
彰化縣,田中鎮,香山里,269,122,147,1,270,816,0,33.09,14.95
彰化縣,田中鎮,碧峰里,365,213,152,6,371,1037,0,35.78,20.54
彰化縣,田中鎮,東源里,280,146,134,2,282,748,0,37.7,19.52
彰化縣,田中鎮,復興里,533,296,237,8,541,1496,0,36.16,19.79
彰化縣,田中鎮,平和里,523,299,224,7,530,1448,0,36.6,20.65
彰化縣,田中鎮,頂潭里,462,218,244,8,470,1226,0,38.34,17.78
彰化縣,田中鎮,中潭里,643,291,352,5,648,1756,0,36.9,16.57
彰化縣,田中鎮,龍潭里,255,107,148,1,256,580,0,44.14,18.45
彰化縣,田中鎮,北路里,1309,693,616,8,1317,3269,0,40.29,21.2
彰化縣,田中鎮,西路里,931,436,495,5,936,2363,0,39.61,18.45
彰化縣,田中鎮,東路里,404,184,220,2,406,1041,0,39.0,17.68
彰化縣,田中鎮,南路里,451,210,241,3,454,1106,0,41.05,18.99
彰化縣,田中鎮,中路里,806,418,388,7,813,1942,0,41.86,21.52
彰化縣,田中鎮,新庄里,939,481,458,4,943,2399,0,39.31,20.05
彰化縣,田中鎮,三安里,571,206,365,5,576,1560,0,36.92,13.21
彰化縣,田中鎮,大崙里,442,211,231,6,448,1292,0,34.67,16.33
彰化縣,田中鎮,沙崙里,634,299,335,9,643,1814,0,35.45,16.48
彰化縣,田中鎮,新民里,1528,779,749,16,1544,4178,0,36.96,18.65
彰化縣,田中鎮,梅州里,434,191,243,9,443,1271,0,34.85,15.03
彰化縣,田中鎮,三民里,516,267,249,2,518,1561,0,33.18,17.1
彰化縣,田中鎮,三光里,325,151,174,4,329,913,0,36.04,16.54
彰化縣,田中鎮,大社里,325,134,191,6,331,866,0,38.22,15.47
彰化縣,田中鎮,合計,12945,6352,6593,124,13069,34682,40379,37.68,18.31
彰化縣,大村鄉,大村村,1254,610,644,16,1270,3428,0,37.05,17.79
彰化縣,大村鄉,茄苳村,579,271,308,5,584,1546,0,37.77,17.53
彰化縣,大村鄉,南勢村,524,235,289,4,528,1493,0,35.37,15.74
彰化縣,大村鄉,田洋村,435,218,217,5,440,1209,0,36.39,18.03
彰化縣,大村鄉,新興村,383,164,219,5,388,1172,0,33.11,13.99
彰化縣,大村鄉,過溝村,1589,851,738,13,1602,4186,0,38.27,20.33
彰化縣,大村鄉,美港村,760,387,373,3,763,2092,0,36.47,18.5
彰化縣,大村鄉,平和村,863,413,450,11,874,2569,0,34.02,16.08
彰化縣,大村鄉,貢旗村,578,295,283,6,584,1569,0,37.22,18.8
彰化縣,大村鄉,加錫村,537,260,277,4,541,1528,0,35.41,17.02
彰化縣,大村鄉,村上村,543,274,269,3,546,1420,0,38.45,19.3
彰化縣,大村鄉,大橋村,698,373,325,9,707,2033,0,34.78,18.35
彰化縣,大村鄉,大崙村,555,257,298,8,563,1624,0,34.67,15.83
彰化縣,大村鄉,擺塘村,974,457,517,10,984,2635,0,37.34,17.34
彰化縣,大村鄉,黃厝村,788,371,417,7,795,2428,0,32.74,15.28
彰化縣,大村鄉,福興村,758,327,431,6,764,2179,0,35.06,15.01
彰化縣,大村鄉,合計,11818,5763,6055,115,11933,33111,39085,36.04,17.41
彰化縣,埔鹽鄉,埔鹽村,670,363,307,8,678,1664,0,40.75,21.81
彰化縣,埔鹽鄉,埔南村,546,292,254,7,553,1536,0,36.0,19.01
彰化縣,埔鹽鄉,廍子村,454,258,196,5,459,1251,0,36.69,20.62
彰化縣,埔鹽鄉,出水村,338,202,136,3,341,889,0,38.36,22.72
彰化縣,埔鹽鄉,南港村,607,317,290,5,612,1750,0,34.97,18.11
彰化縣,埔鹽鄉,打廉村,328,163,165,6,334,939,0,35.57,17.36
彰化縣,埔鹽鄉,豐澤村,447,218,229,10,457,1306,0,34.99,16.69
彰化縣,埔鹽鄉,崑崙村,384,202,182,3,387,1086,0,35.64,18.6
彰化縣,埔鹽鄉,角樹村,273,174,99,3,276,656,0,42.07,26.52
彰化縣,埔鹽鄉,瓦磘村,422,219,203,4,426,1199,0,35.53,18.27
彰化縣,埔鹽鄉,好修村,556,311,245,1,557,1781,0,31.27,17.46
彰化縣,埔鹽鄉,西湖村,638,348,290,8,646,2059,0,31.37,16.9
彰化縣,埔鹽鄉,大有村,394,188,206,6,400,1194,0,33.5,15.75
彰化縣,埔鹽鄉,新興村,184,118,66,4,188,456,0,41.23,25.88
彰化縣,埔鹽鄉,永平村,373,207,166,6,379,1101,0,34.42,18.8
彰化縣,埔鹽鄉,永樂村,308,156,152,8,316,848,0,37.26,18.4
彰化縣,埔鹽鄉,石埤村,396,194,202,3,399,1437,0,27.77,13.5
彰化縣,埔鹽鄉,天盛村,255,159,96,5,260,838,0,31.03,18.97
彰化縣,埔鹽鄉,太平村,471,257,214,11,482,1538,0,31.34,16.71
彰化縣,埔鹽鄉,新水村,507,338,169,7,514,1523,0,33.75,22.19
彰化縣,埔鹽鄉,三省村,450,238,212,6,456,1368,0,33.33,17.4
彰化縣,埔鹽鄉,南新村,449,290,159,2,451,1314,0,34.32,22.07
彰化縣,埔鹽鄉,合計,9450,5212,4238,121,9571,27733,31833,34.51,18.79
彰化縣,埔心鄉,東門村,1365,650,715,6,1371,3555,0,38.57,18.28
彰化縣,埔心鄉,埔心村,463,194,269,4,467,1250,0,37.36,15.52
彰化縣,埔心鄉,義民村,613,310,303,5,618,1556,0,39.72,19.92
彰化縣,埔心鄉,油車村,451,241,210,4,455,1258,0,36.17,19.16
彰化縣,埔心鄉,瓦北村,658,275,383,4,662,1740,0,38.05,15.8
彰化縣,埔心鄉,瓦中村,764,363,401,8,772,1976,0,39.07,18.37
彰化縣,埔心鄉,瓦南村,558,234,324,7,565,1422,0,39.73,16.46
彰化縣,埔心鄉,太平村,656,308,348,5,661,1976,0,33.45,15.59
彰化縣,埔心鄉,經口村,888,384,504,11,899,2348,0,38.29,16.35
彰化縣,埔心鄉,大華村,227,104,123,2,229,658,0,34.8,15.81
彰化縣,埔心鄉,仁里村,436,212,224,7,443,1265,0,35.02,16.76
彰化縣,埔心鄉,舊舘村,574,256,318,3,577,1491,0,38.7,17.17
彰化縣,埔心鄉,南舘村,366,156,210,4,370,1065,0,34.74,14.65
彰化縣,埔心鄉,新舘村,338,166,172,3,341,963,0,35.41,17.24
彰化縣,埔心鄉,羅厝村,429,162,267,5,434,1305,0,33.26,12.41
彰化縣,埔心鄉,芎蕉村,662,258,404,9,671,1842,0,36.43,14.01
彰化縣,埔心鄉,二重村,520,215,305,11,531,1436,0,36.98,14.97
彰化縣,埔心鄉,梧鳳村,314,153,161,8,322,893,0,36.06,17.13
彰化縣,埔心鄉,埤霞村,251,121,130,1,252,736,0,34.24,16.44
彰化縣,埔心鄉,埤脚村,321,184,137,8,329,916,0,35.92,20.09
彰化縣,埔心鄉,合計,10854,4946,5908,115,10969,29651,34223,36.99,16.68
彰化縣,永靖鄉,永東村,327,178,149,2,329,761,0,43.23,23.39
彰化縣,永靖鄉,永西村,607,274,333,0,607,1503,0,40.39,18.23
彰化縣,永靖鄉,永南村,729,375,354,9,738,1800,0,41.0,20.83
彰化縣,永靖鄉,永北村,784,391,393,5,789,2147,0,36.75,18.21
彰化縣,永靖鄉,港西村,661,306,355,7,668,1704,0,39.2,17.96
彰化縣,永靖鄉,五福村,533,267,266,7,540,1438,0,37.55,18.57
彰化縣,永靖鄉,湳港村,382,122,260,6,388,1059,0,36.64,11.52
彰化縣,永靖鄉,新莊村,354,207,147,7,361,1065,0,33.9,19.44
彰化縣,永靖鄉,瑚璉村,977,491,486,12,989,2670,0,37.04,18.39
彰化縣,永靖鄉,五汴村,562,207,355,9,571,1368,0,41.74,15.13
彰化縣,永靖鄉,浮圳村,363,174,189,2,365,1220,0,29.92,14.26
彰化縣,永靖鄉,光雲村,553,222,331,8,561,1624,0,34.54,13.67
彰化縣,永靖鄉,東寧村,665,306,359,10,675,1908,0,35.38,16.04
彰化縣,永靖鄉,永興村,607,314,293,9,616,1558,0,39.54,20.15
彰化縣,永靖鄉,崙子村,515,236,279,6,521,1400,0,37.21,16.86
彰化縣,永靖鄉,獨鰲村,259,130,129,3,262,825,0,31.76,15.76
彰化縣,永靖鄉,敦厚村,244,117,127,1,245,710,0,34.51,16.48
彰化縣,永靖鄉,崙美村,304,123,181,5,309,736,0,41.98,16.71
彰化縣,永靖鄉,同安村,252,104,148,4,256,654,0,39.14,15.9
彰化縣,永靖鄉,同仁村,312,151,161,3,315,847,0,37.19,17.83
彰化縣,永靖鄉,湳墘村,294,135,159,5,299,809,0,36.96,16.69
彰化縣,永靖鄉,四芳村,240,132,108,6,246,637,0,38.62,20.72
彰化縣,永靖鄉,福興村,356,184,172,3,359,1075,0,33.4,17.12
彰化縣,永靖鄉,竹子村,508,175,333,2,510,1290,0,39.53,13.57
彰化縣,永靖鄉,合計,11388,5321,6067,131,11519,30808,36061,37.39,17.27
彰化縣,社頭鄉,社頭村,1042,440,602,2,1044,2749,0,37.98,16.01
彰化縣,社頭鄉,東興村,504,253,251,7,511,1460,0,35.0,17.33
彰化縣,社頭鄉,山湖村,424,152,272,5,429,1121,0,38.27,13.56
彰化縣,社頭鄉,廣興村,1574,661,913,17,1591,4439,0,35.84,14.89
彰化縣,社頭鄉,廣福村,342,140,202,5,347,914,0,37.96,15.32
彰化縣,社頭鄉,朝興村,423,188,235,6,429,1096,0,39.14,17.15
彰化縣,社頭鄉,仁雅村,1045,529,516,7,1052,2717,0,38.72,19.47
彰化縣,社頭鄉,橋頭村,758,335,423,12,770,2068,0,37.23,16.2
彰化縣,社頭鄉,仁和村,235,129,106,3,238,754,0,31.56,17.11
彰化縣,社頭鄉,崙雅村,333,173,160,6,339,905,0,37.46,19.12
彰化縣,社頭鄉,湳底村,567,233,334,7,574,1712,0,33.53,13.61
彰化縣,社頭鄉,泰安村,298,160,138,6,304,968,0,31.4,16.53
彰化縣,社頭鄉,美雅村,458,215,243,6,464,1252,0,37.06,17.17
彰化縣,社頭鄉,新厝村,543,251,292,8,551,1401,0,39.33,17.92
彰化縣,社頭鄉,平和村,362,171,191,0,362,961,0,37.67,17.79
彰化縣,社頭鄉,里仁村,376,195,181,3,379,980,0,38.67,19.9
彰化縣,社頭鄉,張厝村,460,200,260,11,471,1204,0,39.12,16.61
彰化縣,社頭鄉,龍井村,271,104,167,1,272,806,0,33.75,12.9
彰化縣,社頭鄉,舊社村,623,277,346,11,634,1581,0,40.1,17.52
彰化縣,社頭鄉,埤斗村,340,139,201,3,343,977,0,35.11,14.23
彰化縣,社頭鄉,湳雅村,510,207,303,6,516,1487,0,34.7,13.92
彰化縣,社頭鄉,松竹村,380,160,220,4,384,1028,0,37.35,15.56
彰化縣,社頭鄉,清水村,419,239,180,6,425,1260,0,33.73,18.97
彰化縣,社頭鄉,協和村,742,311,431,6,748,2148,0,34.82,14.48
彰化縣,社頭鄉,合計,13029,5862,7167,148,13177,35988,42279,36.61,16.29
彰化縣,二水鄉,合和村,311,146,165,0,311,821,0,37.88,17.78
彰化縣,二水鄉,上豊村,370,159,211,8,378,916,0,41.27,17.36
彰化縣,二水鄉,過圳村,234,115,119,7,241,610,0,39.51,18.85
彰化縣,二水鄉,五伯村,254,120,134,1,255,609,0,41.87,19.7
彰化縣,二水鄉,光化村,380,184,196,1,381,883,0,43.15,20.84
彰化縣,二水鄉,文化村,364,200,164,2,366,933,0,39.23,21.44
彰化縣,二水鄉,二水村,317,145,172,6,323,776,0,41.62,18.69
彰化縣,二水鄉,聖化村,196,122,74,4,200,438,0,45.66,27.85
彰化縣,二水鄉,裕民村,369,179,190,3,372,996,0,37.35,17.97
彰化縣,二水鄉,惠民村,336,140,196,4,340,801,0,42.45,17.48
彰化縣,二水鄉,大園村,264,98,166,3,267,776,0,34.41,12.63
彰化縣,二水鄉,修仁村,288,154,134,3,291,779,0,37.36,19.77
彰化縣,二水鄉,合興村,263,110,153,5,268,665,0,40.3,16.54
彰化縣,二水鄉,源泉村,235,115,120,4,239,597,0,40.03,19.26
彰化縣,二水鄉,倡和村,217,105,112,2,219,562,0,38.97,18.68
彰化縣,二水鄉,復興村,378,150,228,9,387,1000,0,38.7,15.0
彰化縣,二水鄉,十五村,269,120,149,2,271,665,0,40.75,18.05
彰化縣,二水鄉,合計,5045,2362,2683,64,5109,12827,14488,39.83,18.41
彰化縣,北斗鎮,光復里,683,365,318,4,687,1771,0,38.79,20.61
彰化縣,北斗鎮,新政里,301,155,146,3,304,770,0,39.48,20.13
彰化縣,北斗鎮,重慶里,226,88,138,1,227,535,0,42.43,16.45
彰化縣,北斗鎮,五權里,281,135,146,1,282,656,0,42.99,20.58
彰化縣,北斗鎮,七星里,520,215,305,4,524,1406,0,37.27,15.29
彰化縣,北斗鎮,居仁里,538,314,224,2,540,1257,0,42.96,24.98
彰化縣,北斗鎮,東光里,827,380,447,8,835,2278,0,36.65,16.68
彰化縣,北斗鎮,文昌里,1117,552,565,15,1132,3114,0,36.35,17.73
彰化縣,北斗鎮,中和里,411,188,223,4,415,1307,0,31.75,14.38
彰化縣,北斗鎮,西德里,1743,852,891,14,1757,4588,0,38.3,18.57
彰化縣,北斗鎮,西安里,553,295,258,3,556,1694,0,32.82,17.41
彰化縣,北斗鎮,中寮里,950,416,534,8,958,2702,0,35.46,15.4
彰化縣,北斗鎮,大道里,703,296,407,5,708,1904,0,37.18,15.55
彰化縣,北斗鎮,新生里,592,301,291,6,598,2028,0,29.49,14.84
彰化縣,北斗鎮,大新里,590,325,265,7,597,1791,0,33.33,18.15
彰化縣,北斗鎮,合計,10035,4877,5158,85,10120,27801,33351,36.4,17.54
彰化縣,二林鎮,東和里,674,322,352,8,682,2094,0,32.57,15.38
彰化縣,二林鎮,南光里,1114,646,468,13,1127,3227,0,34.92,20.02
彰化縣,二林鎮,西平里,486,259,227,3,489,1498,0,32.64,17.29
彰化縣,二林鎮,北平里,953,457,496,15,968,2966,0,32.64,15.41
彰化縣,二林鎮,中西里,440,274,166,12,452,1610,0,28.07,17.02
彰化縣,二林鎮,廣興里,385,204,181,8,393,1341,0,29.31,15.21
彰化縣,二林鎮,香田里,302,128,174,0,302,1010,0,29.9,12.67
彰化縣,二林鎮,外竹里,268,139,129,7,275,976,0,28.18,14.24
彰化縣,二林鎮,興華里,389,225,164,8,397,1145,0,34.67,19.65
彰化縣,二林鎮,東興里,520,289,231,7,527,1598,0,32.98,18.09
彰化縣,二林鎮,後厝里,1120,650,470,16,1136,3312,0,34.3,19.63
彰化縣,二林鎮,豐田里,742,396,346,6,748,2497,0,29.96,15.86
彰化縣,二林鎮,頂厝里,361,201,160,11,372,1309,0,28.42,15.36
彰化縣,二林鎮,趙甲里,461,252,209,20,481,1557,0,30.89,16.18
彰化縣,二林鎮,振興里,332,174,158,7,339,1180,0,28.73,14.75
彰化縣,二林鎮,萬興里,261,152,109,4,265,770,0,34.42,19.74
彰化縣,二林鎮,永興里,507,257,250,2,509,1485,0,34.28,17.31
彰化縣,二林鎮,西庄里,355,161,194,2,357,1259,0,28.36,12.79
彰化縣,二林鎮,梅芳里,333,182,151,7,340,1071,0,31.75,16.99
彰化縣,二林鎮,華崙里,1117,657,460,21,1138,3551,0,32.05,18.5
彰化縣,二林鎮,東勢里,296,147,149,7,303,958,0,31.63,15.34
彰化縣,二林鎮,萬合里,286,172,114,13,299,1107,0,27.01,15.54
彰化縣,二林鎮,大永里,245,118,127,5,250,886,0,28.22,13.32
彰化縣,二林鎮,原斗里,483,241,242,7,490,1220,0,40.16,19.75
彰化縣,二林鎮,西斗里,334,170,164,6,340,1041,0,32.66,16.33
彰化縣,二林鎮,東華里,360,144,216,7,367,967,0,37.95,14.89
彰化縣,二林鎮,復豐里,202,91,111,4,206,704,0,29.26,12.93
彰化縣,二林鎮,合計,13326,7108,6218,226,13552,42339,49337,32.01,16.79
彰化縣,田尾鄉,田尾村,493,238,255,7,500,1279,0,39.09,18.61
彰化縣,田尾鄉,豐田村,270,146,124,3,273,793,0,34.43,18.41
彰化縣,田尾鄉,饒平村,957,507,450,10,967,2570,0,37.63,19.73
彰化縣,田尾鄉,睦宜村,357,166,191,7,364,1054,0,34.54,15.75
彰化縣,田尾鄉,福田村,282,123,159,6,288,751,0,38.35,16.38
彰化縣,田尾鄉,新興村,417,176,241,5,422,1022,0,41.29,17.22
彰化縣,田尾鄉,北鎮村,370,183,187,5,375,1202,0,31.2,15.22
彰化縣,田尾鄉,南鎮村,227,97,130,0,227,613,0,37.03,15.82
彰化縣,田尾鄉,新生村,481,218,263,6,487,1329,0,36.64,16.4
彰化縣,田尾鄉,南曾村,455,190,265,9,464,1280,0,36.25,14.84
彰化縣,田尾鄉,北曾村,576,240,336,14,590,1535,0,38.44,15.64
彰化縣,田尾鄉,溪畔村,441,199,242,3,444,1216,0,36.51,16.37
彰化縣,田尾鄉,打簾村,664,324,340,14,678,1724,0,39.33,18.79
彰化縣,田尾鄉,柳鳳村,418,213,205,3,421,941,0,44.74,22.64
彰化縣,田尾鄉,陸豐村,299,144,155,4,303,870,0,34.83,16.55
彰化縣,田尾鄉,海豐村,455,213,242,3,458,1365,0,33.55,15.6
彰化縣,田尾鄉,仁里村,548,267,281,9,557,1594,0,34.94,16.75
彰化縣,田尾鄉,新厝村,93,47,46,1,94,258,0,36.43,18.22
彰化縣,田尾鄉,溪頂村,220,88,132,6,226,613,0,36.87,14.36
彰化縣,田尾鄉,正義村,342,168,174,4,346,875,0,39.54,19.2
彰化縣,田尾鄉,合計,8365,3947,4418,119,8484,22884,26569,37.07,17.25
彰化縣,埤頭鄉,和豊村,773,367,406,9,782,2433,0,32.14,15.08
彰化縣,埤頭鄉,興農村,577,273,304,7,584,1785,0,32.72,15.29
彰化縣,埤頭鄉,埤頭村,573,225,348,11,584,1565,0,37.32,14.38
彰化縣,埤頭鄉,豊崙村,644,386,258,12,656,2256,0,29.08,17.11
彰化縣,埤頭鄉,崙子村,408,200,208,3,411,1230,0,33.41,16.26
彰化縣,埤頭鄉,永豊村,518,241,277,13,531,1561,0,34.02,15.44
彰化縣,埤頭鄉,合興村,1179,666,513,6,1185,3254,0,36.42,20.47
彰化縣,埤頭鄉,平原村,675,360,315,11,686,2210,0,31.04,16.29
彰化縣,埤頭鄉,崙腳村,234,99,135,6,240,710,0,33.8,13.94
彰化縣,埤頭鄉,元埔村,206,98,108,0,206,558,0,36.92,17.56
彰化縣,埤頭鄉,芙朝村,491,253,238,6,497,1486,0,33.45,17.03
彰化縣,埤頭鄉,新庄村,336,107,229,5,341,1021,0,33.4,10.48
彰化縣,埤頭鄉,陸嘉村,245,98,147,5,250,807,0,30.98,12.14
彰化縣,埤頭鄉,竹圍村,354,114,240,6,360,1052,0,34.22,10.84
彰化縣,埤頭鄉,中和村,509,216,293,4,513,1457,0,35.21,14.82
彰化縣,埤頭鄉,庄內村,331,122,209,12,343,1056,0,32.48,11.55
彰化縣,埤頭鄉,大湖村,341,119,222,8,349,913,0,38.23,13.03
彰化縣,埤頭鄉,合計,8394,3944,4450,124,8518,25354,29860,33.6,15.56
彰化縣,芳苑鄉,芳苑村,252,86,166,5,257,928,0,27.69,9.27
彰化縣,芳苑鄉,芳中村,145,64,81,4,149,395,0,37.72,16.2
彰化縣,芳苑鄉,仁愛村,224,124,100,2,226,735,0,30.75,16.87
彰化縣,芳苑鄉,信義村,132,61,71,2,134,522,0,25.67,11.69
彰化縣,芳苑鄉,後寮村,231,128,103,3,234,949,0,24.66,13.49
彰化縣,芳苑鄉,三合村,673,313,360,7,680,2090,0,32.54,14.98
彰化縣,芳苑鄉,永興村,407,203,204,3,410,1329,0,30.85,15.27
彰化縣,芳苑鄉,五俊村,102,47,55,2,104,475,0,21.89,9.89
彰化縣,芳苑鄉,路上村,175,87,88,6,181,630,0,28.73,13.81
彰化縣,芳苑鄉,路平村,218,131,87,3,221,785,0,28.15,16.69
彰化縣,芳苑鄉,三成村,226,115,111,7,233,973,0,23.95,11.82
彰化縣,芳苑鄉,福榮村,181,84,97,3,184,575,0,32.0,14.61
彰化縣,芳苑鄉,頂廍村,171,78,93,3,174,557,0,31.24,14.0
彰化縣,芳苑鄉,新街村,197,71,126,5,202,769,0,26.27,9.23
彰化縣,芳苑鄉,王功村,641,206,435,9,650,2116,0,30.72,9.74
彰化縣,芳苑鄉,博愛村,243,70,173,5,248,673,0,36.85,10.4
彰化縣,芳苑鄉,和平村,210,86,124,5,215,727,0,29.57,11.83
彰化縣,芳苑鄉,民生村,214,78,136,2,216,665,0,32.48,11.73
彰化縣,芳苑鄉,興仁村,375,124,251,4,379,1278,0,29.66,9.7
彰化縣,芳苑鄉,新寶村,490,192,298,5,495,1656,0,29.89,11.59
彰化縣,芳苑鄉,草湖村,448,223,225,2,450,1420,0,31.69,15.7
彰化縣,芳苑鄉,文津村,234,107,127,3,237,1062,0,22.32,10.08
彰化縣,芳苑鄉,建平村,589,261,328,3,592,2059,0,28.75,12.68
彰化縣,芳苑鄉,崙腳村,215,116,99,7,222,762,0,29.13,15.22
彰化縣,芳苑鄉,新生村,331,142,189,8,339,1304,0,26.0,10.89
彰化縣,芳苑鄉,漢寶村,952,457,495,13,965,3159,0,30.55,14.47
彰化縣,芳苑鄉,合計,8276,3654,4622,121,8397,28593,32372,29.37,12.78
彰化縣,大城鄉,潭墘村,313,125,188,5,318,1065,0,29.86,11.74
彰化縣,大城鄉,上山村,313,189,124,8,321,1069,0,30.03,17.68
彰化縣,大城鄉,東城村,375,216,159,8,383,1296,0,29.55,16.67
彰化縣,大城鄉,西城村,222,124,98,4,226,798,0,28.32,15.54
彰化縣,大城鄉,大城村,337,198,139,4,341,929,0,36.71,21.31
彰化縣,大城鄉,菜寮村,225,132,93,6,231,1048,0,22.04,12.6
彰化縣,大城鄉,山腳村,315,167,148,3,318,1256,0,25.32,13.3
彰化縣,大城鄉,永和村,163,92,71,6,169,662,0,25.53,13.9
彰化縣,大城鄉,頂庄村,182,98,84,1,183,663,0,27.6,14.78
彰化縣,大城鄉,公館村,301,182,119,9,310,1045,0,29.67,17.42
彰化縣,大城鄉,臺西村,223,113,110,7,230,861,0,26.71,13.12
彰化縣,大城鄉,東港村,275,172,103,3,278,1164,0,23.88,14.78
彰化縣,大城鄉,西港村,236,152,84,8,244,867,0,28.14,17.53
彰化縣,大城鄉,豐美村,213,88,125,7,220,845,0,26.04,10.41
彰化縣,大城鄉,三豐村,108,63,45,7,115,626,0,18.37,10.06
彰化縣,大城鄉,合計,3801,2111,1690,86,3887,14194,15893,27.38,14.87
彰化縣,竹塘鄉,竹元村,385,202,183,5,390,1148,0,33.97,17.6
彰化縣,竹塘鄉,竹塘村,643,355,288,5,648,1936,0,33.47,18.34
彰化縣,竹塘鄉,小西村,230,108,122,7,237,699,0,33.91,15.45
彰化縣,竹塘鄉,民靖村,220,120,100,1,221,753,0,29.35,15.94
彰化縣,竹塘鄉,五庄村,464,160,304,7,471,1527,0,30.84,10.48
彰化縣,竹塘鄉,樹腳村,210,72,138,1,211,641,0,32.92,11.23
彰化縣,竹塘鄉,田頭村,325,149,176,3,328,1052,0,31.18,14.16
彰化縣,竹塘鄉,新廣村,349,138,211,3,352,1083,0,32.5,12.74
彰化縣,竹塘鄉,溪墘村,173,61,112,1,174,471,0,36.94,12.95
彰化縣,竹塘鄉,竹林村,236,102,134,2,238,785,0,30.32,12.99
彰化縣,竹塘鄉,土庫村,217,95,122,3,220,626,0,35.14,15.18
彰化縣,竹塘鄉,內新村,186,52,134,3,189,536,0,35.26,9.7
彰化縣,竹塘鄉,長安村,245,79,166,6,251,750,0,33.47,10.53
彰化縣,竹塘鄉,永安村,147,50,97,1,148,536,0,27.61,9.33
彰化縣,竹塘鄉,合計,4030,1743,2287,48,4078,12543,14669,32.51,13.9
彰化縣,溪州鄉,溪厝村,600,258,342,4,604,1828,0,33.04,14.11
彰化縣,溪州鄉,舊眉村,498,212,286,6,504,1430,0,35.24,14.83
彰化縣,溪州鄉,柑園村,299,145,154,3,302,1131,0,26.7,12.82
彰化縣,溪州鄉,水尾村,487,131,356,7,494,1499,0,32.96,8.74
彰化縣,溪州鄉,坑厝村,247,95,152,6,253,699,0,36.19,13.59
彰化縣,溪州鄉,圳寮村,464,202,262,5,469,1461,0,32.1,13.83
彰化縣,溪州鄉,潮洋村,249,113,136,5,254,813,0,31.24,13.9
彰化縣,溪州鄉,瓦厝村,364,116,248,0,364,839,0,43.38,13.83
彰化縣,溪州鄉,西畔村,572,219,353,13,585,1977,0,29.59,11.08
彰化縣,溪州鄉,張厝村,197,74,123,4,201,693,0,29.0,10.68
彰化縣,溪州鄉,溪州村,584,261,323,7,591,1516,0,38.98,17.22
彰化縣,溪州鄉,成功村,512,210,302,2,514,1799,0,28.57,11.67
彰化縣,溪州鄉,菜公村,251,101,150,6,257,831,0,30.93,12.15
彰化縣,溪州鄉,尾厝村,660,307,353,9,669,1827,0,36.62,16.8
彰化縣,溪州鄉,大庄村,546,181,365,12,558,1863,0,29.95,9.72
彰化縣,溪州鄉,三圳村,435,183,252,11,446,1255,0,35.54,14.58
彰化縣,溪州鄉,東州村,716,257,459,9,725,1915,0,37.86,13.42
彰化縣,溪州鄉,榮光村,279,152,127,8,287,850,0,33.76,17.88
彰化縣,溪州鄉,三條村,328,68,260,3,331,846,0,39.13,8.04
彰化縣,溪州鄉,合計,8288,3285,5003,120,8408,25072,28983,33.54,13.1
彰化縣,合計,合計,390449,190195,200254,4054,394503,1061571,1260388,37.16,17.92
南投縣,南投市,龍泉里,379,196,183,2,381,910,0,41.87,21.54
南投縣,南投市,康壽里,638,345,293,2,640,1370,0,46.72,25.18
南投縣,南投市,三民里,333,177,156,0,333,772,0,43.13,22.93
南投縣,南投市,仁和里,258,109,149,2,260,486,0,53.5,22.43
南投縣,南投市,南投里,262,118,144,1,263,574,0,45.82,20.56
南投縣,南投市,彰仁里,194,86,108,2,196,366,0,53.55,23.5
南投縣,南投市,崇文里,426,218,208,3,429,933,0,45.98,23.37
南投縣,南投市,漳興里,1090,553,537,8,1098,2566,0,42.79,21.55
南投縣,南投市,漳和里,2824,1560,1264,27,2851,7006,0,40.69,22.27
南投縣,南投市,軍功里,1711,945,766,14,1725,4577,0,37.69,20.65
南投縣,南投市,東山里,146,70,76,4,150,376,0,39.89,18.62
南投縣,南投市,平和里,2441,1346,1095,15,2456,6024,0,40.77,22.34
南投縣,南投市,振興里,850,367,483,11,861,2053,0,41.94,17.88
南投縣,南投市,千秋里,405,205,200,5,410,1008,0,40.67,20.34
南投縣,南投市,三興里,2211,1282,929,23,2234,5330,0,41.91,24.05
南投縣,南投市,三和里,1248,679,569,11,1259,2691,0,46.79,25.23
南投縣,南投市,嘉興里,794,334,460,5,799,2109,0,37.89,15.84
南投縣,南投市,嘉和里,1667,901,766,18,1685,4405,0,38.25,20.45
南投縣,南投市,福山里,677,361,316,7,684,1866,0,36.66,19.35
南投縣,南投市,永興里,254,118,136,7,261,779,0,33.5,15.15
南投縣,南投市,鳳鳴里,196,63,133,6,202,606,0,33.33,10.4
南投縣,南投市,鳳山里,341,121,220,4,345,1073,0,32.15,11.28
南投縣,南投市,平山里,2039,1075,964,11,2050,5387,0,38.05,19.96
南投縣,南投市,新興里,1782,971,811,14,1796,4997,0,35.94,19.43
南投縣,南投市,永豐里,1100,567,533,4,1104,2815,0,39.22,20.14
南投縣,南投市,福興里,1133,546,587,9,1142,3015,0,37.88,18.11
南投縣,南投市,營北里,3077,2119,958,27,3104,5877,0,52.82,36.06
南投縣,南投市,營南里,1074,617,457,10,1084,2381,0,45.53,25.91
南投縣,南投市,內興里,2960,1877,1083,23,2983,6642,0,44.91,28.26
南投縣,南投市,內新里,566,292,274,8,574,1402,0,40.94,20.83
南投縣,南投市,光華里,360,292,68,3,363,738,0,49.19,39.57
南投縣,南投市,光榮里,502,410,92,7,509,993,0,51.26,41.29
南投縣,南投市,光明里,468,387,81,2,470,908,0,51.76,42.62
南投縣,南投市,光輝里,287,188,99,3,290,514,0,56.42,36.58
南投縣,南投市,合計,34693,19495,15198,298,34991,83549,98736,41.88,23.33
南投縣,埔里鎮,東門里,1088,610,478,17,1105,2573,0,42.95,23.71
南投縣,埔里鎮,南門里,405,207,198,3,408,785,0,51.97,26.37
南投縣,埔里鎮,西門里,1102,600,502,6,1108,2927,0,37.85,20.5
南投縣,埔里鎮,北門里,833,509,324,5,838,2457,0,34.11,20.72
南投縣,埔里鎮,同聲里,803,471,332,14,817,2163,0,37.77,21.78
南投縣,埔里鎮,薰化里,474,274,200,1,475,997,0,47.64,27.48
南投縣,埔里鎮,清新里,1275,737,538,10,1285,3608,0,35.62,20.43
南投縣,埔里鎮,大城里,2128,1241,887,21,2149,5729,0,37.51,21.66
南投縣,埔里鎮,籃城里,401,183,218,3,404,931,0,43.39,19.66
南投縣,埔里鎮,枇杷里,2613,1591,1022,24,2637,7501,0,35.16,21.21
南投縣,埔里鎮,水頭里,1123,599,524,8,1131,3785,0,29.88,15.83
南投縣,埔里鎮,麒麟里,326,170,156,3,329,1019,0,32.29,16.68
南投縣,埔里鎮,珠格里,373,192,181,8,381,1106,0,34.45,17.36
南投縣,埔里鎮,溪南里,393,221,172,6,399,1116,0,35.75,19.8
南投縣,埔里鎮,桃米里,352,214,138,4,356,1007,0,35.35,21.25
南投縣,埔里鎮,成功里,111,57,54,0,111,298,0,37.25,19.13
南投縣,埔里鎮,南村里,412,232,180,3,415,1324,0,31.34,17.52
南投縣,埔里鎮,愛蘭里,493,298,195,3,496,1412,0,35.13,21.1
南投縣,埔里鎮,鐵山里,602,329,273,9,611,1701,0,35.92,19.34
南投縣,埔里鎮,房里里,457,267,190,2,459,1348,0,34.05,19.81
南投縣,埔里鎮,向善里,259,128,131,6,265,661,0,40.09,19.36
南投縣,埔里鎮,一新里,394,265,129,4,398,988,0,40.28,26.82
南投縣,埔里鎮,廣成里,361,210,151,5,366,1132,0,32.33,18.55
南投縣,埔里鎮,史港里,221,136,85,1,222,580,0,38.28,23.45
南投縣,埔里鎮,福興里,333,130,203,6,339,962,0,35.24,13.51
南投縣,埔里鎮,牛眠里,1009,500,509,10,1019,2818,0,36.16,17.74
南投縣,埔里鎮,大湳里,618,336,282,5,623,1661,0,37.51,20.23
南投縣,埔里鎮,蜈蚣里,866,464,402,9,875,2570,0,34.05,18.05
南投縣,埔里鎮,合成里,572,246,326,7,579,1597,0,36.26,15.4
南投縣,埔里鎮,北安里,1296,760,536,17,1313,3098,0,42.38,24.53
南投縣,埔里鎮,杷城里,1001,539,462,13,1014,2585,0,39.23,20.85
南投縣,埔里鎮,北梅里,1117,665,452,14,1131,3170,0,35.68,20.98
南投縣,埔里鎮,泰安里,858,516,342,6,864,2070,0,41.74,24.93
南投縣,埔里鎮,合計,24669,13897,10772,253,24922,67679,78732,36.82,20.53
南投縣,草屯鎮,玉峰里,901,528,373,11,912,2084,0,43.76,25.34
南投縣,草屯鎮,炎峰里,923,501,422,5,928,2059,0,45.07,24.33
南投縣,草屯鎮,和平里,508,247,261,4,512,1084,0,47.23,22.79
南投縣,草屯鎮,敦和里,2490,1369,1121,24,2514,6414,0,39.2,21.34
南投縣,草屯鎮,山腳里,3343,2029,1314,22,3365,7515,0,44.78,27.0
南投縣,草屯鎮,富寮里,2537,1308,1229,16,2553,6652,0,38.38,19.66
南投縣,草屯鎮,御史里,2390,1211,1179,25,2415,6108,0,39.54,19.83
南投縣,草屯鎮,新豐里,1594,798,796,25,1619,4032,0,40.15,19.79
南投縣,草屯鎮,碧峰里,1677,829,848,16,1693,4524,0,37.42,18.32
南投縣,草屯鎮,碧洲里,1044,615,429,4,1048,2446,0,42.85,25.14
南投縣,草屯鎮,復興里,1209,644,565,13,1222,2862,0,42.7,22.5
南投縣,草屯鎮,上林里,1427,823,604,9,1436,3175,0,45.23,25.92
南投縣,草屯鎮,新庄里,1450,788,662,9,1459,3702,0,39.41,21.29
南投縣,草屯鎮,北投里,1186,513,673,13,1199,2951,0,40.63,17.38
南投縣,草屯鎮,石川里,583,297,286,3,586,1502,0,39.01,19.77
南投縣,草屯鎮,加老里,940,423,517,4,944,2217,0,42.58,19.08
南投縣,草屯鎮,北勢里,726,335,391,9,735,1858,0,39.56,18.03
南投縣,草屯鎮,中原里,895,348,547,9,904,2029,0,44.55,17.15
南投縣,草屯鎮,南埔里,1556,726,830,4,1560,4072,0,38.31,17.83
南投縣,草屯鎮,土城里,597,354,243,6,603,1658,0,36.37,21.35
南投縣,草屯鎮,坪頂里,396,203,193,3,399,1017,0,39.23,19.96
南投縣,草屯鎮,雙冬里,692,332,360,13,705,2247,0,31.38,14.78
南投縣,草屯鎮,平林里,404,230,174,7,411,1070,0,38.41,21.5
南投縣,草屯鎮,中正里,309,165,144,3,312,664,0,46.99,24.85
南投縣,草屯鎮,中山里,1099,538,561,5,1104,2330,0,47.38,23.09
南投縣,草屯鎮,明正里,1556,841,715,15,1571,3714,0,42.3,22.64
南投縣,草屯鎮,新厝里,1424,845,579,15,1439,3215,0,44.76,26.28
南投縣,草屯鎮,合計,33856,17840,16016,292,34148,83201,97262,41.04,21.44
南投縣,竹山鎮,竹山里,848,449,399,8,856,1957,0,43.74,22.94
南投縣,竹山鎮,中正里,231,114,117,2,233,614,0,37.95,18.57
南投縣,竹山鎮,中山里,1686,870,816,13,1699,4553,0,37.32,19.11
南投縣,竹山鎮,雲林里,1330,709,621,10,1340,3463,0,38.69,20.47
南投縣,竹山鎮,硘磘里,645,326,319,7,652,1752,0,37.21,18.61
南投縣,竹山鎮,下坪里,459,253,206,13,472,1189,0,39.7,21.28
南投縣,竹山鎮,桂林里,1272,626,646,14,1286,3652,0,35.21,17.14
南投縣,竹山鎮,中和里,325,103,222,4,329,894,0,36.8,11.52
南投縣,竹山鎮,中崎里,449,231,218,6,455,1401,0,32.48,16.49
南投縣,竹山鎮,德興里,333,178,155,6,339,878,0,38.61,20.27
南投縣,竹山鎮,延平里,955,433,522,14,969,2802,0,34.58,15.45
南投縣,竹山鎮,延正里,536,255,281,7,543,1678,0,32.36,15.2
南投縣,竹山鎮,延山里,315,158,157,5,320,839,0,38.14,18.83
南投縣,竹山鎮,延和里,1718,865,853,14,1732,4860,0,35.64,17.8
南投縣,竹山鎮,山崇里,594,280,314,8,602,1818,0,33.11,15.4
南投縣,竹山鎮,社寮里,471,224,247,7,478,1312,0,36.43,17.07
南投縣,竹山鎮,中央里,377,169,208,7,384,1132,0,33.92,14.93
南投縣,竹山鎮,富州里,233,123,110,2,235,595,0,39.5,20.67
南投縣,竹山鎮,大鞍里,131,75,56,1,132,422,0,31.28,17.77
南投縣,竹山鎮,田子里,178,84,94,5,183,577,0,31.72,14.56
南投縣,竹山鎮,福興里,219,136,83,4,223,591,0,37.73,23.01
南投縣,竹山鎮,鯉魚里,214,107,107,2,216,733,0,29.47,14.6
南投縣,竹山鎮,瑞竹里,179,95,84,1,180,562,0,32.03,16.9
南投縣,竹山鎮,坪頂里,161,88,73,1,162,446,0,36.32,19.73
南投縣,竹山鎮,桶頭里,223,103,120,10,233,865,0,26.94,11.91
南投縣,竹山鎮,秀林里,262,119,143,4,266,674,0,39.47,17.66
南投縣,竹山鎮,延祥里,1319,653,666,11,1330,3551,0,37.45,18.39
南投縣,竹山鎮,竹圍里,827,428,399,11,838,2248,0,37.28,19.04
南投縣,竹山鎮,合計,16490,8254,8236,197,16687,46058,53033,36.23,17.92
南投縣,集集鎮,集集里,444,265,179,9,453,1076,0,42.1,24.63
南投縣,集集鎮,和平里,331,188,143,6,337,872,0,38.65,21.56
南投縣,集集鎮,林尾里,197,94,103,2,199,549,0,36.25,17.12
南投縣,集集鎮,田寮里,385,189,196,7,392,1141,0,34.36,16.56
南投縣,集集鎮,隘寮里,161,67,94,3,164,463,0,35.42,14.47
南投縣,集集鎮,玉映里,173,91,82,1,174,472,0,36.86,19.28
南投縣,集集鎮,吳厝里,339,202,137,7,346,877,0,39.45,23.03
南投縣,集集鎮,八張里,520,279,241,5,525,1415,0,37.1,19.72
南投縣,集集鎮,永昌里,353,172,181,4,357,943,0,37.86,18.24
南投縣,集集鎮,富山里,193,105,88,1,194,544,0,35.66,19.3
南投縣,集集鎮,廣明里,294,171,123,3,297,889,0,33.41,19.24
南投縣,集集鎮,合計,3390,1823,1567,48,3438,9241,10350,37.2,19.73
南投縣,名間鄉,南雅村,420,210,210,3,423,1008,0,41.96,20.83
南投縣,名間鄉,中正村,1320,623,697,14,1334,3391,0,39.34,18.37
南投縣,名間鄉,中山村,764,376,388,11,775,2202,0,35.2,17.08
南投縣,名間鄉,濁水村,608,281,327,6,614,1540,0,39.87,18.25
南投縣,名間鄉,炭寮村,316,137,179,6,322,978,0,32.92,14.01
南投縣,名間鄉,新民村,367,147,220,11,378,957,0,39.5,15.36
南投縣,名間鄉,新街村,1587,699,888,22,1609,4169,0,38.59,16.77
南投縣,名間鄉,東湖村,589,269,320,13,602,1625,0,37.05,16.55
南投縣,名間鄉,萬丹村,365,141,224,7,372,922,0,40.35,15.29
南投縣,名間鄉,田仔村,438,181,257,1,439,1233,0,35.6,14.68
南投縣,名間鄉,大庄村,711,238,473,13,724,1828,0,39.61,13.02
南投縣,名間鄉,廍下村,308,108,200,2,310,900,0,34.44,12.0
南投縣,名間鄉,大坑村,251,88,163,0,251,729,0,34.43,12.07
南投縣,名間鄉,竹圍村,344,132,212,4,348,911,0,38.2,14.49
南投縣,名間鄉,赤水村,456,190,266,4,460,1160,0,39.66,16.38
南投縣,名間鄉,三崙村,533,220,313,6,539,1538,0,35.05,14.3
南投縣,名間鄉,松山村,571,234,337,5,576,1468,0,39.24,15.94
南投縣,名間鄉,松柏村,420,172,248,6,426,1137,0,37.47,15.13
南投縣,名間鄉,埔中村,325,131,194,3,328,845,0,38.82,15.5
南投縣,名間鄉,崁腳村,317,198,119,4,321,874,0,36.73,22.65
南投縣,名間鄉,新厝村,294,156,138,9,303,739,0,41.0,21.11
南投縣,名間鄉,新光村,611,278,333,7,618,1737,0,35.58,16.0
南投縣,名間鄉,仁和村,333,190,143,3,336,867,0,38.75,21.91
南投縣,名間鄉,合計,12248,5399,6849,160,12408,32758,37230,37.88,16.48
南投縣,鹿谷鄉,鹿谷村,658,339,319,5,663,1813,0,36.57,18.7
南投縣,鹿谷鄉,初鄉村,489,276,213,9,498,1402,0,35.52,19.69
南投縣,鹿谷鄉,彰雅村,465,284,181,5,470,1294,0,36.32,21.95
南投縣,鹿谷鄉,廣興村,688,402,286,6,694,1909,0,36.35,21.06
南投縣,鹿谷鄉,內湖村,327,187,140,9,336,997,0,33.7,18.76
南投縣,鹿谷鄉,竹林村,464,255,209,6,470,1463,0,32.13,17.43
南投縣,鹿谷鄉,竹豐村,329,200,129,4,333,902,0,36.92,22.17
南投縣,鹿谷鄉,和雅村,221,154,67,4,225,620,0,36.29,24.84
南投縣,鹿谷鄉,鳳凰村,463,220,243,3,466,1309,0,35.6,16.81
南投縣,鹿谷鄉,永隆村,546,298,248,6,552,1562,0,35.34,19.08
南投縣,鹿谷鄉,秀峰村,214,93,121,6,220,747,0,29.45,12.45
南投縣,鹿谷鄉,清水村,255,125,130,2,257,689,0,37.3,18.14
南投縣,鹿谷鄉,瑞田村,198,82,116,3,201,710,0,28.31,11.55
南投縣,鹿谷鄉,合計,5317,2915,2402,68,5385,15417,16983,34.93,18.91
南投縣,中寮鄉,廣興村,260,99,161,2,262,773,0,33.89,12.81
南投縣,中寮鄉,崁頂村,169,94,75,5,174,470,0,37.02,20.0
南投縣,中寮鄉,八仙村,268,136,132,2,270,773,0,34.93,17.59
南投縣,中寮鄉,和興村,196,96,100,3,199,639,0,31.14,15.02
南投縣,中寮鄉,福盛村,219,116,103,4,223,683,0,32.65,16.98
南投縣,中寮鄉,永平村,543,285,258,10,553,1678,0,32.96,16.98
南投縣,中寮鄉,復興村,103,52,51,1,104,287,0,36.24,18.12
南投縣,中寮鄉,中寮村,217,129,88,2,219,624,0,35.1,20.67
南投縣,中寮鄉,廣福村,151,57,94,2,153,491,0,31.16,11.61
南投縣,中寮鄉,永福村,418,246,172,7,425,1319,0,32.22,18.65
南投縣,中寮鄉,義和村,368,174,194,5,373,1049,0,35.56,16.59
南投縣,中寮鄉,清水村,239,115,124,11,250,847,0,29.52,13.58
南投縣,中寮鄉,龍安村,234,86,148,6,240,666,0,36.04,12.91
南投縣,中寮鄉,龍岩村,221,108,113,2,223,637,0,35.01,16.95
南投縣,中寮鄉,永和村,169,88,81,4,173,499,0,34.67,17.64
南投縣,中寮鄉,內城村,164,81,83,1,165,454,0,36.34,17.84
南投縣,中寮鄉,永芳村,148,73,75,6,154,454,0,33.92,16.08
南投縣,中寮鄉,爽文村,177,87,90,0,177,477,0,37.11,18.24
南投縣,中寮鄉,合計,4264,2122,2142,73,4337,12820,14137,33.83,16.55
南投縣,魚池鄉,東池村,543,295,248,7,550,1550,0,35.48,19.03
南投縣,魚池鄉,魚池村,664,355,309,6,670,1908,0,35.12,18.61
南投縣,魚池鄉,中明村,306,143,163,5,311,994,0,31.29,14.39
南投縣,魚池鄉,新城村,451,216,235,4,455,1333,0,34.13,16.2
南投縣,魚池鄉,大林村,341,148,193,8,349,1061,0,32.89,13.95
南投縣,魚池鄉,東光村,333,170,163,2,335,1242,0,26.97,13.69
南投縣,魚池鄉,共和村,154,65,89,1,155,501,0,30.94,12.97
南投縣,魚池鄉,大雁村,204,103,101,3,207,625,0,33.12,16.48
南投縣,魚池鄉,五城村,232,123,109,3,235,718,0,32.73,17.13
南投縣,魚池鄉,水社村,302,209,93,0,302,823,0,36.7,25.39
南投縣,魚池鄉,頭社村,256,120,136,5,261,917,0,28.46,13.09
南投縣,魚池鄉,武登村,187,118,69,4,191,574,0,33.28,20.56
南投縣,魚池鄉,日月村,308,162,146,3,311,849,0,36.63,19.08
南投縣,魚池鄉,新城村、共和村,190,97,93,2,192,541,0,35.49,17.93
南投縣,魚池鄉,合計,4471,2324,2147,53,4524,13636,15251,33.18,17.04
南投縣,國姓鄉,國姓村,545,268,277,17,562,1641,0,34.25,16.33
南投縣,國姓鄉,石門村,551,335,216,9,560,1676,0,33.41,19.99
南投縣,國姓鄉,大旗村,183,91,92,3,186,641,0,29.02,14.2
南投縣,國姓鄉,北港村,529,242,287,3,532,1823,0,29.18,13.27
南投縣,國姓鄉,長流村,368,230,138,7,375,1346,0,27.86,17.09
南投縣,國姓鄉,長福村,218,124,94,0,218,688,0,31.69,18.02
南投縣,國姓鄉,福龜村,605,346,259,10,615,1766,0,34.82,19.59
南投縣,國姓鄉,乾溝村,249,136,113,7,256,789,0,32.45,17.24
南投縣,國姓鄉,柑林村,367,231,136,5,372,1117,0,33.3,20.68
南投縣,國姓鄉,北山村,499,254,245,10,509,1459,0,34.89,17.41
南投縣,國姓鄉,南港村,475,303,172,11,486,1547,0,31.42,19.59
南投縣,國姓鄉,大石村,208,117,91,2,210,691,0,30.39,16.93
南投縣,國姓鄉,長豐村,182,124,58,3,185,730,0,25.34,16.99
南投縣,國姓鄉,合計,4979,2801,2178,87,5066,15914,17685,31.83,17.6
南投縣,水里鄉,水里村,219,122,97,2,221,726,0,30.44,16.8
南投縣,水里鄉,農富村,186,90,96,1,187,420,0,44.52,21.43
南投縣,水里鄉,新城村,450,227,223,4,454,1475,0,30.78,15.39
南投縣,水里鄉,中央村,232,149,83,3,235,596,0,39.43,25.0
南投縣,水里鄉,城中村,342,208,134,3,345,839,0,41.12,24.79
南投縣,水里鄉,北埔村,366,215,151,4,370,1004,0,36.85,21.41
南投縣,水里鄉,鉅工村,366,205,161,1,367,922,0,39.8,22.23
南投縣,水里鄉,永豐村,429,230,199,13,442,1346,0,32.84,17.09
南投縣,水里鄉,頂崁村,377,191,186,4,381,1172,0,32.51,16.3
南投縣,水里鄉,車埕村,163,100,63,6,169,436,0,38.76,22.94
南投縣,水里鄉,新興村,155,105,50,3,158,621,0,25.44,16.91
南投縣,水里鄉,新山村,73,36,37,0,73,203,0,35.96,17.73
南投縣,水里鄉,郡坑村,127,83,44,1,128,318,0,40.25,26.1
南投縣,水里鄉,上安村,345,211,134,5,350,1065,0,32.86,19.81
南投縣,水里鄉,民和村,248,112,136,5,253,841,0,30.08,13.32
南投縣,水里鄉,永興村,124,50,74,3,127,313,0,40.58,15.97
南投縣,水里鄉,玉峰村,252,106,146,2,254,813,0,31.24,13.04
南投縣,水里鄉,興隆村,96,53,43,1,97,278,0,34.89,19.06
南投縣,水里鄉,南光村,515,291,224,2,517,1527,0,33.86,19.06
南投縣,水里鄉,合計,5065,2784,2281,63,5128,14915,16810,34.38,18.67
南投縣,信義鄉,人和村,225,173,52,7,232,1166,0,19.9,14.84
南投縣,信義鄉,地利村,256,210,46,2,258,920,0,28.04,22.83
南投縣,信義鄉,潭南村,123,107,16,2,125,558,0,22.4,19.18
南投縣,信義鄉,明德村,506,345,161,3,509,1469,0,34.65,23.49
南投縣,信義鄉,愛國村,139,79,60,1,140,481,0,29.11,16.42
南投縣,信義鄉,自強村,208,104,104,6,214,713,0,30.01,14.59
南投縣,信義鄉,羅娜村,338,246,92,4,342,1338,0,25.56,18.39
南投縣,信義鄉,望美村,327,203,124,3,330,1516,0,21.77,13.39
南投縣,信義鄉,同富村,410,218,192,7,417,1399,0,29.81,15.58
南投縣,信義鄉,神木村,162,94,68,3,165,629,0,26.23,14.94
南投縣,信義鄉,東埔村,218,144,74,2,220,988,0,22.27,14.57
南投縣,信義鄉,雙龍村,78,58,20,1,79,610,0,12.95,9.51
南投縣,信義鄉,新鄉村,149,112,37,2,151,587,0,25.72,19.08
南投縣,信義鄉,豐丘村,158,80,78,1,159,628,0,25.32,12.74
南投縣,信義鄉,合計,3297,2173,1124,44,3341,13002,15798,25.7,16.71
南投縣,仁愛鄉,法治村,168,127,41,3,171,801,0,21.35,15.86
南投縣,仁愛鄉,中正村,214,182,32,2,216,907,0,23.81,20.07
南投縣,仁愛鄉,互助村,352,311,41,6,358,1143,0,31.32,27.21
南投縣,仁愛鄉,新生村,163,145,18,0,163,398,0,40.95,36.43
南投縣,仁愛鄉,力行村,98,78,20,2,100,504,0,19.84,15.48
南投縣,仁愛鄉,發祥村,141,117,24,2,143,749,0,19.09,15.62
南投縣,仁愛鄉,親愛村,247,205,42,3,250,1118,0,22.36,18.34
南投縣,仁愛鄉,大同村,545,416,129,3,548,1616,0,33.91,25.74
南投縣,仁愛鄉,南豐村,378,288,90,3,381,1223,0,31.15,23.55
南投縣,仁愛鄉,春陽村,241,200,41,2,243,955,0,25.45,20.94
南投縣,仁愛鄉,精英村,166,113,53,1,167,647,0,25.81,17.47
南投縣,仁愛鄉,萬豐村,110,80,30,1,111,633,0,17.54,12.64
南投縣,仁愛鄉,榮興村,22,21,1,0,22,55,0,40.0,38.18
南投縣,仁愛鄉,翠華村,106,76,30,2,108,507,0,21.3,14.99
南投縣,仁愛鄉,都達村,110,99,11,3,113,627,0,18.02,15.79
南投縣,仁愛鄉,德鹿谷村,93,75,18,0,93,614,0,15.15,12.21
南投縣,仁愛鄉,合計,3154,2533,621,33,3187,12497,15736,25.5,20.27
南投縣,合計,合計,155893,84360,71533,1669,157562,420687,487743,37.45,20.05
雲林縣,斗六市,忠孝里,629,330,299,6,635,1390,0,45.68,23.74
雲林縣,斗六市,仁愛里,478,219,259,3,481,1065,0,45.16,20.56
雲林縣,斗六市,信義里,307,145,162,2,309,609,0,50.74,23.81
雲林縣,斗六市,四維里,274,128,146,7,281,599,0,46.91,21.37
雲林縣,斗六市,太平里,340,187,153,1,341,756,0,45.11,24.74
雲林縣,斗六市,中和里,342,146,196,1,343,767,0,44.72,19.04
雲林縣,斗六市,光興里,309,155,154,5,314,707,0,44.41,21.92
雲林縣,斗六市,三平里,1993,1131,862,17,2010,4843,0,41.5,23.35
雲林縣,斗六市,八德里,1248,658,590,18,1266,3154,0,40.14,20.86
雲林縣,斗六市,鎮北里,1162,646,516,12,1174,2723,0,43.11,23.72
雲林縣,斗六市,龍潭里,772,413,359,7,779,1734,0,44.93,23.82
雲林縣,斗六市,鎮南里,1510,855,655,7,1517,3444,0,44.05,24.83
雲林縣,斗六市,林頭里,1569,837,732,13,1582,4187,0,37.78,19.99
雲林縣,斗六市,重光里,822,353,469,5,827,2303,0,35.91,15.33
雲林縣,斗六市,溝埧里,303,186,117,3,306,657,0,46.58,28.31
雲林縣,斗六市,江厝里,806,406,400,7,813,2185,0,37.21,18.58
雲林縣,斗六市,三光里,210,88,122,3,213,538,0,39.59,16.36
雲林縣,斗六市,崙峯里,986,597,389,7,993,2450,0,40.53,24.37
雲林縣,斗六市,嘉東里,572,265,307,6,578,1451,0,39.83,18.26
雲林縣,斗六市,久安里,979,545,434,12,991,2391,0,41.45,22.79
雲林縣,斗六市,長平里,729,333,396,13,742,1873,0,39.62,17.78
雲林縣,斗六市,保庄里,2273,1179,1094,14,2287,5409,0,42.28,21.8
雲林縣,斗六市,虎溪里,1245,609,636,8,1253,3399,0,36.86,17.92
雲林縣,斗六市,梅林里,712,325,387,13,725,1849,0,39.21,17.58
雲林縣,斗六市,湖山里,416,174,242,2,418,1112,0,37.59,15.65
雲林縣,斗六市,榴中里,1685,821,864,19,1704,4461,0,38.2,18.4
雲林縣,斗六市,榴北里,376,165,211,4,380,1076,0,35.32,15.33
雲林縣,斗六市,榴南里,689,337,352,9,698,2144,0,32.56,15.72
雲林縣,斗六市,溪洲里,1185,598,587,11,1196,3219,0,37.15,18.58
雲林縣,斗六市,長安里,1113,510,603,9,1122,3070,0,36.55,16.61
雲林縣,斗六市,十三里,425,134,291,6,431,1106,0,38.97,12.12
雲林縣,斗六市,鎮東里,1032,590,442,0,1032,2279,0,45.28,25.89
雲林縣,斗六市,鎮西里,1439,732,707,7,1446,3722,0,38.85,19.67
雲林縣,斗六市,公正里,1159,646,513,12,1171,2734,0,42.83,23.63
雲林縣,斗六市,社口里,956,519,437,12,968,2247,0,43.08,23.1
雲林縣,斗六市,公誠里,863,480,383,4,867,2111,0,41.07,22.74
雲林縣,斗六市,明德里,1486,767,719,11,1497,3620,0,41.35,21.19
雲林縣,斗六市,成功里,1184,621,563,7,1191,2596,0,45.88,23.92
雲林縣,斗六市,文化里,965,555,410,5,970,2294,0,42.28,24.19
雲林縣,斗六市,正心里,824,454,370,3,827,1970,0,41.98,23.05
雲林縣,斗六市,合計,36367,18839,17528,311,36678,90244,108508,40.64,20.88
雲林縣,斗南鎮,東仁里,507,238,269,6,513,1125,0,45.6,21.16
雲林縣,斗南鎮,西岐里,888,452,436,5,893,2068,0,43.18,21.86
雲林縣,斗南鎮,南昌里,812,355,457,14,826,2193,0,37.67,16.19
雲林縣,斗南鎮,北銘里,613,317,296,5,618,1430,0,43.22,22.17
雲林縣,斗南鎮,中天里,497,213,284,4,501,1217,0,41.17,17.5
雲林縣,斗南鎮,舊社里,1015,450,565,6,1021,2651,0,38.51,16.97
雲林縣,斗南鎮,林子里,503,209,294,6,509,1321,0,38.53,15.82
雲林縣,斗南鎮,石龜里,317,136,181,4,321,738,0,43.5,18.43
雲林縣,斗南鎮,靖興里,284,133,151,2,286,860,0,33.26,15.47
雲林縣,斗南鎮,新南里,261,112,149,5,266,705,0,37.73,15.89
雲林縣,斗南鎮,阿丹里,386,168,218,7,393,1113,0,35.31,15.09
雲林縣,斗南鎮,將軍里,624,253,371,6,630,1683,0,37.43,15.03
雲林縣,斗南鎮,東明里,384,157,227,5,389,970,0,40.1,16.19
雲林縣,斗南鎮,新光里,1051,411,640,12,1063,2768,0,38.4,14.85
雲林縣,斗南鎮,田頭里,796,344,452,7,803,2175,0,36.92,15.82
雲林縣,斗南鎮,明昌里,1289,633,656,12,1301,3315,0,39.25,19.1
雲林縣,斗南鎮,大東里,319,149,170,6,325,854,0,38.06,17.45
雲林縣,斗南鎮,埤麻里,304,155,149,6,310,792,0,39.14,19.57
雲林縣,斗南鎮,西伯里,310,167,143,2,312,823,0,37.91,20.29
雲林縣,斗南鎮,新崙里,525,218,307,5,530,1470,0,36.05,14.83
雲林縣,斗南鎮,小東里,559,178,381,10,569,1433,0,39.71,12.42
雲林縣,斗南鎮,石溪里,330,136,194,7,337,851,0,39.6,15.98
雲林縣,斗南鎮,大同里,1138,589,549,8,1146,2831,0,40.48,20.81
雲林縣,斗南鎮,僑真里,835,403,432,5,840,2236,0,37.57,18.02
雲林縣,斗南鎮,合計,14547,6576,7971,155,14702,37622,43841,39.08,17.48
雲林縣,虎尾鎮,中山里,366,180,186,2,368,914,0,40.26,19.69
雲林縣,虎尾鎮,新興里,648,339,309,2,650,1655,0,39.27,20.48
雲林縣,虎尾鎮,東仁里,1018,532,486,10,1028,2525,0,40.71,21.07
雲林縣,虎尾鎮,公安里,1183,624,559,8,1191,2771,0,42.98,22.52
雲林縣,虎尾鎮,德興里,940,539,401,10,950,2473,0,38.41,21.8
雲林縣,虎尾鎮,西安里,1190,657,533,5,1195,3168,0,37.72,20.74
雲林縣,虎尾鎮,安慶里,614,329,285,3,617,1361,0,45.33,24.17
雲林縣,虎尾鎮,平和里,1623,850,773,9,1632,4499,0,36.27,18.89
雲林縣,虎尾鎮,興南里,870,447,423,9,879,2323,0,37.84,19.24
雲林縣,虎尾鎮,新吉里,1444,702,742,13,1457,3807,0,38.27,18.44
雲林縣,虎尾鎮,穎川里,776,402,374,5,781,2017,0,38.72,19.93
雲林縣,虎尾鎮,延平里,417,212,205,4,421,1123,0,37.49,18.88
雲林縣,虎尾鎮,三合里,476,243,233,6,482,1313,0,36.71,18.51
雲林縣,虎尾鎮,北溪里,298,142,156,5,303,828,0,36.59,17.15
雲林縣,虎尾鎮,墾地里,580,244,336,8,588,1952,0,30.12,12.5
雲林縣,虎尾鎮,西屯里,506,205,301,2,508,1478,0,34.37,13.87
雲林縣,虎尾鎮,芳草里,261,80,181,2,263,872,0,30.16,9.17
雲林縣,虎尾鎮,埒內里,930,368,562,8,938,2607,0,35.98,14.12
雲林縣,虎尾鎮,堀頭里,297,154,143,4,301,844,0,35.66,18.25
雲林縣,虎尾鎮,安溪里,578,247,331,13,591,1767,0,33.45,13.98
雲林縣,虎尾鎮,興中里,585,287,298,9,594,1633,0,36.37,17.58
雲林縣,虎尾鎮,廉使里,1198,500,698,6,1204,3437,0,35.03,14.55
雲林縣,虎尾鎮,惠來里,754,333,421,19,773,2304,0,33.55,14.45
雲林縣,虎尾鎮,頂溪里,826,334,492,11,837,2528,0,33.11,13.21
雲林縣,虎尾鎮,中溪里,486,215,271,1,487,1339,0,36.37,16.06
雲林縣,虎尾鎮,下溪里,547,268,279,7,554,1501,0,36.91,17.85
雲林縣,虎尾鎮,建國里,165,92,73,3,168,515,0,32.62,17.86
雲林縣,虎尾鎮,立仁里,1397,788,609,3,1400,3651,0,38.35,21.58
雲林縣,虎尾鎮,東屯里,378,173,205,4,382,1211,0,31.54,14.29
雲林縣,虎尾鎮,合計,21351,10486,10865,191,21542,58416,70772,36.88,17.95
雲林縣,西螺鎮,振興里,534,169,365,4,538,1509,0,35.65,11.2
雲林縣,西螺鎮,大園里,655,272,383,7,662,1720,0,38.49,15.81
雲林縣,西螺鎮,廣福里,752,372,380,6,758,2061,0,36.78,18.05
雲林縣,西螺鎮,正興里,1110,490,620,7,1117,2893,0,38.61,16.94
雲林縣,西螺鎮,永安里,151,53,98,0,151,325,0,46.46,16.31
雲林縣,西螺鎮,中和里,236,96,140,0,236,549,0,42.99,17.49
雲林縣,西螺鎮,福興里,225,88,137,1,226,568,0,39.79,15.49
雲林縣,西螺鎮,光華里,374,157,217,5,379,1004,0,37.75,15.64
雲林縣,西螺鎮,中興里,1067,444,623,7,1074,2870,0,37.42,15.47
雲林縣,西螺鎮,漢光里,1597,593,1004,13,1610,4547,0,35.41,13.04
雲林縣,西螺鎮,新安里,458,107,351,5,463,1277,0,36.26,8.38
雲林縣,西螺鎮,新豐里,525,150,375,8,533,1475,0,36.14,10.17
雲林縣,西螺鎮,詔安里,372,151,221,8,380,972,0,39.09,15.53
雲林縣,西螺鎮,河南里,344,119,225,4,348,1105,0,31.49,10.77
雲林縣,西螺鎮,安定里,552,160,392,4,556,1776,0,31.31,9.01
雲林縣,西螺鎮,福田里,503,135,368,11,514,1499,0,34.29,9.01
雲林縣,西螺鎮,大新里,564,176,388,4,568,1573,0,36.11,11.19
雲林縣,西螺鎮,埤頭里,320,88,232,6,326,872,0,37.39,10.09
雲林縣,西螺鎮,東興里,389,87,302,4,393,935,0,42.03,9.3
雲林縣,西螺鎮,廣興里,327,149,178,4,331,854,0,38.76,17.45
雲林縣,西螺鎮,鹿場里,528,151,377,4,532,1477,0,36.02,10.22
雲林縣,西螺鎮,頂湳里,381,111,270,8,389,963,0,40.39,11.53
雲林縣,西螺鎮,下湳里,243,134,109,3,246,809,0,30.41,16.56
雲林縣,西螺鎮,九隆里,276,83,193,4,280,727,0,38.51,11.42
雲林縣,西螺鎮,吳厝里,386,127,259,2,388,1287,0,30.15,9.87
雲林縣,西螺鎮,七座里,310,96,214,5,315,862,0,36.54,11.14
雲林縣,西螺鎮,公舘里,459,142,317,7,466,1346,0,34.62,10.55
雲林縣,西螺鎮,合計,13638,4900,8738,141,13779,37855,45246,36.4,12.94
雲林縣,土庫鎮,忠正里,316,137,179,4,320,765,0,41.83,17.91
雲林縣,土庫鎮,順天里,329,142,187,2,331,868,0,38.13,16.36
雲林縣,土庫鎮,宮北里,568,262,306,5,573,1345,0,42.6,19.48
雲林縣,土庫鎮,越港里,451,237,214,0,451,1052,0,42.87,22.53
雲林縣,土庫鎮,溪邊里,337,138,199,7,344,1083,0,31.76,12.74
雲林縣,土庫鎮,興新里,497,201,296,5,502,1401,0,35.83,14.35
雲林縣,土庫鎮,奮起里,400,172,228,10,410,1267,0,32.36,13.58
雲林縣,土庫鎮,埤腳里,419,183,236,6,425,1221,0,34.81,14.99
雲林縣,土庫鎮,大荖里,311,125,186,4,315,854,0,36.89,14.64
雲林縣,土庫鎮,石廟里,907,423,484,13,920,2844,0,32.35,14.87
雲林縣,土庫鎮,東平里,634,208,426,12,646,1845,0,35.01,11.27
雲林縣,土庫鎮,南平里,609,264,345,12,621,1750,0,35.49,15.09
雲林縣,土庫鎮,北平里,282,93,189,5,287,830,0,34.58,11.2
雲林縣,土庫鎮,西平里,573,212,361,9,582,1773,0,32.83,11.96
雲林縣,土庫鎮,後埔里,682,280,402,7,689,2272,0,30.33,12.32
雲林縣,土庫鎮,崙內里,439,180,259,7,446,1501,0,29.71,11.99
雲林縣,土庫鎮,新庄里,453,169,284,8,461,1425,0,32.35,11.86
雲林縣,土庫鎮,合計,8207,3426,4781,116,8323,24096,28137,34.54,14.22
雲林縣,北港鎮,東陽里,310,102,208,3,313,692,0,45.23,14.74
雲林縣,北港鎮,光民里,276,82,194,2,278,655,0,42.44,12.52
雲林縣,北港鎮,東華里,180,81,99,2,182,437,0,41.65,18.54
雲林縣,北港鎮,南安里,373,135,238,6,379,831,0,45.61,16.25
雲林縣,北港鎮,中和里,147,49,98,2,149,329,0,45.29,14.89
雲林縣,北港鎮,義民里,155,68,87,2,157,385,0,40.78,17.66
雲林縣,北港鎮,共榮里,152,44,108,2,154,355,0,43.38,12.39
雲林縣,北港鎮,西勢里,368,140,228,2,370,907,0,40.79,15.44
雲林縣,北港鎮,仁和里,200,81,119,2,202,469,0,43.07,17.27
雲林縣,北港鎮,賜福里,143,58,85,1,144,312,0,46.15,18.59
雲林縣,北港鎮,公舘里,206,87,119,0,206,525,0,39.24,16.57
雲林縣,北港鎮,大同里,436,158,278,4,440,1132,0,38.87,13.96
雲林縣,北港鎮,仁安里,204,100,104,3,207,425,0,48.71,23.53
雲林縣,北港鎮,華勝里,1910,757,1153,23,1933,4762,0,40.59,15.9
雲林縣,北港鎮,光復里,631,309,322,4,635,1679,0,37.82,18.4
雲林縣,北港鎮,新街里,2357,1042,1315,21,2378,6248,0,38.06,16.68
雲林縣,北港鎮,劉厝里,400,121,279,3,403,1122,0,35.92,10.78
雲林縣,北港鎮,府番里,232,105,127,3,235,794,0,29.6,13.22
雲林縣,北港鎮,草湖里,393,107,286,8,401,1344,0,29.84,7.96
雲林縣,北港鎮,溝皂里,384,119,265,4,388,1120,0,34.64,10.63
雲林縣,北港鎮,後溝里,338,100,238,5,343,969,0,35.4,10.32
雲林縣,北港鎮,番溝里,229,68,161,8,237,760,0,31.18,8.95
雲林縣,北港鎮,大北里,173,48,125,4,177,537,0,32.96,8.94
雲林縣,北港鎮,好收里,534,185,349,9,543,1571,0,34.56,11.78
雲林縣,北港鎮,樹腳里,1113,411,702,5,1118,2928,0,38.18,14.04
雲林縣,北港鎮,扶朝里,418,72,346,3,421,958,0,43.95,7.52
雲林縣,北港鎮,水埔里,153,49,104,0,153,470,0,32.55,10.43
雲林縣,北港鎮,新厝里,131,47,84,2,133,380,0,35.0,12.37
雲林縣,北港鎮,合計,12546,4725,7821,133,12679,33096,38748,38.31,14.28
雲林縣,古坑鄉,水碓村,432,206,226,4,436,1190,0,36.64,17.31
雲林縣,古坑鄉,田心村,416,230,186,5,421,1080,0,38.98,21.3
雲林縣,古坑鄉,高林村,399,146,253,5,404,1106,0,36.53,13.2
雲林縣,古坑鄉,荷苞村,490,230,260,9,499,1397,0,35.72,16.46
雲林縣,古坑鄉,東和村,1046,459,587,12,1058,3146,0,33.63,14.59
雲林縣,古坑鄉,新庄村,582,212,370,11,593,1472,0,40.29,14.4
雲林縣,古坑鄉,棋盤村,692,249,443,17,709,2048,0,34.62,12.16
雲林縣,古坑鄉,華山村,217,84,133,1,218,708,0,30.79,11.86
雲林縣,古坑鄉,華南村,105,30,75,0,105,278,0,37.77,10.79
雲林縣,古坑鄉,永光村,684,300,384,9,693,2109,0,32.86,14.22
雲林縣,古坑鄉,桂林村,342,104,238,2,344,1061,0,32.42,9.8
雲林縣,古坑鄉,崁腳村,358,177,181,8,366,1155,0,31.69,15.32
雲林縣,古坑鄉,樟湖村,104,46,58,1,105,429,0,24.48,10.72
雲林縣,古坑鄉,草嶺村,198,82,116,1,199,543,0,36.65,15.1
雲林縣,古坑鄉,永昌村,746,331,415,14,760,2065,0,36.8,16.03
雲林縣,古坑鄉,麻園村,326,118,208,9,335,761,0,44.02,15.51
雲林縣,古坑鄉,古坑村,781,381,400,7,788,2241,0,35.16,17.0
雲林縣,古坑鄉,朝陽村,763,375,388,12,775,2080,0,37.26,18.03
雲林縣,古坑鄉,西平村,579,264,315,5,584,1501,0,38.91,17.59
雲林縣,古坑鄉,湳仔村,247,113,134,4,251,672,0,37.35,16.82
雲林縣,古坑鄉,合計,9507,4137,5370,136,9643,27042,30632,35.66,15.3
雲林縣,大埤鄉,北和村,289,122,167,2,291,737,0,39.48,16.55
雲林縣,大埤鄉,南和村,805,302,503,12,817,2148,0,38.04,14.06
雲林縣,大埤鄉,大德村,350,164,186,5,355,959,0,37.02,17.1
雲林縣,大埤鄉,松竹村,327,90,237,3,330,908,0,36.34,9.91
雲林縣,大埤鄉,尚義村,661,249,412,15,676,1893,0,35.71,13.15
雲林縣,大埤鄉,嘉興村,674,286,388,7,681,1830,0,37.21,15.63
雲林縣,大埤鄉,豐田村,577,244,333,8,585,1532,0,38.19,15.93
雲林縣,大埤鄉,三結村,384,136,248,6,390,1179,0,33.08,11.54
雲林縣,大埤鄉,吉田村,237,79,158,6,243,716,0,33.94,11.03
雲林縣,大埤鄉,豐岡村,198,98,100,2,200,583,0,34.31,16.81
雲林縣,大埤鄉,聯美村,324,133,191,5,329,1045,0,31.48,12.73
雲林縣,大埤鄉,怡然村,273,124,149,3,276,743,0,37.15,16.69
雲林縣,大埤鄉,北鎮村,244,85,159,4,248,670,0,37.01,12.69
雲林縣,大埤鄉,興安村,237,90,147,2,239,669,0,35.72,13.45
雲林縣,大埤鄉,西鎮村,220,86,134,5,225,701,0,32.1,12.27
雲林縣,大埤鄉,合計,5800,2288,3512,85,5885,16313,18555,36.08,14.03
雲林縣,莿桐鄉,莿桐村,1672,550,1122,15,1687,4116,0,40.99,13.36
雲林縣,莿桐鄉,甘厝村,332,101,231,7,339,864,0,39.24,11.69
雲林縣,莿桐鄉,甘西村,590,169,421,6,596,1530,0,38.95,11.05
雲林縣,莿桐鄉,興桐村,500,183,317,7,507,1177,0,43.08,15.55
雲林縣,莿桐鄉,義和村,377,118,259,6,383,1068,0,35.86,11.05
雲林縣,莿桐鄉,埔子村,746,260,486,12,758,2015,0,37.62,12.9
雲林縣,莿桐鄉,大美村,1189,516,673,10,1199,3053,0,39.27,16.9
雲林縣,莿桐鄉,埔尾村,523,206,317,7,530,1250,0,42.4,16.48
雲林縣,莿桐鄉,饒平村,396,155,241,5,401,1135,0,35.33,13.66
雲林縣,莿桐鄉,興貴村,687,266,421,10,697,1882,0,37.04,14.13
雲林縣,莿桐鄉,四合村,626,262,364,9,635,1725,0,36.81,15.19
雲林縣,莿桐鄉,麻園村,497,207,290,11,508,1453,0,34.96,14.25
雲林縣,莿桐鄉,五華村,468,158,310,4,472,1313,0,35.95,12.03
雲林縣,莿桐鄉,六合村,675,265,410,13,688,1767,0,38.94,15.0
雲林縣,莿桐鄉,合計,9278,3416,5862,122,9400,24348,28143,38.61,14.03
雲林縣,林內鄉,林南村,359,165,194,5,364,1004,0,36.25,16.43
雲林縣,林內鄉,林中村,1292,591,701,21,1313,3548,0,37.01,16.66
雲林縣,林內鄉,林北村,762,315,447,11,773,2097,0,36.86,15.02
雲林縣,林內鄉,坪頂村,173,91,82,2,175,505,0,34.65,18.02
雲林縣,林內鄉,林茂村,289,137,152,3,292,802,0,36.41,17.08
雲林縣,林內鄉,九芎村,828,367,461,12,840,2594,0,32.38,14.15
雲林縣,林內鄉,湖本村,227,90,137,1,228,627,0,36.36,14.35
雲林縣,林內鄉,烏塗村,380,183,197,11,391,1115,0,35.07,16.41
雲林縣,林內鄉,烏麻村,344,188,156,5,349,1016,0,34.35,18.5
雲林縣,林內鄉,重興村,641,226,415,7,648,1798,0,36.04,12.57
雲林縣,林內鄉,合計,5295,2353,2942,78,5373,15106,17408,35.57,15.58
雲林縣,二崙鄉,崙東村,528,212,316,4,532,1442,0,36.89,14.7
雲林縣,二崙鄉,崙西村,627,256,371,6,633,1698,0,37.28,15.08
雲林縣,二崙鄉,來惠村,523,174,349,7,530,1596,0,33.21,10.9
雲林縣,二崙鄉,三和村,503,159,344,11,514,1474,0,34.87,10.79
雲林縣,二崙鄉,湳仔村,411,185,226,7,418,1126,0,37.12,16.43
雲林縣,二崙鄉,田尾村,646,221,425,5,651,1839,0,35.4,12.02
雲林縣,二崙鄉,定安村,302,95,207,5,307,861,0,35.66,11.03
雲林縣,二崙鄉,大華村,343,94,249,1,344,873,0,39.4,10.77
雲林縣,二崙鄉,義庄村,281,57,224,2,283,748,0,37.83,7.62
雲林縣,二崙鄉,楊賢村,455,117,338,8,463,1464,0,31.63,7.99
雲林縣,二崙鄉,港後村,615,172,443,10,625,1782,0,35.07,9.65
雲林縣,二崙鄉,大義村,273,81,192,3,276,821,0,33.62,9.87
雲林縣,二崙鄉,油車村,651,224,427,7,658,1719,0,38.28,13.03
雲林縣,二崙鄉,大庄村,405,124,281,10,415,1223,0,33.93,10.14
雲林縣,二崙鄉,庄西村,231,69,162,1,232,907,0,25.58,7.61
雲林縣,二崙鄉,大同村,279,84,195,4,283,824,0,34.34,10.19
雲林縣,二崙鄉,復興村,267,91,176,1,268,983,0,27.26,9.26
雲林縣,二崙鄉,永定村,560,169,391,4,564,1406,0,40.11,12.02
雲林縣,二崙鄉,合計,7900,2584,5316,96,7996,22786,25808,35.09,11.34
雲林縣,崙背鄉,東明村,420,172,248,4,424,1134,0,37.39,15.17
雲林縣,崙背鄉,西榮村,506,226,280,6,512,1437,0,35.63,15.73
雲林縣,崙背鄉,南陽村,833,396,437,3,836,2263,0,36.94,17.5
雲林縣,崙背鄉,崙前村,731,251,480,11,742,2078,0,35.71,12.08
雲林縣,崙背鄉,羅厝村,741,267,474,13,754,2042,0,36.92,13.08
雲林縣,崙背鄉,港尾村,421,126,295,7,428,1250,0,34.24,10.08
雲林縣,崙背鄉,阿勸村,588,261,327,10,598,2022,0,29.57,12.91
雲林縣,崙背鄉,五魁村,261,165,96,4,265,782,0,33.89,21.1
雲林縣,崙背鄉,大有村,429,179,250,16,445,1484,0,29.99,12.06
雲林縣,崙背鄉,豐榮村,502,187,315,6,508,1710,0,29.71,10.94
雲林縣,崙背鄉,草湖村,424,189,235,7,431,1413,0,30.5,13.38
雲林縣,崙背鄉,舊庄村,267,98,169,5,272,1102,0,24.68,8.89
雲林縣,崙背鄉,水尾村,441,121,320,7,448,1181,0,37.93,10.25
雲林縣,崙背鄉,枋南村,235,91,144,2,237,749,0,31.64,12.15
雲林縣,崙背鄉,合計,6799,2729,4070,101,6900,20647,23741,33.42,13.22
雲林縣,麥寮鄉,麥津村,1122,607,515,11,1133,4277,0,26.49,14.19
雲林縣,麥寮鄉,麥豐村,1938,1050,888,16,1954,7460,0,26.19,14.08
雲林縣,麥寮鄉,瓦磘村,513,200,313,10,523,1968,0,26.58,10.16
雲林縣,麥寮鄉,興華村,755,322,433,10,765,2867,0,26.68,11.23
雲林縣,麥寮鄉,崙後村,635,345,290,7,642,2721,0,23.59,12.68
雲林縣,麥寮鄉,後安村,657,377,280,11,668,3051,0,21.89,12.36
雲林縣,麥寮鄉,海豐村,506,248,258,8,514,2216,0,23.19,11.19
雲林縣,麥寮鄉,三盛村,513,217,296,11,524,2141,0,24.47,10.14
雲林縣,麥寮鄉,橋頭村,1008,464,544,13,1021,4026,0,25.36,11.53
雲林縣,麥寮鄉,新吉村,303,137,166,2,305,1156,0,26.38,11.85
雲林縣,麥寮鄉,施厝村,926,394,532,21,947,3617,0,26.18,10.89
雲林縣,麥寮鄉,雷厝村,543,260,283,13,556,2222,0,25.02,11.7
雲林縣,麥寮鄉,中興村,368,180,188,3,371,1548,0,23.97,11.63
雲林縣,麥寮鄉,合計,9787,4801,4986,136,9923,39270,48001,25.27,12.23
雲林縣,東勢鄉,東南村,559,300,259,6,565,1442,0,39.18,20.8
雲林縣,東勢鄉,東北村,384,185,199,4,388,1155,0,33.59,16.02
雲林縣,東勢鄉,嘉隆村,439,177,262,4,443,1536,0,28.84,11.52
雲林縣,東勢鄉,復興村,199,90,109,1,200,511,0,39.14,17.61
雲林縣,東勢鄉,月眉村,341,114,227,2,343,1160,0,29.57,9.83
雲林縣,東勢鄉,程海村,182,73,109,2,184,532,0,34.59,13.72
雲林縣,東勢鄉,龍潭村,264,79,185,7,271,778,0,34.83,10.15
雲林縣,東勢鄉,安南村,211,83,128,3,214,812,0,26.35,10.22
雲林縣,東勢鄉,昌南村,279,116,163,4,283,825,0,34.3,14.06
雲林縣,東勢鄉,同安村,549,262,287,18,567,1857,0,30.53,14.11
雲林縣,東勢鄉,新坤村,312,137,175,3,315,1015,0,31.03,13.5
雲林縣,東勢鄉,四美村,287,133,154,8,295,989,0,29.83,13.45
雲林縣,東勢鄉,合計,4006,1749,2257,62,4068,12612,13963,32.25,13.87
雲林縣,褒忠鄉,中民村,699,315,384,7,706,1848,0,38.2,17.05
雲林縣,褒忠鄉,埔姜村,524,232,292,6,530,1415,0,37.46,16.4
雲林縣,褒忠鄉,中勝村,519,205,314,5,524,1455,0,36.01,14.09
雲林縣,褒忠鄉,新湖村,436,155,281,9,445,1158,0,38.43,13.39
雲林縣,褒忠鄉,馬鳴村,503,187,316,12,515,1437,0,35.84,13.01
雲林縣,褒忠鄉,有才村,296,109,187,3,299,806,0,37.1,13.52
雲林縣,褒忠鄉,田洋村,280,114,166,2,282,774,0,36.43,14.73
雲林縣,褒忠鄉,龍岩村,388,181,207,6,394,1187,0,33.19,15.25
雲林縣,褒忠鄉,潮厝村,305,119,186,10,315,853,0,36.93,13.95
雲林縣,褒忠鄉,合計,3950,1617,2333,60,4010,10933,12368,36.68,14.79
雲林縣,臺西鄉,台西村,416,258,158,6,422,1177,0,35.85,21.92
雲林縣,臺西鄉,海北村,324,182,142,3,327,1060,0,30.85,17.17
雲林縣,臺西鄉,海南村,311,171,140,6,317,1093,0,29.0,15.65
雲林縣,臺西鄉,海口村,489,269,220,12,501,1980,0,25.3,13.59
雲林縣,臺西鄉,溪頂村,361,168,193,10,371,1449,0,25.6,11.59
雲林縣,臺西鄉,牛厝村,453,193,260,14,467,1828,0,25.55,10.56
雲林縣,臺西鄉,泉州村,156,74,82,4,160,592,0,27.03,12.5
雲林縣,臺西鄉,光華村,221,108,113,3,224,672,0,33.33,16.07
雲林縣,臺西鄉,五榔村,139,39,100,4,143,450,0,31.78,8.67
雲林縣,臺西鄉,山寮村,211,126,85,2,213,811,0,26.26,15.54
雲林縣,臺西鄉,富琦村,385,191,194,5,390,1466,0,26.6,13.03
雲林縣,臺西鄉,永豐村,369,196,173,4,373,1332,0,28.0,14.71
雲林縣,臺西鄉,和豐村,758,355,403,20,778,2935,0,26.51,12.1
雲林縣,臺西鄉,蚊港村,431,250,181,7,438,1741,0,25.16,14.36
雲林縣,臺西鄉,五港村,462,250,212,7,469,1781,0,26.33,14.04
雲林縣,臺西鄉,合計,5486,2830,2656,107,5593,20367,22792,27.46,13.9
雲林縣,元長鄉,長南村,1021,390,631,9,1030,3218,0,32.01,12.12
雲林縣,元長鄉,長北村,491,179,312,4,495,1454,0,34.04,12.31
雲林縣,元長鄉,子茂村,409,132,277,5,414,1308,0,31.65,10.09
雲林縣,元長鄉,後湖村,227,72,155,8,235,705,0,33.33,10.21
雲林縣,元長鄉,山內村,289,118,171,5,294,936,0,31.41,12.61
雲林縣,元長鄉,合和村,296,99,197,6,302,1030,0,29.32,9.61
雲林縣,元長鄉,五塊村,284,129,155,8,292,890,0,32.81,14.49
雲林縣,元長鄉,潭西村,258,66,192,8,266,715,0,37.2,9.23
雲林縣,元長鄉,潭東村,176,86,90,3,179,570,0,31.4,15.09
雲林縣,元長鄉,客厝村,222,110,112,0,222,836,0,26.56,13.16
雲林縣,元長鄉,卓運村,138,31,107,2,140,351,0,39.89,8.83
雲林縣,元長鄉,頂寮村,294,97,197,3,297,1112,0,26.71,8.72
雲林縣,元長鄉,下寮村,441,175,266,5,446,1457,0,30.61,12.01
雲林縣,元長鄉,龍岩村,315,74,241,2,317,958,0,33.09,7.72
雲林縣,元長鄉,西莊村,243,81,162,10,253,813,0,31.12,9.96
雲林縣,元長鄉,鹿北村,310,107,203,1,311,1127,0,27.6,9.49
雲林縣,元長鄉,鹿南村,263,98,165,5,268,816,0,32.84,12.01
雲林縣,元長鄉,瓦磘村,414,138,276,3,417,1472,0,28.33,9.38
雲林縣,元長鄉,內寮村,172,48,124,1,173,578,0,29.93,8.3
雲林縣,元長鄉,崙仔村,191,76,115,9,200,803,0,24.91,9.46
雲林縣,元長鄉,新吉村,225,88,137,3,228,686,0,33.24,12.83
雲林縣,元長鄉,合計,6679,2394,4285,100,6779,21835,24426,31.05,10.96
雲林縣,四湖鄉,四湖村,583,270,313,6,589,1728,0,34.09,15.63
雲林縣,四湖鄉,新庄村,183,73,110,3,186,626,0,29.71,11.66
雲林縣,四湖鄉,溪底村,259,106,153,0,259,902,0,28.71,11.75
雲林縣,四湖鄉,鹿場村,258,98,160,5,263,883,0,29.78,11.1
雲林縣,四湖鄉,湖西村,749,391,358,15,764,2201,0,34.71,17.76
雲林縣,四湖鄉,施湖村,294,146,148,0,294,1152,0,25.52,12.67
雲林縣,四湖鄉,湖寮村,183,75,108,8,191,712,0,26.83,10.53
雲林縣,四湖鄉,蔡厝村,210,87,123,3,213,828,0,25.72,10.51
雲林縣,四湖鄉,飛沙村,227,110,117,0,227,846,0,26.83,13.0
雲林縣,四湖鄉,三姓村,83,34,49,3,86,352,0,24.43,9.66
雲林縣,四湖鄉,內湖村,189,66,123,3,192,743,0,25.84,8.88
雲林縣,四湖鄉,羊調村,220,96,124,7,227,898,0,25.28,10.69
雲林縣,四湖鄉,崙北村,379,162,217,5,384,1669,0,23.01,9.71
雲林縣,四湖鄉,崙南村,177,83,94,3,180,782,0,23.02,10.61
雲林縣,四湖鄉,廣溝村,134,63,71,4,138,683,0,20.2,9.22
雲林縣,四湖鄉,萡子村,238,71,167,6,244,878,0,27.79,8.09
雲林縣,四湖鄉,林厝村,275,95,180,9,284,1016,0,27.95,9.35
雲林縣,四湖鄉,林東村,215,103,112,10,225,958,0,23.49,10.75
雲林縣,四湖鄉,溪尾村,164,77,87,5,169,724,0,23.34,10.64
雲林縣,四湖鄉,飛東村,155,51,104,5,160,533,0,30.02,9.57
雲林縣,四湖鄉,萡東村,270,55,215,5,275,1007,0,27.31,5.46
雲林縣,四湖鄉,合計,5445,2312,3133,105,5550,20121,22100,27.58,11.49
雲林縣,口湖鄉,湖東村,379,165,214,4,383,1198,0,31.97,13.77
雲林縣,口湖鄉,口湖村,350,150,200,5,355,1068,0,33.24,14.04
雲林縣,口湖鄉,頂湖村,167,68,99,0,167,614,0,27.2,11.07
雲林縣,口湖鄉,埔北村,261,78,183,4,265,851,0,31.14,9.17
雲林縣,口湖鄉,埔南村,250,80,170,8,258,694,0,37.18,11.53
雲林縣,口湖鄉,謝厝村,347,87,260,6,353,973,0,36.28,8.94
雲林縣,口湖鄉,蚵寮村,402,99,303,13,415,1405,0,29.54,7.05
雲林縣,口湖鄉,下崙村,547,173,374,7,554,2020,0,27.43,8.56
雲林縣,口湖鄉,崙中村,403,129,274,8,411,1473,0,27.9,8.76
雲林縣,口湖鄉,崙東村,399,155,244,5,404,1410,0,28.65,10.99
雲林縣,口湖鄉,青蚶村,142,36,106,2,144,511,0,28.18,7.05
雲林縣,口湖鄉,港東村,426,159,267,8,434,1493,0,29.07,10.65
雲林縣,口湖鄉,港西村,256,87,169,4,260,806,0,32.26,10.79
雲林縣,口湖鄉,台子村,639,97,542,7,646,1888,0,34.22,5.14
雲林縣,口湖鄉,成龍村,282,107,175,5,287,896,0,32.03,11.94
雲林縣,口湖鄉,湖口村,296,66,230,6,302,980,0,30.82,6.73
雲林縣,口湖鄉,水井村,326,120,206,11,337,925,0,36.43,12.97
雲林縣,口湖鄉,後厝村,231,73,158,1,232,686,0,33.82,10.64
雲林縣,口湖鄉,梧南村,662,199,463,6,668,1773,0,37.68,11.22
雲林縣,口湖鄉,梧北村,482,104,378,7,489,1154,0,42.37,9.01
雲林縣,口湖鄉,過港村,183,60,123,6,189,595,0,31.76,10.08
雲林縣,口湖鄉,合計,7430,2292,5138,123,7553,23413,26186,32.26,9.79
雲林縣,水林鄉,水北村,646,218,428,12,658,2131,0,30.88,10.23
雲林縣,水林鄉,水南村,722,235,487,9,731,1971,0,37.09,11.92
雲林縣,水林鄉,海埔村,356,78,278,5,361,969,0,37.25,8.05
雲林縣,水林鄉,土厝村,405,85,320,8,413,1149,0,35.94,7.4
雲林縣,水林鄉,春埔村,318,93,225,3,321,944,0,34.0,9.85
雲林縣,水林鄉,西井村,194,82,112,5,199,598,0,33.28,13.71
雲林縣,水林鄉,車港村,183,65,118,3,186,597,0,31.16,10.89
雲林縣,水林鄉,蘇秦村,296,74,222,7,303,943,0,32.13,7.85
雲林縣,水林鄉,灣東村,178,88,90,4,182,603,0,30.18,14.59
雲林縣,水林鄉,灣西村,287,104,183,4,291,905,0,32.15,11.49
雲林縣,水林鄉,萬興村,211,52,159,3,214,680,0,31.47,7.65
雲林縣,水林鄉,尖山村,203,44,159,1,204,627,0,32.54,7.02
雲林縣,水林鄉,大山村,363,103,260,4,367,1006,0,36.48,10.24
雲林縣,水林鄉,大溝村,340,100,240,7,347,967,0,35.88,10.34
雲林縣,水林鄉,順興村,266,66,200,5,271,803,0,33.75,8.22
雲林縣,水林鄉,蕃薯村,320,98,222,5,325,927,0,35.06,10.57
雲林縣,水林鄉,山腳村,243,70,173,8,251,776,0,32.35,9.02
雲林縣,水林鄉,松北村,286,111,175,5,291,989,0,29.42,11.22
雲林縣,水林鄉,松中村,188,44,144,1,189,484,0,39.05,9.09
雲林縣,水林鄉,松西村,197,41,156,3,200,647,0,30.91,6.34
雲林縣,水林鄉,瓊埔村,223,36,187,6,229,655,0,34.96,5.5
雲林縣,水林鄉,塭底村,188,42,146,5,193,653,0,29.56,6.43
雲林縣,水林鄉,後寮村,228,71,157,3,231,653,0,35.38,10.87
雲林縣,水林鄉,溪墘村,244,85,159,13,257,765,0,33.59,11.11
雲林縣,水林鄉,合計,7085,2085,5000,129,7214,21442,23934,33.64,9.72
雲林縣,合計,合計,201103,86539,114564,2487,203590,577564,673309,35.25,14.98
嘉義縣,太保市,太保里,865,385,480,16,881,2315,0,38.06,16.63
嘉義縣,太保市,後庄里,189,44,145,1,190,466,0,40.77,9.44
嘉義縣,太保市,前潭里,610,205,405,12,622,1453,0,42.81,14.11
嘉義縣,太保市,後潭里,727,283,444,9,736,1685,0,43.68,16.8
嘉義縣,太保市,梅埔里,470,175,295,11,481,1133,0,42.45,15.45
嘉義縣,太保市,春珠里,383,125,258,3,386,1105,0,34.93,11.31
嘉義縣,太保市,崙頂里,329,135,194,4,333,817,0,40.76,16.52
嘉義縣,太保市,東勢里,766,336,430,7,773,1799,0,42.97,18.68
嘉義縣,太保市,新埤里,491,163,328,6,497,1244,0,39.95,13.1
嘉義縣,太保市,舊埤里,909,342,567,7,916,2556,0,35.84,13.38
嘉義縣,太保市,田尾里,292,104,188,2,294,724,0,40.61,14.36
嘉義縣,太保市,港尾里,217,89,128,4,221,547,0,40.4,16.27
嘉義縣,太保市,過溝里,1396,500,896,8,1404,3489,0,40.24,14.33
嘉義縣,太保市,麻寮里,1676,639,1037,17,1693,4625,0,36.61,13.82
嘉義縣,太保市,南新里,711,217,494,5,716,1819,0,39.36,11.93
嘉義縣,太保市,北新里,1118,393,725,9,1127,3112,0,36.21,12.63
嘉義縣,太保市,埤鄉里,272,108,164,2,274,679,0,40.35,15.91
嘉義縣,太保市,安仁里,1042,487,555,4,1046,2639,0,39.64,18.45
嘉義縣,太保市,合計,12463,4730,7733,127,12590,32207,38651,39.09,14.69
嘉義縣,朴子市,安福里,720,351,369,7,727,1887,0,38.53,18.6
嘉義縣,朴子市,平和里,948,434,514,4,952,2322,0,41.0,18.69
嘉義縣,朴子市,內厝里,482,170,312,2,484,1092,0,44.32,15.57
嘉義縣,朴子市,開元里,177,63,114,2,179,377,0,47.48,16.71
嘉義縣,朴子市,順天里,262,102,160,1,263,610,0,43.11,16.72
嘉義縣,朴子市,中正里,293,134,159,5,298,618,0,48.22,21.68
嘉義縣,朴子市,博厚里,325,121,204,3,328,819,0,40.05,14.77
嘉義縣,朴子市,文化里,704,307,397,5,709,1676,0,42.3,18.32
嘉義縣,朴子市,永和里,935,317,618,8,943,2498,0,37.75,12.69
嘉義縣,朴子市,竹圍里,1728,772,956,19,1747,4243,0,41.17,18.19
嘉義縣,朴子市,新寮里,241,82,159,0,241,669,0,36.02,12.26
嘉義縣,朴子市,双溪里,190,68,122,2,192,608,0,31.58,11.18
嘉義縣,朴子市,溪口里,273,91,182,2,275,768,0,35.81,11.85
嘉義縣,朴子市,德興里,407,97,310,7,414,1015,0,40.79,9.56
嘉義縣,朴子市,仁和里,669,302,367,7,676,1769,0,38.21,17.07
嘉義縣,朴子市,大鄉里,1105,408,697,18,1123,3190,0,35.2,12.79
嘉義縣,朴子市,大葛里,1085,442,643,10,1095,2926,0,37.42,15.11
嘉義縣,朴子市,佳禾里,247,88,159,5,252,742,0,33.96,11.86
嘉義縣,朴子市,竹村里,413,157,256,3,416,1040,0,40.0,15.1
嘉義縣,朴子市,崁前里,326,108,218,8,334,870,0,38.39,12.41
嘉義縣,朴子市,順安里,112,36,76,3,115,246,0,46.75,14.63
嘉義縣,朴子市,崁後里,269,80,189,6,275,709,0,38.79,11.28
嘉義縣,朴子市,德家里,262,81,181,4,266,767,0,34.68,10.56
嘉義縣,朴子市,新庄里,268,120,148,5,273,678,0,40.27,17.7
嘉義縣,朴子市,梅華里,415,85,330,7,422,1019,0,41.41,8.34
嘉義縣,朴子市,松華里,422,96,326,7,429,1190,0,36.05,8.07
嘉義縣,朴子市,南竹里,195,27,168,4,199,486,0,40.95,5.56
嘉義縣,朴子市,合計,13473,5139,8334,154,13627,34834,41439,39.12,14.75
嘉義縣,布袋鎮,岱江里,227,118,109,5,232,593,0,39.12,19.9
嘉義縣,布袋鎮,九龍里,144,72,72,3,147,356,0,41.29,20.22
嘉義縣,布袋鎮,岑海里,793,350,443,9,802,2143,0,37.42,16.33
嘉義縣,布袋鎮,興中里,386,166,220,3,389,1064,0,36.56,15.6
嘉義縣,布袋鎮,光復里,678,313,365,12,690,1593,0,43.31,19.65
嘉義縣,布袋鎮,見龍里,302,104,198,0,302,860,0,35.12,12.09
嘉義縣,布袋鎮,新厝里,200,99,101,5,205,683,0,30.01,14.49
嘉義縣,布袋鎮,龍江里,228,94,134,4,232,742,0,31.27,12.67
嘉義縣,布袋鎮,新岑里,392,102,290,9,401,920,0,43.59,11.09
嘉義縣,布袋鎮,新民里,381,139,242,4,385,1287,0,29.91,10.8
嘉義縣,布袋鎮,復興里,757,277,480,8,765,2276,0,33.61,12.17
嘉義縣,布袋鎮,好美里,331,121,210,9,340,1106,0,30.74,10.94
嘉義縣,布袋鎮,永安里,362,172,190,7,369,1090,0,33.85,15.78
嘉義縣,布袋鎮,東港里,685,245,440,11,696,1861,0,37.4,13.16
嘉義縣,布袋鎮,江山里,105,40,65,1,106,281,0,37.72,14.23
嘉義縣,布袋鎮,菜舖里,140,58,82,3,143,385,0,37.14,15.06
嘉義縣,布袋鎮,考試里,125,40,85,2,127,288,0,44.1,13.89
嘉義縣,布袋鎮,振寮里,241,124,117,1,242,713,0,33.94,17.39
嘉義縣,布袋鎮,西安里,418,160,258,8,426,1117,0,38.14,14.32
嘉義縣,布袋鎮,東安里,537,157,380,9,546,1286,0,42.46,12.21
嘉義縣,布袋鎮,中安里,468,139,329,8,476,1350,0,35.26,10.3
嘉義縣,布袋鎮,樹林里,191,63,128,8,199,518,0,38.42,12.16
嘉義縣,布袋鎮,貴舍里,236,59,177,3,239,632,0,37.82,9.34
嘉義縣,布袋鎮,合計,8327,3212,5115,132,8459,23144,25692,36.55,13.88
嘉義縣,大林鎮,東林里,214,91,123,3,217,467,0,46.47,19.49
嘉義縣,大林鎮,西林里,812,340,472,6,818,1816,0,45.04,18.72
嘉義縣,大林鎮,吉林里,384,188,196,3,387,885,0,43.73,21.24
嘉義縣,大林鎮,平林里,2379,1079,1300,16,2395,5889,0,40.67,18.32
嘉義縣,大林鎮,明華里,476,158,318,10,486,1127,0,43.12,14.02
嘉義縣,大林鎮,明和里,659,308,351,6,665,1783,0,37.3,17.27
嘉義縣,大林鎮,排路里,269,64,205,0,269,595,0,45.21,10.76
嘉義縣,大林鎮,西結里,259,66,193,3,262,703,0,37.27,9.39
嘉義縣,大林鎮,湖北里,263,83,180,6,269,612,0,43.95,13.56
嘉義縣,大林鎮,大糖里,73,40,33,2,75,184,0,40.76,21.74
嘉義縣,大林鎮,大美里,553,247,306,4,557,1563,0,35.64,15.8
嘉義縣,大林鎮,過溪里,523,206,317,9,532,1405,0,37.86,14.66
嘉義縣,大林鎮,中坑里,529,203,326,5,534,1327,0,40.24,15.3
嘉義縣,大林鎮,上林里,318,124,194,5,323,793,0,40.73,15.64
嘉義縣,大林鎮,中林里,640,199,441,12,652,1546,0,42.17,12.87
嘉義縣,大林鎮,三和里,732,306,426,8,740,2009,0,36.83,15.23
嘉義縣,大林鎮,溝背里,347,123,224,3,350,905,0,38.67,13.59
嘉義縣,大林鎮,義和里,253,122,131,5,258,656,0,39.33,18.6
嘉義縣,大林鎮,內林里,270,120,150,7,277,644,0,43.01,18.63
嘉義縣,大林鎮,三角里,294,134,160,2,296,817,0,36.23,16.4
嘉義縣,大林鎮,三村里,341,132,209,3,344,820,0,41.95,16.1
嘉義縣,大林鎮,合計,10588,4333,6255,118,10706,26546,30237,40.33,16.32
嘉義縣,民雄鄉,東榮村,938,405,533,6,944,2300,0,41.04,17.61
嘉義縣,民雄鄉,中樂村,675,326,349,8,683,1528,0,44.7,21.34
嘉義縣,民雄鄉,西安村,1396,550,846,11,1407,3338,0,42.15,16.48
嘉義縣,民雄鄉,寮頂村,875,336,539,8,883,2158,0,40.92,15.57
嘉義縣,民雄鄉,福權村,678,221,457,7,685,1567,0,43.71,14.1
嘉義縣,民雄鄉,東湖村,642,267,375,7,649,1827,0,35.52,14.61
嘉義縣,民雄鄉,頂崙村,566,237,329,7,573,1469,0,39.01,16.13
嘉義縣,民雄鄉,菁埔村,685,172,513,14,699,1708,0,40.93,10.07
嘉義縣,民雄鄉,中和村,365,161,204,4,369,962,0,38.36,16.74
嘉義縣,民雄鄉,平和村,349,120,229,4,353,817,0,43.21,14.69
嘉義縣,民雄鄉,西昌村,347,103,244,2,349,821,0,42.51,12.55
嘉義縣,民雄鄉,豊收村,836,384,452,8,844,2163,0,39.02,17.75
嘉義縣,民雄鄉,三興村,599,255,344,9,608,1346,0,45.17,18.95
嘉義縣,民雄鄉,東興村,207,84,123,2,209,523,0,39.96,16.06
嘉義縣,民雄鄉,鎮北村,458,187,271,12,470,1154,0,40.73,16.2
嘉義縣,民雄鄉,興中村,670,270,400,3,673,1837,0,36.64,14.7
嘉義縣,民雄鄉,興南村,933,371,562,10,943,2740,0,34.42,13.54
嘉義縣,民雄鄉,福興村,851,320,531,7,858,1995,0,43.01,16.04
嘉義縣,民雄鄉,文隆村,995,438,557,10,1005,2450,0,41.02,17.88
嘉義縣,民雄鄉,山中村,1379,488,891,19,1398,3513,0,39.8,13.89
嘉義縣,民雄鄉,中央村,515,162,353,5,520,1281,0,40.59,12.65
嘉義縣,民雄鄉,北斗村,1937,794,1143,12,1949,5279,0,36.92,15.04
嘉義縣,民雄鄉,双福村,954,467,487,10,964,2449,0,39.36,19.07
嘉義縣,民雄鄉,大崎村,885,365,520,8,893,2361,0,37.82,15.46
嘉義縣,民雄鄉,秀林村,1027,348,679,18,1045,2602,0,40.16,13.37
嘉義縣,民雄鄉,松山村,590,228,362,6,596,1690,0,35.27,13.49
嘉義縣,民雄鄉,金興村,1136,465,671,9,1145,2956,0,38.73,15.73
嘉義縣,民雄鄉,福樂村,2574,1067,1507,15,2589,6649,0,38.94,16.05
嘉義縣,民雄鄉,合計,24062,9591,14471,241,24303,61483,71044,39.53,15.6
嘉義縣,溪口鄉,溪東村,509,193,316,9,518,1277,0,40.56,15.11
嘉義縣,溪口鄉,溪西村,291,96,195,4,295,653,0,45.18,14.7
嘉義縣,溪口鄉,溪北村,230,72,158,6,236,636,0,37.11,11.32
嘉義縣,溪口鄉,游東村,396,96,300,3,399,952,0,41.91,10.08
嘉義縣,溪口鄉,游西村,260,55,205,3,263,656,0,40.09,8.38
嘉義縣,溪口鄉,柴林村,279,74,205,5,284,758,0,37.47,9.76
嘉義縣,溪口鄉,林腳村,260,62,198,4,264,803,0,32.88,7.72
嘉義縣,溪口鄉,美南村,364,86,278,9,373,1113,0,33.51,7.73
嘉義縣,溪口鄉,美北村,331,103,228,4,335,971,0,34.5,10.61
嘉義縣,溪口鄉,本厝村,366,127,239,7,373,921,0,40.5,13.79
嘉義縣,溪口鄉,柳溝村,500,159,341,7,507,1264,0,40.11,12.58
嘉義縣,溪口鄉,疊溪村,394,115,279,4,398,1013,0,39.29,11.35
嘉義縣,溪口鄉,妙崙村,242,74,168,3,245,680,0,36.03,10.88
嘉義縣,溪口鄉,坪頂村,359,108,251,3,362,878,0,41.23,12.3
嘉義縣,溪口鄉,合計,4781,1420,3361,71,4852,12575,13890,38.58,11.29
嘉義縣,新港鄉,宮前村,985,432,553,7,992,2204,0,45.01,19.6
嘉義縣,新港鄉,宮後村,652,229,423,8,660,1541,0,42.83,14.86
嘉義縣,新港鄉,大興村,585,210,375,6,591,1424,0,41.5,14.75
嘉義縣,新港鄉,福德村,632,246,386,10,642,1618,0,39.68,15.2
嘉義縣,新港鄉,古民村,531,120,411,6,537,1375,0,39.05,8.73
嘉義縣,新港鄉,中庄村,643,178,465,10,653,1582,0,41.28,11.25
嘉義縣,新港鄉,大潭村,625,175,450,13,638,1618,0,39.43,10.82
嘉義縣,新港鄉,西庄村,379,141,238,5,384,931,0,41.25,15.15
嘉義縣,新港鄉,埤子村,215,53,162,2,217,549,0,39.53,9.65
嘉義縣,新港鄉,南崙村,361,52,309,6,367,886,0,41.42,5.87
嘉義縣,新港鄉,北崙村,166,32,134,6,172,465,0,36.99,6.88
嘉義縣,新港鄉,海瀛村,195,64,131,2,197,486,0,40.53,13.17
嘉義縣,新港鄉,月眉村,749,196,553,14,763,1627,0,46.9,12.05
嘉義縣,新港鄉,月潭村,585,145,440,8,593,1538,0,38.56,9.43
嘉義縣,新港鄉,溪北村,508,141,367,6,514,1308,0,39.3,10.78
嘉義縣,新港鄉,三間村,557,230,327,4,561,1492,0,37.6,15.42
嘉義縣,新港鄉,中洋村,407,150,257,4,411,1023,0,40.18,14.66
嘉義縣,新港鄉,菜公村,373,125,248,4,377,947,0,39.81,13.2
嘉義縣,新港鄉,安和村,355,90,265,7,362,985,0,36.75,9.14
嘉義縣,新港鄉,潭大村,423,122,301,10,433,1118,0,38.73,10.91
嘉義縣,新港鄉,南港村,382,115,267,3,385,1017,0,37.86,11.31
嘉義縣,新港鄉,板頭村,208,61,147,1,209,548,0,38.14,11.13
嘉義縣,新港鄉,共和村,328,101,227,2,330,838,0,39.38,12.05
嘉義縣,新港鄉,合計,10844,3408,7436,144,10988,27120,30952,40.52,12.57
嘉義縣,六腳鄉,蒜頭村,437,178,259,3,440,1127,0,39.04,15.79
嘉義縣,六腳鄉,蒜東村,271,93,178,5,276,788,0,35.03,11.8
嘉義縣,六腳鄉,蒜南村,322,89,233,3,325,829,0,39.2,10.74
嘉義縣,六腳鄉,工廠村,99,67,32,1,100,211,0,47.39,31.75
嘉義縣,六腳鄉,灣南村,423,143,280,7,430,1153,0,37.29,12.4
嘉義縣,六腳鄉,灣北村,366,151,215,7,373,1165,0,32.02,12.96
嘉義縣,六腳鄉,雙涵村,325,77,248,10,335,861,0,38.91,8.94
嘉義縣,六腳鄉,塗師村,243,65,178,8,251,615,0,40.81,10.57
嘉義縣,六腳鄉,三義村,262,60,202,3,265,725,0,36.55,8.28
嘉義縣,六腳鄉,港美村,267,43,224,3,270,677,0,39.88,6.35
嘉義縣,六腳鄉,豐美村,397,117,280,2,399,996,0,40.06,11.75
嘉義縣,六腳鄉,六斗村,308,107,201,4,312,905,0,34.48,11.82
嘉義縣,六腳鄉,崙陽村,359,110,249,3,362,1019,0,35.53,10.79
嘉義縣,六腳鄉,蘇厝村,483,136,347,7,490,1433,0,34.19,9.49
嘉義縣,六腳鄉,竹本村,202,61,141,2,204,594,0,34.34,10.27
嘉義縣,六腳鄉,永賢村,146,28,118,4,150,467,0,32.12,6.0
嘉義縣,六腳鄉,魚寮村,213,61,152,2,215,611,0,35.19,9.98
嘉義縣,六腳鄉,潭墘村,291,93,198,3,294,838,0,35.08,11.1
嘉義縣,六腳鄉,正義村,593,151,442,9,602,1392,0,43.25,10.85
嘉義縣,六腳鄉,溪厝村,215,64,151,6,221,578,0,38.24,11.07
嘉義縣,六腳鄉,六腳村,267,108,159,4,271,734,0,36.92,14.71
嘉義縣,六腳鄉,六南村,169,59,110,5,174,521,0,33.4,11.32
嘉義縣,六腳鄉,崩山村,237,70,167,2,239,627,0,38.12,11.16
嘉義縣,六腳鄉,古林村,262,51,211,4,266,659,0,40.36,7.74
嘉義縣,六腳鄉,更寮村,194,61,133,1,195,563,0,34.64,10.83
嘉義縣,六腳鄉,合計,7351,2243,5108,108,7459,20088,21914,37.13,11.17
嘉義縣,東石鄉,東石村,673,245,428,9,682,1898,0,35.93,12.91
嘉義縣,東石鄉,猿樹村,301,110,191,5,306,922,0,33.19,11.93
嘉義縣,東石鄉,型厝村,417,159,258,6,423,1320,0,32.05,12.05
嘉義縣,東石鄉,塭港村,546,235,311,2,548,1622,0,33.79,14.49
嘉義縣,東石鄉,三家村,323,121,202,10,333,1120,0,29.73,10.8
嘉義縣,東石鄉,永屯村,210,86,124,2,212,701,0,30.24,12.27
嘉義縣,東石鄉,海埔村,136,58,78,8,144,388,0,37.11,14.95
嘉義縣,東石鄉,龍港村,294,163,131,9,303,839,0,36.11,19.43
嘉義縣,東石鄉,副瀨村,313,96,217,11,324,857,0,37.81,11.2
嘉義縣,東石鄉,下揖村,254,75,179,6,260,714,0,36.41,10.5
嘉義縣,東石鄉,頂揖村,143,58,85,1,144,368,0,39.13,15.76
嘉義縣,東石鄉,溪下村,259,109,150,5,264,957,0,27.59,11.39
嘉義縣,東石鄉,港墘村,468,165,303,10,478,1185,0,40.34,13.92
嘉義縣,東石鄉,蔦松村,270,95,175,9,279,821,0,33.98,11.57
嘉義縣,東石鄉,圍潭村,218,75,143,3,221,650,0,34.0,11.54
嘉義縣,東石鄉,洲仔村,245,84,161,7,252,795,0,31.7,10.57
嘉義縣,東石鄉,東崙村,230,84,146,5,235,670,0,35.07,12.54
嘉義縣,東石鄉,西崙村,411,142,269,6,417,1074,0,38.83,13.22
嘉義縣,東石鄉,塭仔村,329,74,255,6,335,893,0,37.51,8.29
嘉義縣,東石鄉,網寮村,372,157,215,4,376,1167,0,32.22,13.45
嘉義縣,東石鄉,掌潭村,326,131,195,1,327,757,0,43.2,17.31
嘉義縣,東石鄉,港口村,85,34,51,1,86,284,0,30.28,11.97
嘉義縣,東石鄉,鰲鼓村,414,138,276,6,420,1233,0,34.06,11.19
嘉義縣,東石鄉,合計,7237,2694,4543,132,7369,21235,23594,34.7,12.69
嘉義縣,義竹鄉,岸腳村,257,98,159,9,266,663,0,40.12,14.78
嘉義縣,義竹鄉,義竹村,601,201,400,13,614,1416,0,43.36,14.19
嘉義縣,義竹鄉,六桂村,451,206,245,10,461,1125,0,40.98,18.31
嘉義縣,義竹鄉,仁里村,353,156,197,5,358,829,0,43.18,18.82
嘉義縣,義竹鄉,傳芳村,280,107,173,7,287,749,0,38.32,14.29
嘉義縣,義竹鄉,頭竹村,465,149,316,10,475,1195,0,39.75,12.47
嘉義縣,義竹鄉,五厝村,148,54,94,1,149,368,0,40.49,14.67
嘉義縣,義竹鄉,中平村,171,80,91,6,177,412,0,42.96,19.42
嘉義縣,義竹鄉,埤前村,323,120,203,6,329,721,0,45.63,16.64
嘉義縣,義竹鄉,平溪村,173,56,117,1,174,422,0,41.23,13.27
嘉義縣,義竹鄉,後鎮村,182,85,97,6,188,417,0,45.08,20.38
嘉義縣,義竹鄉,北華村,247,99,148,5,252,591,0,42.64,16.75
嘉義縣,義竹鄉,新店村,477,190,287,8,485,1447,0,33.52,13.13
嘉義縣,義竹鄉,東過村,239,89,150,6,245,826,0,29.66,10.77
嘉義縣,義竹鄉,西過村,264,75,189,1,265,777,0,34.11,9.65
嘉義縣,義竹鄉,官和村,290,62,228,7,297,796,0,37.31,7.79
嘉義縣,義竹鄉,官順村,149,49,100,1,150,422,0,35.55,11.61
嘉義縣,義竹鄉,新富村,181,90,91,9,190,520,0,36.54,17.31
嘉義縣,義竹鄉,東光村,294,92,202,1,295,724,0,40.75,12.71
嘉義縣,義竹鄉,東榮村,151,47,104,1,152,363,0,41.87,12.95
嘉義縣,義竹鄉,龍蛟村,198,72,126,3,201,554,0,36.28,13.0
嘉義縣,義竹鄉,溪洲村,295,80,215,4,299,636,0,47.01,12.58
嘉義縣,義竹鄉,合計,6189,2257,3932,120,6309,15973,17439,39.5,14.13
嘉義縣,鹿草鄉,後寮村,180,51,129,0,180,512,0,35.16,9.96
嘉義縣,鹿草鄉,鹿東村,219,66,153,1,220,540,0,40.74,12.22
嘉義縣,鹿草鄉,鹿草村,465,168,297,1,466,1289,0,36.15,13.03
嘉義縣,鹿草鄉,西井村,478,196,282,6,484,1319,0,36.69,14.86
嘉義縣,鹿草鄉,豊稠村,180,80,100,0,180,736,0,24.46,10.87
嘉義縣,鹿草鄉,重寮村,393,120,273,6,399,1002,0,39.82,11.98
嘉義縣,鹿草鄉,施家村,157,38,119,4,161,427,0,37.7,8.9
嘉義縣,鹿草鄉,下潭村,325,84,241,8,333,799,0,41.68,10.51
嘉義縣,鹿草鄉,光潭村,384,103,281,3,387,982,0,39.41,10.49
嘉義縣,鹿草鄉,碧潭村,328,140,188,7,335,937,0,35.75,14.94
嘉義縣,鹿草鄉,松竹村,295,130,165,5,300,927,0,32.36,14.02
嘉義縣,鹿草鄉,竹山村,342,83,259,8,350,895,0,39.11,9.27
嘉義縣,鹿草鄉,後堀村,436,144,292,7,443,1126,0,39.34,12.79
嘉義縣,鹿草鄉,三角村,578,180,398,7,585,1379,0,42.42,13.05
嘉義縣,鹿草鄉,下麻村,275,112,163,5,280,599,0,46.74,18.7
嘉義縣,鹿草鄉,合計,5035,1695,3340,68,5103,13469,14778,37.89,12.58
嘉義縣,水上鄉,水上村,1624,709,915,18,1642,4025,0,40.8,17.61
嘉義縣,水上鄉,水頭村,1056,470,586,5,1061,2466,0,43.03,19.06
嘉義縣,水上鄉,大堀村,778,231,547,7,785,1615,0,48.61,14.3
嘉義縣,水上鄉,大崙村,788,263,525,6,794,2073,0,38.3,12.69
嘉義縣,水上鄉,塗溝村,343,109,234,5,348,782,0,44.5,13.94
嘉義縣,水上鄉,粗溪村,606,257,349,11,617,1540,0,40.06,16.69
嘉義縣,水上鄉,下寮村,749,319,430,5,754,1867,0,40.39,17.09
嘉義縣,水上鄉,三和村,681,319,362,4,685,1779,0,38.5,17.93
嘉義縣,水上鄉,回歸村,179,87,92,5,184,427,0,43.09,20.37
嘉義縣,水上鄉,三鎮村,241,141,100,4,245,614,0,39.9,22.96
嘉義縣,水上鄉,靖和村,212,98,114,2,214,384,0,55.73,25.52
嘉義縣,水上鄉,南和村,521,182,339,2,523,1345,0,38.88,13.53
嘉義縣,水上鄉,龍德村,838,259,579,5,843,1915,0,44.02,13.52
嘉義縣,水上鄉,溪洲村,425,142,283,7,432,1028,0,42.02,13.81
嘉義縣,水上鄉,柳林村,715,263,452,11,726,2028,0,35.8,12.97
嘉義縣,水上鄉,柳鄉村,798,267,531,7,805,1983,0,40.6,13.46
嘉義縣,水上鄉,柳新村,685,355,330,7,692,1782,0,38.83,19.92
嘉義縣,水上鄉,寬士村,1648,635,1013,20,1668,4357,0,38.28,14.57
嘉義縣,水上鄉,民生村,1211,495,716,10,1221,2967,0,41.15,16.68
嘉義縣,水上鄉,忠和村,712,302,410,7,719,1853,0,38.8,16.3
嘉義縣,水上鄉,中庄村,646,190,456,4,650,1779,0,36.54,10.68
嘉義縣,水上鄉,南鄉村,336,123,213,3,339,910,0,37.25,13.52
嘉義縣,水上鄉,三界村,378,136,242,7,385,971,0,39.65,14.01
嘉義縣,水上鄉,國姓村,426,127,299,5,431,1239,0,34.79,10.25
嘉義縣,水上鄉,內溪村,434,180,254,2,436,1179,0,36.98,15.27
嘉義縣,水上鄉,義興村,307,111,196,3,310,792,0,39.14,14.02
嘉義縣,水上鄉,合計,17337,6770,10567,172,17509,43700,48786,40.07,15.49
嘉義縣,中埔鄉,中埔村,614,227,387,7,621,1790,0,34.69,12.68
嘉義縣,中埔鄉,塩舘村,374,161,213,1,375,935,0,40.11,17.22
嘉義縣,中埔鄉,龍門村,323,136,187,3,326,787,0,41.42,17.28
嘉義縣,中埔鄉,裕民村,342,92,250,4,346,862,0,40.14,10.67
嘉義縣,中埔鄉,金蘭村,465,190,275,3,468,1500,0,31.2,12.67
嘉義縣,中埔鄉,富收村,1055,407,648,13,1068,2900,0,36.83,14.03
嘉義縣,中埔鄉,和睦村,1237,489,748,12,1249,3322,0,37.6,14.72
嘉義縣,中埔鄉,和美村,2667,1180,1487,15,2682,7020,0,38.21,16.81
嘉義縣,中埔鄉,和興村,2019,791,1228,33,2052,5652,0,36.31,14.0
嘉義縣,中埔鄉,隆興村,641,259,382,10,651,1825,0,35.67,14.19
嘉義縣,中埔鄉,義仁村,514,169,345,6,520,1490,0,34.9,11.34
嘉義縣,中埔鄉,社口村,716,281,435,7,723,2097,0,34.48,13.4
嘉義縣,中埔鄉,灣潭村,320,111,209,3,323,1020,0,31.67,10.88
嘉義縣,中埔鄉,石硦村,414,164,250,6,420,1122,0,37.43,14.62
嘉義縣,中埔鄉,頂埔村,341,104,237,7,348,932,0,37.34,11.16
嘉義縣,中埔鄉,同仁村,658,219,439,7,665,1851,0,35.93,11.83
嘉義縣,中埔鄉,瑞豐村,224,100,124,3,227,723,0,31.4,13.83
嘉義縣,中埔鄉,沄水村,337,121,216,8,345,966,0,35.71,12.53
嘉義縣,中埔鄉,三層村,196,59,137,1,197,634,0,31.07,9.31
嘉義縣,中埔鄉,深坑村,257,99,158,5,262,714,0,36.69,13.87
嘉義縣,中埔鄉,東興村,154,63,91,2,156,356,0,43.82,17.7
嘉義縣,中埔鄉,中崙村,102,51,51,4,106,291,0,36.43,17.53
嘉義縣,中埔鄉,合計,13970,5473,8497,160,14130,38789,43935,36.43,14.11
嘉義縣,竹崎鄉,竹崎村,966,398,568,5,971,2455,0,39.55,16.21
嘉義縣,竹崎鄉,和平村,727,268,459,10,737,2167,0,34.01,12.37
嘉義縣,竹崎鄉,坑頭村,234,98,136,2,236,750,0,31.47,13.07
嘉義縣,竹崎鄉,沙坑村,304,82,222,10,314,813,0,38.62,10.09
嘉義縣,竹崎鄉,獅埜村,502,160,342,8,510,1212,0,42.08,13.2
嘉義縣,竹崎鄉,義和村,293,114,179,6,299,603,0,49.59,18.91
嘉義縣,竹崎鄉,義仁村,308,114,194,2,310,1025,0,30.24,11.12
嘉義縣,竹崎鄉,灣橋村,1988,881,1107,19,2007,5214,0,38.49,16.9
嘉義縣,竹崎鄉,鹿滿村,550,209,341,3,553,1401,0,39.47,14.92
嘉義縣,竹崎鄉,紫雲村,468,197,271,7,475,1362,0,34.88,14.46
嘉義縣,竹崎鄉,內埔村,620,234,386,10,630,1562,0,40.33,14.98
嘉義縣,竹崎鄉,昇平村,488,172,316,2,490,1738,0,28.19,9.9
嘉義縣,竹崎鄉,白杞村,178,74,104,2,180,611,0,29.46,12.11
嘉義縣,竹崎鄉,桃源村,307,131,176,5,312,998,0,31.26,13.13
嘉義縣,竹崎鄉,塘興村,296,146,150,5,301,851,0,35.37,17.16
嘉義縣,竹崎鄉,義隆村,216,92,124,2,218,624,0,34.94,14.74
嘉義縣,竹崎鄉,龍山村,607,196,411,9,616,1756,0,35.08,11.16
嘉義縣,竹崎鄉,文峯村,218,82,136,6,224,626,0,35.78,13.1
嘉義縣,竹崎鄉,金獅村,156,60,96,1,157,416,0,37.74,14.42
嘉義縣,竹崎鄉,復金村,637,231,406,5,642,1845,0,34.8,12.52
嘉義縣,竹崎鄉,緞繻村,269,122,147,4,273,903,0,30.23,13.51
嘉義縣,竹崎鄉,仁壽村,66,14,52,0,66,238,0,27.73,5.88
嘉義縣,竹崎鄉,中和村,240,90,150,2,242,766,0,31.59,11.75
嘉義縣,竹崎鄉,光華村,207,102,105,3,210,681,0,30.84,14.98
嘉義縣,竹崎鄉,合計,10845,4267,6578,128,10973,30617,34503,35.84,13.94
嘉義縣,梅山鄉,梅東村,801,310,491,15,816,2182,0,37.4,14.21
嘉義縣,梅山鄉,梅南村,354,178,176,2,356,869,0,40.97,20.48
嘉義縣,梅山鄉,過山村,192,71,121,4,196,540,0,36.3,13.15
嘉義縣,梅山鄉,梅北村,1546,618,928,18,1564,4337,0,36.06,14.25
嘉義縣,梅山鄉,圳南村,146,56,90,3,149,393,0,37.91,14.25
嘉義縣,梅山鄉,永興村,179,81,98,4,183,500,0,36.6,16.2
嘉義縣,梅山鄉,半天村,108,32,76,2,110,355,0,30.99,9.01
嘉義縣,梅山鄉,圳北村,183,69,114,2,185,579,0,31.95,11.92
嘉義縣,梅山鄉,大南村,556,217,339,7,563,1618,0,34.8,13.41
嘉義縣,梅山鄉,双溪村,205,80,125,5,210,548,0,38.32,14.6
嘉義縣,梅山鄉,安靖村,224,94,130,1,225,814,0,27.64,11.55
嘉義縣,梅山鄉,太平村,139,67,72,1,140,488,0,28.69,13.73
嘉義縣,梅山鄉,碧湖村,83,42,41,1,84,275,0,30.55,15.27
嘉義縣,梅山鄉,太興村,152,90,62,1,153,414,0,36.96,21.74
嘉義縣,梅山鄉,瑞峯村,207,102,105,6,213,703,0,30.3,14.51
嘉義縣,梅山鄉,瑞里村,182,116,66,2,184,610,0,30.16,19.02
嘉義縣,梅山鄉,太和村,238,98,140,4,242,929,0,26.05,10.55
嘉義縣,梅山鄉,龍眼村,126,29,97,0,126,400,0,31.5,7.25
嘉義縣,梅山鄉,合計,5621,2350,3271,78,5699,16554,18481,34.43,14.2
嘉義縣,番路鄉,江西村,438,227,211,6,444,1143,0,38.85,19.86
嘉義縣,番路鄉,內甕村,168,74,94,1,169,440,0,38.41,16.82
嘉義縣,番路鄉,新福村,410,167,243,3,413,1282,0,32.22,13.03
嘉義縣,番路鄉,下坑村,671,286,385,4,675,1748,0,38.62,16.36
嘉義縣,番路鄉,番路村,297,120,177,2,299,835,0,35.81,14.37
嘉義縣,番路鄉,民和村,313,148,165,1,314,849,0,36.98,17.43
嘉義縣,番路鄉,觸口村,408,173,235,5,413,1220,0,33.85,14.18
嘉義縣,番路鄉,大湖村,156,57,99,4,160,596,0,26.85,9.56
嘉義縣,番路鄉,公田村,250,108,142,1,251,956,0,26.26,11.3
嘉義縣,番路鄉,公興村,145,54,91,3,148,498,0,29.72,10.84
嘉義縣,番路鄉,草山村,97,65,32,2,99,364,0,27.2,17.86
嘉義縣,番路鄉,合計,3353,1479,1874,32,3385,9931,11097,34.09,14.89
嘉義縣,大埔鄉,大埔村,353,131,222,4,357,1448,0,24.65,9.05
嘉義縣,大埔鄉,和平村,170,57,113,4,174,650,0,26.77,8.77
嘉義縣,大埔鄉,永樂村,118,62,56,0,118,420,0,28.1,14.76
嘉義縣,大埔鄉,茄苳村,182,78,104,6,188,923,0,20.37,8.45
嘉義縣,大埔鄉,西興村,177,91,86,0,177,567,0,31.22,16.05
嘉義縣,大埔鄉,合計,1000,419,581,14,1014,4008,4553,25.3,10.45
嘉義縣,阿里山鄉,中山村,111,63,48,1,112,367,0,30.52,17.17
嘉義縣,阿里山鄉,中正村,65,47,18,0,65,184,0,35.33,25.54
嘉義縣,阿里山鄉,香林村,42,28,14,0,42,142,0,29.58,19.72
嘉義縣,阿里山鄉,十字村,80,50,30,3,83,316,0,26.27,15.82
嘉義縣,阿里山鄉,來吉村,129,99,30,1,130,292,0,44.52,33.9
嘉義縣,阿里山鄉,豐山村,81,50,31,2,83,303,0,27.39,16.5
嘉義縣,阿里山鄉,達邦村,247,195,52,4,251,819,0,30.65,23.81
嘉義縣,阿里山鄉,樂野村,300,184,116,7,307,939,0,32.69,19.6
嘉義縣,阿里山鄉,里佳村,86,69,17,0,86,244,0,35.25,28.28
嘉義縣,阿里山鄉,山美村,131,104,27,0,131,472,0,27.75,22.03
嘉義縣,阿里山鄉,新美村,92,64,28,2,94,289,0,32.53,22.15
嘉義縣,阿里山鄉,茶山村,81,32,49,1,82,254,0,32.28,12.6
嘉義縣,阿里山鄉,合計,1445,985,460,21,1466,4621,5455,31.72,21.32
嘉義縣,合計,合計,163921,62465,101456,2020,165941,436894,496440,37.98,14.3
屏東縣,屏東市,維新里,1141,429,712,10,1151,2604,0,44.2,16.47
屏東縣,屏東市,橋南里,597,266,331,6,603,1528,0,39.46,17.41
屏東縣,屏東市,橋北里,397,175,222,3,400,843,0,47.45,20.76
屏東縣,屏東市,長春里,824,387,437,4,828,1836,0,45.1,21.08
屏東縣,屏東市,豐榮里,1206,540,666,10,1216,2467,0,49.29,21.89
屏東縣,屏東市,豐源里,1641,830,811,13,1654,3454,0,47.89,24.03
屏東縣,屏東市,豐田里,1719,805,914,7,1726,3905,0,44.2,20.61
屏東縣,屏東市,大連里,4201,2242,1959,36,4237,9028,0,46.93,24.83
屏東縣,屏東市,湖西里,675,193,482,5,680,1482,0,45.88,13.02
屏東縣,屏東市,湖南里,439,131,308,1,440,1032,0,42.64,12.69
屏東縣,屏東市,歸心里,472,111,361,8,480,1115,0,43.05,9.96
屏東縣,屏東市,瑞光里,3127,1544,1583,28,3155,7115,0,44.34,21.7
屏東縣,屏東市,新生里,2272,986,1286,17,2289,5421,0,42.22,18.19
屏東縣,屏東市,頂宅里,239,75,164,2,241,510,0,47.25,14.71
屏東縣,屏東市,厚生里,1240,419,821,10,1250,2821,0,44.31,14.85
屏東縣,屏東市,擇仁里,360,123,237,2,362,796,0,45.48,15.45
屏東縣,屏東市,建國里,408,188,220,5,413,900,0,45.89,20.89
屏東縣,屏東市,一心里,559,304,255,2,561,1173,0,47.83,25.92
屏東縣,屏東市,萬年里,299,105,194,2,301,678,0,44.4,15.49
屏東縣,屏東市,義勇里,558,330,228,6,564,1104,0,51.09,29.89
屏東縣,屏東市,光華里,274,105,169,3,277,655,0,42.29,16.03
屏東縣,屏東市,永安里,2906,1254,1652,25,2931,6960,0,42.11,18.02
屏東縣,屏東市,新興里,987,364,623,9,996,2467,0,40.37,14.75
屏東縣,屏東市,公館里,671,208,463,8,679,1488,0,45.63,13.98
屏東縣,屏東市,龍華里,927,317,610,12,939,2203,0,42.62,14.39
屏東縣,屏東市,玉成里,619,136,483,8,627,1481,0,42.34,9.18
屏東縣,屏東市,頂柳里,466,146,320,3,469,1083,0,43.31,13.48
屏東縣,屏東市,大湖里,712,262,450,7,719,1791,0,40.15,14.63
屏東縣,屏東市,安鎮里,841,289,552,11,852,1995,0,42.71,14.49
屏東縣,屏東市,永光里,452,183,269,2,454,1004,0,45.22,18.23
屏東縣,屏東市,大洲里,524,135,389,6,530,1166,0,45.45,11.58
屏東縣,屏東市,大武里,3409,1586,1823,39,3448,8068,0,42.74,19.66
屏東縣,屏東市,前進里,1215,450,765,9,1224,2872,0,42.62,15.67
屏東縣,屏東市,清溪里,1680,774,906,9,1689,4077,0,41.43,18.98
屏東縣,屏東市,長安里,839,302,537,6,845,1956,0,43.2,15.44
屏東縣,屏東市,斯文里,759,383,376,4,763,1637,0,46.61,23.4
屏東縣,屏東市,華山里,2004,1047,957,16,2020,4657,0,43.38,22.48
屏東縣,屏東市,興樂里,340,176,164,2,342,730,0,46.85,24.11
屏東縣,屏東市,明正里,262,128,134,3,265,652,0,40.64,19.63
屏東縣,屏東市,太平里,302,130,172,3,305,626,0,48.72,20.77
屏東縣,屏東市,中正里,1968,1039,929,20,1988,4603,0,43.19,22.57
屏東縣,屏東市,勝利里,2024,1095,929,17,2041,5471,0,37.31,20.01
屏東縣,屏東市,永城里,770,369,401,13,783,1912,0,40.95,19.3
屏東縣,屏東市,溝美里,985,458,527,12,997,2231,0,44.69,20.53
屏東縣,屏東市,北勢里,1085,488,597,11,1096,2284,0,47.99,21.37
屏東縣,屏東市,北興里,2563,1300,1263,15,2578,6059,0,42.55,21.46
屏東縣,屏東市,仁愛里,1018,476,542,10,1028,2149,0,47.84,22.15
屏東縣,屏東市,廣興里,876,389,487,6,882,2058,0,42.86,18.9
屏東縣,屏東市,崇蘭里,5176,2916,2260,36,5212,12298,0,42.38,23.71
屏東縣,屏東市,空翔里,803,538,265,6,809,1655,0,48.88,32.51
屏東縣,屏東市,潭墘里,4541,2689,1852,34,4575,11543,0,39.63,23.3
屏東縣,屏東市,三山里,570,176,394,8,578,1324,0,43.66,13.29
屏東縣,屏東市,海豐里,373,111,262,2,375,849,0,44.17,13.07
屏東縣,屏東市,仁義里,427,130,297,11,438,1089,0,40.22,11.94
屏東縣,屏東市,和興里,421,122,299,7,428,941,0,45.48,12.96
屏東縣,屏東市,信和里,684,177,507,8,692,1560,0,44.36,11.35
屏東縣,屏東市,崇武里,1254,911,343,10,1264,2890,0,43.74,31.52
屏東縣,屏東市,武廟里、大同里、端正里,534,183,351,5,539,1053,0,51.19,17.38
屏東縣,屏東市,文明里、泰安里,290,156,134,6,296,675,0,43.85,23.11
屏東縣,屏東市,光榮里、民權里,629,262,367,5,634,1310,0,48.4,20.0
屏東縣,屏東市,大埔里、必信里,559,218,341,2,561,1240,0,45.24,17.58
屏東縣,屏東市,崇智里、崇禮里,306,105,201,1,307,654,0,46.94,16.06
屏東縣,屏東市,楠樹里、扶風里、慶春里,601,204,397,6,607,1166,0,52.06,17.5
屏東縣,屏東市,安樂里、平和里,488,201,287,1,489,1039,0,47.06,19.35
屏東縣,屏東市,金泉里、勝豐里,510,180,330,5,515,1018,0,50.59,17.68
屏東縣,屏東市,凌雲里、鵬程里,214,121,93,3,217,525,0,41.33,23.05
屏東縣,屏東市,永順里、永昌里,239,102,137,2,241,520,0,46.35,19.62
屏東縣,屏東市,合計,72471,33674,38797,624,73095,167496,196653,43.64,20.1
屏東縣,潮州鎮,潮州里,224,122,102,2,226,505,0,44.75,24.16
屏東縣,潮州鎮,同榮里,301,101,200,1,302,582,0,51.89,17.35
屏東縣,潮州鎮,新榮里,552,220,332,3,555,1227,0,45.23,17.93
屏東縣,潮州鎮,新生里,415,163,252,2,417,983,0,42.42,16.58
屏東縣,潮州鎮,光華里,1749,749,1000,7,1756,4770,0,36.81,15.7
屏東縣,潮州鎮,彭城里,377,113,264,1,378,859,0,44.0,13.15
屏東縣,潮州鎮,三星里,2294,1043,1251,13,2307,5434,0,42.45,19.19
屏東縣,潮州鎮,三共里,2764,1215,1549,20,2784,6463,0,43.08,18.8
屏東縣,潮州鎮,三和里,880,376,504,6,886,2106,0,42.07,17.85
屏東縣,潮州鎮,五魁里,550,201,349,5,555,1387,0,40.01,14.49
屏東縣,潮州鎮,蓬萊里,929,328,601,3,932,2401,0,38.82,13.66
屏東縣,潮州鎮,八爺里,916,363,553,12,928,2381,0,38.98,15.25
屏東縣,潮州鎮,永春里,2666,1143,1523,19,2685,7120,0,37.71,16.05
屏東縣,潮州鎮,富春里,451,187,264,4,455,1172,0,38.82,15.96
屏東縣,潮州鎮,光春里,554,218,336,7,561,1413,0,39.7,15.43
屏東縣,潮州鎮,興美里,312,111,201,2,314,881,0,35.64,12.6
屏東縣,潮州鎮,檨子里,168,60,108,1,169,468,0,36.11,12.82
屏東縣,潮州鎮,九塊里,622,175,447,12,634,1633,0,38.82,10.72
屏東縣,潮州鎮,泗林里,694,248,446,8,702,1615,0,43.47,15.36
屏東縣,潮州鎮,四春里,683,216,467,12,695,1694,0,41.03,12.75
屏東縣,潮州鎮,崙東里,609,193,416,7,616,1535,0,40.13,12.57
屏東縣,潮州鎮,合計,18710,7545,11165,147,18857,46629,53851,40.44,16.18
屏東縣,東港鎮,新勝里,952,296,656,5,957,1975,0,48.46,14.99
屏東縣,東港鎮,東和里,242,92,150,1,243,631,0,38.51,14.58
屏東縣,東港鎮,朝安里,595,171,424,8,603,1575,0,38.29,10.86
屏東縣,東港鎮,八德里,333,111,222,0,333,734,0,45.37,15.12
屏東縣,東港鎮,東隆里,439,145,294,2,441,1192,0,37.0,12.16
屏東縣,東港鎮,豐漁里,241,79,162,1,242,559,0,43.29,14.13
屏東縣,東港鎮,盛漁里,491,121,370,4,495,1329,0,37.25,9.1
屏東縣,東港鎮,興漁里,707,178,529,3,710,1804,0,39.36,9.87
屏東縣,東港鎮,鎮海里,1047,261,786,5,1052,2840,0,37.04,9.19
屏東縣,東港鎮,嘉蓮里,664,193,471,4,668,1680,0,39.76,11.49
屏東縣,東港鎮,南平里,527,201,326,9,536,1562,0,34.31,12.87
屏東縣,東港鎮,船頭里,2096,743,1353,19,2115,5363,0,39.44,13.85
屏東縣,東港鎮,下廍里,785,155,630,19,804,1937,0,41.51,8.0
屏東縣,東港鎮,大潭里,593,184,409,7,600,1532,0,39.16,12.01
屏東縣,東港鎮,興東里,3482,1329,2153,25,3507,9392,0,37.34,14.15
屏東縣,東港鎮,興農里,551,190,361,3,554,1324,0,41.84,14.35
屏東縣,東港鎮,興和里,419,100,319,8,427,1049,0,40.71,9.53
屏東縣,東港鎮,共和里,286,198,88,4,290,664,0,43.67,29.82
屏東縣,東港鎮,頂新里、頂中里,381,139,242,1,382,852,0,44.84,16.31
屏東縣,東港鎮,興台里、中興里,487,208,279,5,492,1133,0,43.42,18.36
屏東縣,東港鎮,合計,15318,5094,10224,133,15451,39127,46590,39.49,13.02
屏東縣,恆春鎮,城南里,295,161,134,2,297,896,0,33.15,17.97
屏東縣,恆春鎮,城北里,708,351,357,6,714,2205,0,32.38,15.92
屏東縣,恆春鎮,城西里,322,168,154,6,328,1109,0,29.58,15.15
屏東縣,恆春鎮,山腳里,1197,606,591,8,1205,4194,0,28.73,14.45
屏東縣,恆春鎮,網紗里,893,433,460,13,906,3117,0,29.07,13.89
屏東縣,恆春鎮,仁壽里,227,93,134,3,230,856,0,26.87,10.86
屏東縣,恆春鎮,茄湖里,169,56,113,4,173,504,0,34.33,11.11
屏東縣,恆春鎮,頭溝里,166,64,102,1,167,473,0,35.31,13.53
屏東縣,恆春鎮,四溝里,273,107,166,5,278,1021,0,27.23,10.48
屏東縣,恆春鎮,德和里,247,99,148,7,254,928,0,27.37,10.67
屏東縣,恆春鎮,龍水里,285,136,149,0,285,1079,0,26.41,12.6
屏東縣,恆春鎮,山海里,481,153,328,8,489,1560,0,31.35,9.81
屏東縣,恆春鎮,大光里,533,266,267,8,541,2199,0,24.6,12.1
屏東縣,恆春鎮,水泉里,318,106,212,6,324,1388,0,23.34,7.64
屏東縣,恆春鎮,南灣里,478,243,235,6,484,1686,0,28.71,14.41
屏東縣,恆春鎮,墾丁里,456,199,257,8,464,1205,0,38.51,16.51
屏東縣,恆春鎮,鵝鑾里,334,166,168,5,339,1082,0,31.33,15.34
屏東縣,恆春鎮,合計,7382,3407,3975,96,7478,25502,30236,29.32,13.36
屏東縣,萬丹鄉,萬安村,245,73,172,1,246,587,0,41.91,12.44
屏東縣,萬丹鄉,萬惠村,360,129,231,3,363,817,0,44.43,15.79
屏東縣,萬丹鄉,萬全村,1458,528,930,18,1476,3322,0,44.43,15.89
屏東縣,萬丹鄉,萬後村,241,75,166,0,241,711,0,33.9,10.55
屏東縣,萬丹鄉,萬生村,613,262,351,4,617,1403,0,43.98,18.67
屏東縣,萬丹鄉,寶厝村,860,347,513,7,867,2249,0,38.55,15.43
屏東縣,萬丹鄉,四維村,822,280,542,11,833,2047,0,40.69,13.68
屏東縣,萬丹鄉,竹林村,693,219,474,10,703,1671,0,42.07,13.11
屏東縣,萬丹鄉,廣安村,1021,314,707,7,1028,2276,0,45.17,13.8
屏東縣,萬丹鄉,田厝村,440,110,330,7,447,973,0,45.94,11.31
屏東縣,萬丹鄉,崙頂村,713,216,497,9,722,1835,0,39.35,11.77
屏東縣,萬丹鄉,厦北村,685,191,494,7,692,1593,0,43.44,11.99
屏東縣,萬丹鄉,厦南村,565,188,377,6,571,1407,0,40.58,13.36
屏東縣,萬丹鄉,上村村,365,100,265,3,368,822,0,44.77,12.17
屏東縣,萬丹鄉,加興村,541,120,421,6,547,1248,0,43.83,9.62
屏東縣,萬丹鄉,社口村,555,210,345,13,568,1471,0,38.61,14.28
屏東縣,萬丹鄉,磚寮村,417,131,286,7,424,943,0,44.96,13.89
屏東縣,萬丹鄉,社皮村,846,281,565,2,848,1968,0,43.09,14.28
屏東縣,萬丹鄉,社上村,712,220,492,9,721,1666,0,43.28,13.21
屏東縣,萬丹鄉,社中村,711,194,517,13,724,1692,0,42.79,11.47
屏東縣,萬丹鄉,水泉村,765,263,502,13,778,1694,0,45.93,15.53
屏東縣,萬丹鄉,新庄村,869,350,519,9,878,2075,0,42.31,16.87
屏東縣,萬丹鄉,香社村,622,211,411,8,630,1508,0,41.78,13.99
屏東縣,萬丹鄉,後村村,451,136,315,3,454,977,0,46.47,13.92
屏東縣,萬丹鄉,新鐘村,725,313,412,8,733,2019,0,36.31,15.5
屏東縣,萬丹鄉,灣內村,526,135,391,8,534,1343,0,39.76,10.05
屏東縣,萬丹鄉,興全村,472,171,301,9,481,1145,0,42.01,14.93
屏東縣,萬丹鄉,興安村,354,99,255,2,356,828,0,43.0,11.96
屏東縣,萬丹鄉,水仙村,232,91,141,3,235,546,0,43.04,16.67
屏東縣,萬丹鄉,甘棠村,132,47,85,2,134,394,0,34.01,11.93
屏東縣,萬丹鄉,合計,18011,6004,12007,208,18219,43230,49955,42.14,13.89
屏東縣,長治鄉,進興村,1106,448,658,15,1121,2655,0,42.22,16.87
屏東縣,長治鄉,新潭村,1506,690,816,14,1520,3605,0,42.16,19.14
屏東縣,長治鄉,潭頭村,889,378,511,5,894,1921,0,46.54,19.68
屏東縣,長治鄉,香楊村,1169,501,668,6,1175,2628,0,44.71,19.06
屏東縣,長治鄉,長興村,476,218,258,3,479,1056,0,45.36,20.64
屏東縣,長治鄉,德成村,409,160,249,1,410,859,0,47.73,18.63
屏東縣,長治鄉,德協村,470,162,308,2,472,1045,0,45.17,15.5
屏東縣,長治鄉,復興村,667,236,431,7,674,1475,0,45.69,16.0
屏東縣,長治鄉,崙上村,701,295,406,4,705,1639,0,43.01,18.0
屏東縣,長治鄉,德榮村,524,162,362,5,529,1144,0,46.24,14.16
屏東縣,長治鄉,德和村,270,74,196,3,273,743,0,36.74,9.96
屏東縣,長治鄉,繁華村,924,234,690,6,930,2349,0,39.59,9.96
屏東縣,長治鄉,繁昌村,667,208,459,10,677,1719,0,39.38,12.1
屏東縣,長治鄉,繁榮村,482,152,330,8,490,1404,0,34.9,10.83
屏東縣,長治鄉,繁隆村,398,147,251,7,405,1127,0,35.94,13.04
屏東縣,長治鄉,榮華村,304,187,117,2,306,710,0,43.1,26.34
屏東縣,長治鄉,合計,10962,4252,6710,98,11060,26079,29381,42.41,16.3
屏東縣,麟洛鄉,新田村,1002,342,660,11,1013,2127,0,47.63,16.08
屏東縣,麟洛鄉,麟頂村,436,161,275,3,439,925,0,47.46,17.41
屏東縣,麟洛鄉,麟蹄村,739,257,482,5,744,1484,0,50.13,17.32
屏東縣,麟洛鄉,麟趾村,1178,401,777,12,1190,2480,0,47.98,16.17
屏東縣,麟洛鄉,田中村,557,176,381,3,560,1156,0,48.44,15.22
屏東縣,麟洛鄉,田心村,418,154,264,3,421,846,0,49.76,18.2
屏東縣,麟洛鄉,田道村,349,119,230,2,351,671,0,52.31,17.73
屏東縣,麟洛鄉,合計,4679,1610,3069,39,4718,9689,10711,48.69,16.62
屏東縣,九如鄉,九清村,598,166,432,5,603,1438,0,41.93,11.54
屏東縣,九如鄉,九塊村,588,150,438,4,592,1353,0,43.75,11.09
屏東縣,九如鄉,九明村,787,188,599,12,799,1675,0,47.7,11.22
屏東縣,九如鄉,玉水村,511,138,373,9,520,1222,0,42.55,11.29
屏東縣,九如鄉,大坵村,473,145,328,5,478,1155,0,41.39,12.55
屏東縣,九如鄉,三塊村,610,143,467,4,614,1563,0,39.28,9.15
屏東縣,九如鄉,後庄村,803,174,629,17,820,1747,0,46.94,9.96
屏東縣,九如鄉,耆老村,541,141,400,4,545,1257,0,43.36,11.22
屏東縣,九如鄉,洽興村,619,178,441,6,625,1454,0,42.98,12.24
屏東縣,九如鄉,東寧村,2003,635,1368,18,2021,4613,0,43.81,13.77
屏東縣,九如鄉,玉泉村,709,251,458,7,716,1586,0,45.15,15.83
屏東縣,九如鄉,合計,8242,2309,5933,91,8333,19063,21784,43.71,12.11
屏東縣,里港鄉,玉田村,1307,651,656,13,1320,3156,0,41.83,20.63
屏東縣,里港鄉,大平村,472,165,307,9,481,1106,0,43.49,14.92
屏東縣,里港鄉,永春村,342,101,241,2,344,840,0,40.95,12.02
屏東縣,里港鄉,春林村,578,185,393,4,582,1323,0,43.99,13.98
屏東縣,里港鄉,過江村,818,239,579,9,827,1992,0,41.52,12.0
屏東縣,里港鄉,鐵店村,600,177,423,3,603,1418,0,42.52,12.48
屏東縣,里港鄉,塔樓村,634,163,471,11,645,1522,0,42.38,10.71
屏東縣,里港鄉,潮厝村,595,157,438,6,601,1564,0,38.43,10.04
屏東縣,里港鄉,茄苳村,658,166,492,8,666,1502,0,44.34,11.05
屏東縣,里港鄉,載興村,987,231,756,15,1002,2297,0,43.62,10.06
屏東縣,里港鄉,土庫村,844,415,429,11,855,1980,0,43.18,20.96
屏東縣,里港鄉,三廍村,725,295,430,11,736,1815,0,40.55,16.25
屏東縣,里港鄉,中和村,349,131,218,4,353,956,0,36.92,13.7
屏東縣,里港鄉,瀰力村,254,61,193,9,263,514,0,51.17,11.87
屏東縣,里港鄉,合計,9163,3137,6026,115,9278,21985,25657,42.2,14.27
屏東縣,鹽埔鄉,新圍村,1079,333,746,19,1098,3077,0,35.68,10.82
屏東縣,鹽埔鄉,高朗村,900,279,621,14,914,2767,0,33.03,10.08
屏東縣,鹽埔鄉,鹽北村,580,269,311,9,589,1800,0,32.72,14.94
屏東縣,鹽埔鄉,鹽中村,782,357,425,11,793,2311,0,34.31,15.45
屏東縣,鹽埔鄉,鹽南村,559,256,303,7,566,1683,0,33.63,15.21
屏東縣,鹽埔鄉,仕絨村,355,190,165,1,356,1022,0,34.83,18.59
屏東縣,鹽埔鄉,振興村,604,231,373,14,618,1803,0,34.28,12.81
屏東縣,鹽埔鄉,永隆村,215,60,155,1,216,537,0,40.22,11.17
屏東縣,鹽埔鄉,久愛村,343,143,200,8,351,908,0,38.66,15.75
屏東縣,鹽埔鄉,洛陽村,638,249,389,9,647,1606,0,40.29,15.5
屏東縣,鹽埔鄉,新二村,1242,524,718,17,1259,3450,0,36.49,15.19
屏東縣,鹽埔鄉,彭厝村,381,162,219,5,386,957,0,40.33,16.93
屏東縣,鹽埔鄉,合計,7678,3053,4625,115,7793,21921,24795,35.55,13.93
屏東縣,高樹鄉,高樹村,961,244,717,8,969,2093,0,46.3,11.66
屏東縣,高樹鄉,長榮村,538,112,426,7,545,1236,0,44.09,9.06
屏東縣,高樹鄉,東興村,330,64,266,2,332,707,0,46.96,9.05
屏東縣,高樹鄉,東振村,238,62,176,7,245,578,0,42.39,10.73
屏東縣,高樹鄉,源泉村,439,124,315,6,445,995,0,44.72,12.46
屏東縣,高樹鄉,建興村,440,99,341,8,448,1135,0,39.47,8.72
屏東縣,高樹鄉,大埔村,251,75,176,4,255,592,0,43.07,12.67
屏東縣,高樹鄉,菜寮村,310,48,262,5,315,727,0,43.33,6.6
屏東縣,高樹鄉,司馬村,210,67,143,7,217,618,0,35.11,10.84
屏東縣,高樹鄉,舊寮村,483,132,351,1,484,1183,0,40.91,11.16
屏東縣,高樹鄉,新豐村,508,134,374,6,514,1416,0,36.3,9.46
屏東縣,高樹鄉,泰山村,658,208,450,8,666,1828,0,36.43,11.38
屏東縣,高樹鄉,南華村,468,139,329,6,474,1231,0,38.51,11.29
屏東縣,高樹鄉,廣福村,439,124,315,5,444,1041,0,42.65,11.91
屏東縣,高樹鄉,廣興村,357,114,243,8,365,1085,0,33.64,10.51
屏東縣,高樹鄉,舊庄村,392,81,311,9,401,988,0,40.59,8.2
屏東縣,高樹鄉,田子村,413,109,304,6,419,1054,0,39.75,10.34
屏東縣,高樹鄉,鹽樹村,537,140,397,6,543,1172,0,46.33,11.95
屏東縣,高樹鄉,新南村,542,150,392,12,554,1483,0,37.36,10.11
屏東縣,高樹鄉,合計,8514,2226,6288,121,8635,21162,23583,40.8,10.52
屏東縣,萬巒鄉,萬巒村,508,154,354,4,512,1171,0,43.72,13.15
屏東縣,萬巒鄉,萬全村,313,102,211,1,314,715,0,43.92,14.27
屏東縣,萬巒鄉,萬和村,766,245,521,8,774,1663,0,46.54,14.73
屏東縣,萬巒鄉,鹿寮村,403,112,291,7,410,885,0,46.33,12.66
屏東縣,萬巒鄉,硫黃村,272,73,199,4,276,530,0,52.08,13.77
屏東縣,萬巒鄉,泗溝村,483,187,296,9,492,1083,0,45.43,17.27
屏東縣,萬巒鄉,五溝村,477,167,310,6,483,990,0,48.79,16.87
屏東縣,萬巒鄉,成德村,582,198,384,5,587,1392,0,42.17,14.22
屏東縣,萬巒鄉,萬金村,788,229,559,7,795,1976,0,40.23,11.59
屏東縣,萬巒鄉,赤山村,564,211,353,7,571,1657,0,34.46,12.73
屏東縣,萬巒鄉,佳佐村,621,148,473,7,628,1673,0,37.54,8.85
屏東縣,萬巒鄉,佳和村,528,207,321,4,532,1374,0,38.72,15.07
屏東縣,萬巒鄉,新厝村,480,103,377,6,486,1233,0,39.42,8.35
屏東縣,萬巒鄉,新置村,426,152,274,6,432,1162,0,37.18,13.08
屏東縣,萬巒鄉,合計,7211,2288,4923,81,7292,17504,20028,41.66,13.07
屏東縣,內埔鄉,內埔村,1620,641,979,13,1633,3943,0,41.42,16.26
屏東縣,內埔鄉,內田村,1286,487,799,10,1296,3127,0,41.45,15.57
屏東縣,內埔鄉,興南村,596,211,385,8,604,1261,0,47.9,16.73
屏東縣,內埔鄉,義亭村,248,83,165,1,249,565,0,44.07,14.69
屏東縣,內埔鄉,美和村,928,342,586,8,936,2169,0,43.15,15.77
屏東縣,內埔鄉,和興村,1133,475,658,12,1145,2795,0,40.97,16.99
屏東縣,內埔鄉,東寧村,1881,711,1170,12,1893,4356,0,43.46,16.32
屏東縣,內埔鄉,豐田村,1248,439,809,12,1260,3045,0,41.38,14.42
屏東縣,內埔鄉,振豐村,766,263,503,3,769,1580,0,48.67,16.65
屏東縣,內埔鄉,富田村,827,228,599,6,833,1847,0,45.1,12.34
屏東縣,內埔鄉,竹圍村,797,251,546,8,805,1835,0,43.87,13.68
屏東縣,內埔鄉,東勢村,1195,342,853,11,1206,2856,0,42.23,11.97
屏東縣,內埔鄉,東片村,480,143,337,6,486,920,0,52.83,15.54
屏東縣,內埔鄉,上樹村,497,153,344,7,504,1079,0,46.71,14.18
屏東縣,內埔鄉,老埤村,753,236,517,9,762,2282,0,33.39,10.34
屏東縣,內埔鄉,中林村,554,124,430,5,559,1517,0,36.85,8.17
屏東縣,內埔鄉,龍泉村,881,406,475,15,896,2397,0,37.38,16.94
屏東縣,內埔鄉,龍潭村,760,417,343,13,773,2350,0,32.89,17.74
屏東縣,內埔鄉,建興村,359,136,223,8,367,782,0,46.93,17.39
屏東縣,內埔鄉,大新村,698,269,429,14,712,1726,0,41.25,15.59
屏東縣,內埔鄉,黎明村,844,238,606,10,854,2405,0,35.51,9.9
屏東縣,內埔鄉,隘寮村,410,150,260,9,419,1260,0,33.25,11.9
屏東縣,內埔鄉,水門村,329,150,179,6,335,795,0,42.14,18.87
屏東縣,內埔鄉,合計,19090,6895,12195,206,19296,46892,52910,41.15,14.7
屏東縣,竹田鄉,竹田村,663,246,417,2,665,1447,0,45.96,17.0
屏東縣,竹田鄉,竹南村,409,113,296,5,414,868,0,47.7,13.02
屏東縣,竹田鄉,糶糴村,331,114,217,7,338,676,0,50.0,16.86
屏東縣,竹田鄉,履豐村,277,88,189,4,281,577,0,48.7,15.25
屏東縣,竹田鄉,頭崙村,573,178,395,4,577,1289,0,44.76,13.81
屏東縣,竹田鄉,二崙村,474,163,311,3,477,969,0,49.23,16.82
屏東縣,竹田鄉,美崙村,315,114,201,3,318,621,0,51.21,18.36
屏東縣,竹田鄉,南勢村,253,76,177,1,254,459,0,55.34,16.56
屏東縣,竹田鄉,西勢村,1097,393,704,10,1107,2368,0,46.75,16.6
屏東縣,竹田鄉,福田村,237,77,160,4,241,477,0,50.52,16.14
屏東縣,竹田鄉,永豐村,353,123,230,0,353,881,0,40.07,13.96
屏東縣,竹田鄉,六巷村,361,124,237,5,366,796,0,45.98,15.58
屏東縣,竹田鄉,泗洲村,429,155,274,9,438,1099,0,39.85,14.1
屏東縣,竹田鄉,大湖村,501,152,349,3,504,1186,0,42.5,12.82
屏東縣,竹田鄉,鳳明村,459,194,265,7,466,1180,0,39.49,16.44
屏東縣,竹田鄉,合計,6732,2310,4422,67,6799,14893,16409,45.65,15.51
屏東縣,新埤鄉,新埤村,829,376,453,10,839,1959,0,42.83,19.19
屏東縣,新埤鄉,建功村,529,209,320,6,535,1030,0,51.94,20.29
屏東縣,新埤鄉,打鐵村,384,169,215,8,392,860,0,45.58,19.65
屏東縣,新埤鄉,南豐村,339,113,226,5,344,734,0,46.87,15.4
屏東縣,新埤鄉,萬隆村,566,233,333,6,572,1713,0,33.39,13.6
屏東縣,新埤鄉,箕湖村,359,129,230,9,368,1100,0,33.45,11.73
屏東縣,新埤鄉,餉潭村,367,97,270,5,372,1253,0,29.69,7.74
屏東縣,新埤鄉,合計,3373,1326,2047,49,3422,8649,9464,39.57,15.33
屏東縣,枋寮鄉,枋寮村,461,219,242,5,466,1196,0,38.96,18.31
屏東縣,枋寮鄉,新龍村,323,182,141,4,327,865,0,37.8,21.04
屏東縣,枋寮鄉,保生村,351,113,238,5,356,906,0,39.29,12.47
屏東縣,枋寮鄉,中寮村,252,74,178,1,253,573,0,44.15,12.91
屏東縣,枋寮鄉,安樂村,616,204,412,4,620,1578,0,39.29,12.93
屏東縣,枋寮鄉,隆山村,1535,455,1080,15,1550,4151,0,37.34,10.96
屏東縣,枋寮鄉,天時村,799,268,531,10,809,1866,0,43.35,14.36
屏東縣,枋寮鄉,地利村,651,249,402,3,654,1416,0,46.19,17.58
屏東縣,枋寮鄉,人和村,829,310,519,7,836,2027,0,41.24,15.29
屏東縣,枋寮鄉,內寮村,251,60,191,2,253,695,0,36.4,8.63
屏東縣,枋寮鄉,新開村,235,89,146,2,237,874,0,27.12,10.18
屏東縣,枋寮鄉,太源村,286,126,160,6,292,927,0,31.5,13.59
屏東縣,枋寮鄉,玉泉村,119,56,63,3,122,428,0,28.5,13.08
屏東縣,枋寮鄉,東海村,1011,420,591,19,1030,2680,0,38.43,15.67
屏東縣,枋寮鄉,大庄村,232,73,159,3,235,604,0,38.91,12.09
屏東縣,枋寮鄉,合計,7951,2898,5053,89,8040,20786,23466,38.68,13.94
屏東縣,新園鄉,瓦磘村,670,204,466,8,678,1629,0,41.62,12.52
屏東縣,新園鄉,仙吉村,913,270,643,6,919,2479,0,37.07,10.89
屏東縣,新園鄉,田洋村,818,220,598,10,828,2135,0,38.78,10.3
屏東縣,新園鄉,港墘村,307,114,193,1,308,807,0,38.17,14.13
屏東縣,新園鄉,內庄村,357,118,239,6,363,820,0,44.27,14.39
屏東縣,新園鄉,新東村,823,305,518,16,839,2294,0,36.57,13.3
屏東縣,新園鄉,新園村,880,287,593,9,889,2190,0,40.59,13.11
屏東縣,新園鄉,烏龍村,500,135,365,9,509,1194,0,42.63,11.31
屏東縣,新園鄉,興龍村,905,241,664,3,908,2092,0,43.4,11.52
屏東縣,新園鄉,中洲村,645,123,522,7,652,1553,0,41.98,7.92
屏東縣,新園鄉,南龍村,568,137,431,8,576,1368,0,42.11,10.01
屏東縣,新園鄉,港西村,797,246,551,10,807,2061,0,39.16,11.94
屏東縣,新園鄉,五房村,1058,338,720,12,1070,2733,0,39.15,12.37
屏東縣,新園鄉,鹽埔村,1610,408,1202,22,1632,4335,0,37.65,9.41
屏東縣,新園鄉,共和村,775,159,616,13,788,2284,0,34.5,6.96
屏東縣,新園鄉,合計,11626,3305,8321,140,11766,29974,33639,39.25,11.03
屏東縣,崁頂鄉,崁頂村,842,301,541,10,852,2220,0,38.38,13.56
屏東縣,崁頂鄉,園寮村,796,303,493,6,802,1996,0,40.18,15.18
屏東縣,崁頂鄉,圍內村,492,173,319,5,497,1200,0,41.42,14.42
屏東縣,崁頂鄉,力社村,506,150,356,7,513,1272,0,40.33,11.79
屏東縣,崁頂鄉,洲子村,368,117,251,5,373,1046,0,35.66,11.19
屏東縣,崁頂鄉,北勢村,602,187,415,13,615,1466,0,41.95,12.76
屏東縣,崁頂鄉,越溪村,355,114,241,3,358,905,0,39.56,12.6
屏東縣,崁頂鄉,港東村,724,199,525,5,729,1834,0,39.75,10.85
屏東縣,崁頂鄉,合計,4685,1544,3141,54,4739,11939,15223,39.69,12.93
屏東縣,林邊鄉,林邊村,624,197,427,5,629,1392,0,45.19,14.15
屏東縣,林邊鄉,光林村,623,192,431,6,629,1509,0,41.68,12.72
屏東縣,林邊鄉,仁和村,691,218,473,9,700,1603,0,43.67,13.6
屏東縣,林邊鄉,中林村,322,125,197,4,326,690,0,47.25,18.12
屏東縣,林邊鄉,永樂村,1372,438,934,18,1390,3098,0,44.87,14.14
屏東縣,林邊鄉,水利村,641,247,394,13,654,1761,0,37.14,14.03
屏東縣,林邊鄉,崎峯村,425,140,285,13,438,1241,0,35.29,11.28
屏東縣,林邊鄉,田厝村,351,112,239,4,355,895,0,39.66,12.51
屏東縣,林邊鄉,竹林村,754,226,528,11,765,1885,0,40.58,11.99
屏東縣,林邊鄉,鎮安村,462,157,305,9,471,1086,0,43.37,14.46
屏東縣,林邊鄉,合計,6265,2052,4213,92,6357,15160,17145,41.93,13.54
屏東縣,南州鄉,溪洲村,691,239,452,4,695,1652,0,42.07,14.47
屏東縣,南州鄉,溪南村,396,140,256,3,399,908,0,43.94,15.42
屏東縣,南州鄉,仁里村,219,85,134,4,223,487,0,45.79,17.45
屏東縣,南州鄉,溪北村,309,175,134,2,311,673,0,46.21,26.0
屏東縣,南州鄉,七塊村,363,128,235,6,369,1011,0,36.5,12.66
屏東縣,南州鄉,萬華村,367,133,234,1,368,965,0,38.13,13.78
屏東縣,南州鄉,米崙村,456,175,281,4,460,1028,0,44.75,17.02
屏東縣,南州鄉,壽元村,425,70,355,6,431,1050,0,41.05,6.67
屏東縣,南州鄉,同安村,419,94,325,7,426,965,0,44.15,9.74
屏東縣,南州鄉,南安村,235,64,171,5,240,515,0,46.6,12.43
屏東縣,南州鄉,合計,3880,1303,2577,42,3922,9254,10249,42.38,14.08
屏東縣,佳冬鄉,佳冬村,586,205,381,4,590,1467,0,40.22,13.97
屏東縣,佳冬鄉,六根村,542,191,351,6,548,1302,0,42.09,14.67
屏東縣,佳冬鄉,賴家村,343,93,250,2,345,733,0,47.07,12.69
屏東縣,佳冬鄉,萬建村,692,241,451,4,696,1793,0,38.82,13.44
屏東縣,佳冬鄉,石光村,801,208,593,8,809,1922,0,42.09,10.82
屏東縣,佳冬鄉,玉光村,794,202,592,12,806,2056,0,39.2,9.82
屏東縣,佳冬鄉,昌隆村,399,119,280,11,410,936,0,43.8,12.71
屏東縣,佳冬鄉,豐隆村,273,94,179,4,277,674,0,41.1,13.95
屏東縣,佳冬鄉,大同村,447,113,334,7,454,1138,0,39.89,9.93
屏東縣,佳冬鄉,羌園村,416,105,311,3,419,1061,0,39.49,9.9
屏東縣,佳冬鄉,燄溫村,356,121,235,4,360,1072,0,33.58,11.29
屏東縣,佳冬鄉,塭豐村,773,332,441,10,783,2355,0,33.25,14.1
屏東縣,佳冬鄉,合計,6422,2024,4398,75,6497,16509,18414,39.35,12.26
屏東縣,琉球鄉,本福村,501,241,260,3,504,2066,0,24.39,11.67
屏東縣,琉球鄉,中福村,270,138,132,4,274,1247,0,21.97,11.07
屏東縣,琉球鄉,漁福村,226,152,74,0,226,975,0,23.18,15.59
屏東縣,琉球鄉,大福村,292,179,113,1,293,1617,0,18.12,11.07
屏東縣,琉球鄉,南福村,193,102,91,1,194,1117,0,17.37,9.13
屏東縣,琉球鄉,天福村,198,116,82,0,198,1101,0,17.98,10.54
屏東縣,琉球鄉,上福村,258,150,108,4,262,1622,0,16.15,9.25
屏東縣,琉球鄉,杉福村,170,87,83,3,173,850,0,20.35,10.24
屏東縣,琉球鄉,合計,2108,1165,943,16,2124,10595,12095,20.05,11.0
屏東縣,車城鄉,福興村,488,208,280,4,492,1315,0,37.41,15.82
屏東縣,車城鄉,福安村,226,62,164,1,227,534,0,42.51,11.61
屏東縣,車城鄉,田中村,157,63,94,1,158,610,0,25.9,10.33
屏東縣,車城鄉,海口村,202,87,115,6,208,717,0,29.01,12.13
屏東縣,車城鄉,統埔村,111,43,68,0,111,370,0,30.0,11.62
屏東縣,車城鄉,溫泉村,269,111,158,4,273,837,0,32.62,13.26
屏東縣,車城鄉,保力村,349,147,202,11,360,1197,0,30.08,12.28
屏東縣,車城鄉,新街村,145,32,113,3,148,418,0,35.41,7.66
屏東縣,車城鄉,埔墘村,111,57,54,1,112,412,0,27.18,13.83
屏東縣,車城鄉,射寮村,150,74,76,4,154,481,0,32.02,15.38
屏東縣,車城鄉,後灣村,154,66,88,4,158,399,0,39.6,16.54
屏東縣,車城鄉,合計,2362,950,1412,39,2401,7290,8221,32.94,13.03
屏東縣,滿州鄉,滿州村,423,205,218,4,427,1429,0,29.88,14.35
屏東縣,滿州鄉,里德村,119,58,61,1,120,392,0,30.61,14.8
屏東縣,滿州鄉,永靖村,371,168,203,3,374,1208,0,30.96,13.91
屏東縣,滿州鄉,港口村,392,130,262,3,395,1223,0,32.3,10.63
屏東縣,滿州鄉,响林村,147,48,99,1,148,526,0,28.14,9.13
屏東縣,滿州鄉,長樂村,267,141,126,5,272,1255,0,21.67,11.24
屏東縣,滿州鄉,九棚村,90,39,51,0,90,348,0,25.86,11.21
屏東縣,滿州鄉,港仔村,98,43,55,0,98,305,0,32.13,14.1
屏東縣,滿州鄉,合計,1907,832,1075,17,1924,6686,7397,28.78,12.44
屏東縣,枋山鄉,枋山村,352,176,176,9,361,966,0,37.37,18.22
屏東縣,枋山鄉,加祿村,697,224,473,5,702,1872,0,37.5,11.97
屏東縣,枋山鄉,楓港村,289,73,216,5,294,962,0,30.56,7.59
屏東縣,枋山鄉,善餘村,245,77,168,6,251,837,0,29.99,9.2
屏東縣,枋山鄉,合計,1583,550,1033,25,1608,4637,5145,34.68,11.86
屏東縣,三地門鄉,三地村,550,434,116,16,566,1460,0,38.77,29.73
屏東縣,三地門鄉,達來村,95,57,38,1,96,341,0,28.15,16.72
屏東縣,三地門鄉,德文村,87,56,31,1,88,566,0,15.55,9.89
屏東縣,三地門鄉,大社村,170,141,29,8,178,639,0,27.86,22.07
屏東縣,三地門鄉,賽嘉村,217,160,57,4,221,725,0,30.48,22.07
屏東縣,三地門鄉,口社村,190,141,49,3,193,550,0,35.09,25.64
屏東縣,三地門鄉,馬兒村,101,68,33,0,101,341,0,29.62,19.94
屏東縣,三地門鄉,安坡村,156,112,44,2,158,468,0,33.76,23.93
屏東縣,三地門鄉,青山村,199,168,31,5,204,694,0,29.39,24.21
屏東縣,三地門鄉,青葉村,166,134,32,2,168,617,0,27.23,21.72
屏東縣,三地門鄉,合計,1931,1471,460,42,1973,6401,7691,30.82,22.98
屏東縣,霧臺鄉,霧台村,348,238,110,3,351,1089,0,32.23,21.85
屏東縣,霧臺鄉,阿禮村,106,89,17,1,107,297,0,36.03,29.97
屏東縣,霧臺鄉,吉露村,72,54,18,0,72,183,0,39.34,29.51
屏東縣,霧臺鄉,大武村,67,45,22,1,68,441,0,15.42,10.2
屏東縣,霧臺鄉,佳暮村,150,127,23,1,151,356,0,42.42,35.67
屏東縣,霧臺鄉,好茶村,183,112,71,4,187,476,0,39.29,23.53
屏東縣,霧臺鄉,合計,926,665,261,10,936,2842,3230,32.93,23.4
屏東縣,瑪家鄉,瑪家村,161,118,43,1,162,443,0,36.57,26.64
屏東縣,瑪家鄉,北葉村,311,243,68,2,313,771,0,40.6,31.52
屏東縣,瑪家鄉,凉山村,282,224,58,1,283,1041,0,27.19,21.52
屏東縣,瑪家鄉,佳義村,306,206,100,4,310,887,0,34.95,23.22
屏東縣,瑪家鄉,排灣村,135,112,23,0,135,419,0,32.22,26.73
屏東縣,瑪家鄉,三和村,782,639,143,7,789,2049,0,38.51,31.19
屏東縣,瑪家鄉,合計,1977,1542,435,15,1992,5610,6706,35.51,27.49
屏東縣,泰武鄉,佳平村,324,271,53,3,327,844,0,38.74,32.11
屏東縣,泰武鄉,武潭村,336,254,82,7,343,950,0,36.11,26.74
屏東縣,泰武鄉,平和村,211,124,87,2,213,610,0,34.92,20.33
屏東縣,泰武鄉,佳興村,118,99,19,0,118,408,0,28.92,24.26
屏東縣,泰武鄉,泰武村,206,176,30,5,211,772,0,27.33,22.8
屏東縣,泰武鄉,萬安村,255,226,29,0,255,748,0,34.09,30.21
屏東縣,泰武鄉,合計,1450,1150,300,17,1467,4332,5365,33.86,26.55
屏東縣,來義鄉,來義村,257,215,42,1,258,909,0,28.38,23.65
屏東縣,來義鄉,義林村,196,151,45,1,197,586,0,33.62,25.77
屏東縣,來義鄉,丹林村,262,226,36,0,262,709,0,36.95,31.88
屏東縣,來義鄉,古樓村,404,340,64,5,409,1112,0,36.78,30.58
屏東縣,來義鄉,文樂村,295,239,56,4,299,840,0,35.6,28.45
屏東縣,來義鄉,望嘉村,350,310,40,0,350,864,0,40.51,35.88
屏東縣,來義鄉,南和村,411,345,66,7,418,1197,0,34.92,28.82
屏東縣,來義鄉,合計,2175,1826,349,18,2193,6217,7400,35.27,29.37
屏東縣,春日鄉,春日村,190,151,39,3,193,923,0,20.91,16.36
屏東縣,春日鄉,古華村,188,130,58,1,189,685,0,27.59,18.98
屏東縣,春日鄉,士文村,56,38,18,5,61,311,0,19.61,12.22
屏東縣,春日鄉,七佳村,282,222,60,5,287,940,0,30.53,23.62
屏東縣,春日鄉,歸崇村,166,121,45,11,177,647,0,27.36,18.7
屏東縣,春日鄉,力里村,124,94,30,8,132,469,0,28.14,20.04
屏東縣,春日鄉,合計,1006,756,250,33,1039,3975,4912,26.14,19.02
屏東縣,獅子鄉,楓林村,224,173,51,2,226,702,0,32.19,24.64
屏東縣,獅子鄉,丹路村,204,170,34,3,207,759,0,27.27,22.4
屏東縣,獅子鄉,草埔村,212,184,28,5,217,626,0,34.66,29.39
屏東縣,獅子鄉,內文村,73,61,12,0,73,229,0,31.88,26.64
屏東縣,獅子鄉,竹坑村,98,74,24,0,98,293,0,33.45,25.26
屏東縣,獅子鄉,獅子村,147,122,25,0,147,490,0,30.0,24.9
屏東縣,獅子鄉,內獅村,220,183,37,5,225,624,0,36.06,29.33
屏東縣,獅子鄉,南世村,113,95,18,2,115,369,0,31.17,25.75
屏東縣,獅子鄉,合計,1291,1062,229,17,1308,4092,4805,31.96,25.95
屏東縣,牡丹鄉,石門村,499,387,112,7,506,1579,0,32.05,24.51
屏東縣,牡丹鄉,牡丹村,224,197,27,5,229,645,0,35.5,30.54
屏東縣,牡丹鄉,東源村,147,122,25,3,150,435,0,34.48,28.05
屏東縣,牡丹鄉,旭海村,127,94,33,3,130,359,0,36.21,26.18
屏東縣,牡丹鄉,高士村,151,114,37,1,152,567,0,26.81,20.11
屏東縣,牡丹鄉,四林村,103,76,27,5,108,549,0,19.67,13.84
屏東縣,牡丹鄉,合計,1251,990,261,24,1275,4134,4860,30.84,23.95
屏東縣,合計,合計,278332,111215,167117,2955,281287,700254,807970,40.17,15.88
宜蘭縣,宜蘭市,神農里,1056,555,501,7,1063,2534,0,41.95,21.9
宜蘭縣,宜蘭市,民權里,597,322,275,4,601,1744,0,34.46,18.46
宜蘭縣,宜蘭市,進士里,925,464,461,6,931,2115,0,44.02,21.94
宜蘭縣,宜蘭市,南橋里,523,218,305,7,530,1269,0,41.77,17.18
宜蘭縣,宜蘭市,建業里,843,368,475,8,851,1962,0,43.37,18.76
宜蘭縣,宜蘭市,南津里,881,474,407,9,890,2131,0,41.76,22.24
宜蘭縣,宜蘭市,凱旋里,519,215,304,7,526,1298,0,40.52,16.56
宜蘭縣,宜蘭市,黎明里,720,313,407,5,725,1846,0,39.27,16.96
宜蘭縣,宜蘭市,東村里,845,399,446,7,852,2200,0,38.73,18.14
宜蘭縣,宜蘭市,延平里,1190,599,591,12,1202,3263,0,36.84,18.36
宜蘭縣,宜蘭市,七張里,532,198,334,8,540,1459,0,37.01,13.57
宜蘭縣,宜蘭市,慈安里,604,291,313,7,611,1801,0,33.93,16.16
宜蘭縣,宜蘭市,新民里,653,264,389,6,659,1464,0,45.01,18.03
宜蘭縣,宜蘭市,東門里,402,136,266,0,402,951,0,42.27,14.3
宜蘭縣,宜蘭市,小東里,636,284,352,5,641,1595,0,40.19,17.81
宜蘭縣,宜蘭市,菜園里,523,239,284,4,527,1334,0,39.51,17.92
宜蘭縣,宜蘭市,孝廉里,448,164,284,2,450,1122,0,40.11,14.62
宜蘭縣,宜蘭市,新生里,947,356,591,6,953,2678,0,35.59,13.29
宜蘭縣,宜蘭市,茭白里,766,333,433,9,775,2080,0,37.26,16.01
宜蘭縣,宜蘭市,北津里,824,311,513,11,835,2200,0,37.95,14.14
宜蘭縣,宜蘭市,梅洲里,1151,415,736,12,1163,3159,0,36.82,13.14
宜蘭縣,宜蘭市,北門里,487,182,305,5,492,1112,0,44.24,16.37
宜蘭縣,宜蘭市,中山里,345,157,188,5,350,902,0,38.8,17.41
宜蘭縣,宜蘭市,西門里,739,274,465,6,745,1736,0,42.91,15.78
宜蘭縣,宜蘭市,南門里,553,246,307,3,556,1330,0,41.8,18.5
宜蘭縣,宜蘭市,負郭里,1185,542,643,4,1189,2908,0,40.89,18.64
宜蘭縣,宜蘭市,民族里,937,492,445,12,949,2157,0,44.0,22.81
宜蘭縣,宜蘭市,建軍里,649,319,330,5,654,1576,0,41.5,20.24
宜蘭縣,宜蘭市,思源里,1763,990,773,13,1776,4247,0,41.82,23.31
宜蘭縣,宜蘭市,文化里,1226,622,604,10,1236,2966,0,41.67,20.97
宜蘭縣,宜蘭市,復興里,1082,598,484,7,1089,2613,0,41.68,22.89
宜蘭縣,宜蘭市,成功里,1146,552,594,14,1160,3044,0,38.11,18.13
宜蘭縣,宜蘭市,新東里,1174,601,573,9,1183,3099,0,38.17,19.39
宜蘭縣,宜蘭市,七結里,1097,586,511,5,1102,2533,0,43.51,23.13
宜蘭縣,宜蘭市,泰山里,654,348,306,6,660,1969,0,33.52,17.67
宜蘭縣,宜蘭市,大新里,303,139,164,4,307,770,0,39.87,18.05
宜蘭縣,宜蘭市,中興里,1017,470,547,4,1021,2844,0,35.9,16.53
宜蘭縣,宜蘭市,擺厘里,1228,588,640,11,1239,2875,0,43.1,20.45
宜蘭縣,宜蘭市,合計,31170,14624,16546,265,31435,78886,95269,39.85,18.54
宜蘭縣,羅東鎮,大新里,618,265,353,7,625,1532,0,40.8,17.3
宜蘭縣,羅東鎮,東安里,1289,497,792,17,1306,3501,0,37.3,14.2
宜蘭縣,羅東鎮,新群里,1053,375,678,6,1059,2687,0,39.41,13.96
宜蘭縣,羅東鎮,羅莊里,1188,520,668,9,1197,3002,0,39.87,17.32
宜蘭縣,羅東鎮,南昌里,871,379,492,9,880,2352,0,37.41,16.11
宜蘭縣,羅東鎮,南豪里,548,230,318,9,557,1294,0,43.04,17.77
宜蘭縣,羅東鎮,成功里,630,268,362,3,633,1501,0,42.17,17.85
宜蘭縣,羅東鎮,仁德里,488,207,281,2,490,1123,0,43.63,18.43
宜蘭縣,羅東鎮,漢民里,1422,619,803,9,1431,3579,0,39.98,17.3
宜蘭縣,羅東鎮,西安里,1085,455,630,8,1093,2799,0,39.05,16.26
宜蘭縣,羅東鎮,北成里,1085,447,638,17,1102,2795,0,39.43,15.99
宜蘭縣,羅東鎮,賢文里,1389,639,750,14,1403,3502,0,40.06,18.25
宜蘭縣,羅東鎮,公正里,1128,452,676,10,1138,2641,0,43.09,17.11
宜蘭縣,羅東鎮,集祥里,369,144,225,5,374,1099,0,34.03,13.1
宜蘭縣,羅東鎮,信義里,1225,522,703,11,1236,2919,0,42.34,17.88
宜蘭縣,羅東鎮,竹林里,1158,447,711,16,1174,2844,0,41.28,15.72
宜蘭縣,羅東鎮,仁愛里,1488,609,879,8,1496,3570,0,41.9,17.06
宜蘭縣,羅東鎮,樹林里,1553,725,828,14,1567,3337,0,46.96,21.73
宜蘭縣,羅東鎮,國華里,1775,788,987,10,1785,4280,0,41.71,18.41
宜蘭縣,羅東鎮,維揚里,1245,520,725,4,1249,2960,0,42.2,17.57
宜蘭縣,羅東鎮,開明里,569,209,360,7,576,1355,0,42.51,15.42
宜蘭縣,羅東鎮,中山里,535,173,362,4,539,1343,0,40.13,12.88
宜蘭縣,羅東鎮,仁和里,383,142,241,2,385,978,0,39.37,14.52
宜蘭縣,羅東鎮,合計,23094,9632,13462,201,23295,56993,71097,40.87,16.9
宜蘭縣,蘇澳鎮,龍德里,1201,441,760,18,1219,3347,0,36.42,13.18
宜蘭縣,蘇澳鎮,頂寮里,381,128,253,4,385,1020,0,37.75,12.55
宜蘭縣,蘇澳鎮,永榮里,1383,513,870,10,1393,3753,0,37.12,13.67
宜蘭縣,蘇澳鎮,存仁里,348,112,236,4,352,861,0,40.88,13.01
宜蘭縣,蘇澳鎮,港邊里,497,175,322,9,506,1218,0,41.54,14.37
宜蘭縣,蘇澳鎮,隘丁里,1151,443,708,11,1162,3062,0,37.95,14.47
宜蘭縣,蘇澳鎮,新城里,575,214,361,10,585,1452,0,40.29,14.74
宜蘭縣,蘇澳鎮,聖湖里,795,407,388,8,803,2219,0,36.19,18.34
宜蘭縣,蘇澳鎮,蘇西里,888,381,507,6,894,2348,0,38.07,16.23
宜蘭縣,蘇澳鎮,蘇北里,376,186,190,7,383,953,0,40.19,19.52
宜蘭縣,蘇澳鎮,蘇南里,217,96,121,0,217,437,0,49.66,21.97
宜蘭縣,蘇澳鎮,蘇東里,165,81,84,2,167,499,0,33.47,16.23
宜蘭縣,蘇澳鎮,長安里,183,79,104,2,185,521,0,35.51,15.16
宜蘭縣,蘇澳鎮,永光里,184,101,83,1,185,431,0,42.92,23.43
宜蘭縣,蘇澳鎮,永春里,192,73,119,2,194,573,0,33.86,12.74
宜蘭縣,蘇澳鎮,永樂里,153,67,86,0,153,439,0,34.85,15.26
宜蘭縣,蘇澳鎮,南安里,330,146,184,4,334,909,0,36.74,16.06
宜蘭縣,蘇澳鎮,南正里,334,109,225,1,335,893,0,37.51,12.21
宜蘭縣,蘇澳鎮,南成里,328,115,213,9,337,1052,0,32.03,10.93
宜蘭縣,蘇澳鎮,南興里,425,183,242,13,438,1414,0,30.98,12.94
宜蘭縣,蘇澳鎮,南寧里,342,146,196,9,351,1011,0,34.72,14.44
宜蘭縣,蘇澳鎮,南建里,400,126,274,8,408,1165,0,35.02,10.82
宜蘭縣,蘇澳鎮,東澳里,88,42,46,3,91,330,0,27.58,12.73
宜蘭縣,蘇澳鎮,南強里,221,71,150,5,226,691,0,32.71,10.27
宜蘭縣,蘇澳鎮,朝陽里,212,59,153,4,216,584,0,36.99,10.1
宜蘭縣,蘇澳鎮,聖愛里,920,376,544,5,925,2734,0,33.83,13.75
宜蘭縣,蘇澳鎮,合計,12289,4870,7419,155,12444,33916,38592,36.69,14.36
宜蘭縣,頭城鎮,石城里,81,29,52,0,81,304,0,26.64,9.54
宜蘭縣,頭城鎮,大里里,193,94,99,3,196,676,0,28.99,13.91
宜蘭縣,頭城鎮,大溪里,262,102,160,5,267,874,0,30.55,11.67
宜蘭縣,頭城鎮,合興里,85,39,46,1,86,345,0,24.93,11.3
宜蘭縣,頭城鎮,更新里,351,154,197,11,362,1352,0,26.78,11.39
宜蘭縣,頭城鎮,外澳里,238,111,127,5,243,862,0,28.19,12.88
宜蘭縣,頭城鎮,港口里,214,81,133,2,216,678,0,31.86,11.95
宜蘭縣,頭城鎮,武營里,566,293,273,7,573,1576,0,36.36,18.59
宜蘭縣,頭城鎮,大坑里,473,214,259,9,482,1356,0,35.55,15.78
宜蘭縣,頭城鎮,城東里,305,161,144,2,307,710,0,43.24,22.68
宜蘭縣,頭城鎮,城北里,200,117,83,0,200,488,0,40.98,23.98
宜蘭縣,頭城鎮,城西里,194,104,90,1,195,533,0,36.59,19.51
宜蘭縣,頭城鎮,城南里,266,146,120,1,267,645,0,41.4,22.64
宜蘭縣,頭城鎮,竹安里,572,257,315,10,582,2076,0,28.03,12.38
宜蘭縣,頭城鎮,新建里,698,337,361,10,708,2044,0,34.64,16.49
宜蘭縣,頭城鎮,拔雅里,716,353,363,10,726,2076,0,34.97,17.0
宜蘭縣,頭城鎮,福成里,294,130,164,5,299,931,0,32.12,13.96
宜蘭縣,頭城鎮,金面里,595,305,290,3,598,1711,0,34.95,17.83
宜蘭縣,頭城鎮,金盈里,225,114,111,2,227,692,0,32.8,16.47
宜蘭縣,頭城鎮,頂埔里,487,239,248,6,493,1301,0,37.89,18.37
宜蘭縣,頭城鎮,下埔里,307,128,179,4,311,909,0,34.21,14.08
宜蘭縣,頭城鎮,中崙里,309,139,170,4,313,1008,0,31.05,13.79
宜蘭縣,頭城鎮,二城里,340,148,192,6,346,1090,0,31.74,13.58
宜蘭縣,頭城鎮,龜山里,227,97,130,3,230,705,0,32.62,13.76
宜蘭縣,頭城鎮,合計,8198,3892,4306,110,8308,24942,28673,33.31,15.6
宜蘭縣,礁溪鄉,白雲村,526,215,311,7,533,1601,0,33.29,13.43
宜蘭縣,礁溪鄉,玉石村,704,314,390,9,713,1954,0,36.49,16.07
宜蘭縣,礁溪鄉,德陽村,1491,795,696,16,1507,3987,0,37.8,19.94
宜蘭縣,礁溪鄉,大忠村,920,454,466,14,934,2517,0,37.11,18.04
宜蘭縣,礁溪鄉,大義村,231,102,129,1,232,620,0,37.42,16.45
宜蘭縣,礁溪鄉,六結村,576,285,291,6,582,1372,0,42.42,20.77
宜蘭縣,礁溪鄉,二龍村,447,159,288,1,448,1198,0,37.4,13.27
宜蘭縣,礁溪鄉,時潮村,522,151,371,8,530,1460,0,36.3,10.34
宜蘭縣,礁溪鄉,玉田村,831,266,565,6,837,2114,0,39.59,12.58
宜蘭縣,礁溪鄉,三民村,846,314,532,8,854,2406,0,35.49,13.05
宜蘭縣,礁溪鄉,林美村,340,107,233,6,346,1132,0,30.57,9.45
宜蘭縣,礁溪鄉,白鵝村,292,116,176,5,297,830,0,35.78,13.98
宜蘭縣,礁溪鄉,玉光村,422,170,252,4,426,1059,0,40.23,16.05
宜蘭縣,礁溪鄉,光武村,477,181,296,6,483,1359,0,35.54,13.32
宜蘭縣,礁溪鄉,吳沙村,1030,380,650,12,1042,2526,0,41.25,15.04
宜蘭縣,礁溪鄉,龍潭村,1222,407,815,14,1236,3316,0,37.27,12.27
宜蘭縣,礁溪鄉,匏崙村,328,132,196,2,330,921,0,35.83,14.33
宜蘭縣,礁溪鄉,二結村,179,45,134,2,181,422,0,42.89,10.66
宜蘭縣,礁溪鄉,合計,11384,4593,6791,127,11511,30794,35091,37.38,14.92
宜蘭縣,壯圍鄉,吉祥村,978,409,569,8,986,2606,0,37.84,15.69
宜蘭縣,壯圍鄉,美福村,693,298,395,4,697,1928,0,36.15,15.46
宜蘭縣,壯圍鄉,新南村,364,134,230,7,371,931,0,39.85,14.39
宜蘭縣,壯圍鄉,東港村,282,90,192,1,283,979,0,28.91,9.19
宜蘭縣,壯圍鄉,復興村,516,156,360,9,525,1599,0,32.83,9.76
宜蘭縣,壯圍鄉,過嶺村,484,160,324,6,490,1492,0,32.84,10.72
宜蘭縣,壯圍鄉,永鎮村,306,96,210,2,308,792,0,38.89,12.12
宜蘭縣,壯圍鄉,忠孝村,873,304,569,13,886,2369,0,37.4,12.83
宜蘭縣,壯圍鄉,古亭村,588,217,371,7,595,1580,0,37.66,13.73
宜蘭縣,壯圍鄉,功勞村,498,179,319,8,506,1240,0,40.81,14.44
宜蘭縣,壯圍鄉,美城村,849,343,506,11,860,2246,0,38.29,15.27
宜蘭縣,壯圍鄉,新社村,379,133,246,8,387,1058,0,36.58,12.57
宜蘭縣,壯圍鄉,大福村,559,204,355,8,567,1756,0,32.29,11.62
宜蘭縣,壯圍鄉,古結村,421,160,261,1,422,1124,0,37.54,14.23
宜蘭縣,壯圍鄉,合計,7790,2883,4907,93,7883,21700,24419,36.33,13.29
宜蘭縣,員山鄉,員山村,2137,929,1208,26,2163,5810,0,37.23,15.99
宜蘭縣,員山鄉,尚德村,755,302,453,11,766,2164,0,35.4,13.96
宜蘭縣,員山鄉,惠好村,670,228,442,8,678,1676,0,40.45,13.6
宜蘭縣,員山鄉,七賢村,554,244,310,4,558,1505,0,37.08,16.21
宜蘭縣,員山鄉,深溝村,776,307,469,2,778,1941,0,40.08,15.82
宜蘭縣,員山鄉,蓁巷村,439,138,301,8,447,1249,0,35.79,11.05
宜蘭縣,員山鄉,內城村,448,203,245,13,461,1436,0,32.1,14.14
宜蘭縣,員山鄉,中華村,225,75,150,5,230,608,0,37.83,12.34
宜蘭縣,員山鄉,永和村,654,243,411,7,661,1818,0,36.36,13.37
宜蘭縣,員山鄉,頭分村,467,191,276,12,479,1340,0,35.75,14.25
宜蘭縣,員山鄉,枕山村,869,255,614,6,875,2277,0,38.43,11.2
宜蘭縣,員山鄉,同樂村,888,303,585,10,898,2403,0,37.37,12.61
宜蘭縣,員山鄉,湖東村,308,115,193,1,309,888,0,34.8,12.95
宜蘭縣,員山鄉,逸仙村,340,110,230,5,345,926,0,37.26,11.88
宜蘭縣,員山鄉,湖北村,349,128,221,5,354,997,0,35.51,12.84
宜蘭縣,員山鄉,湖西村,444,146,298,10,454,1363,0,33.31,10.71
宜蘭縣,員山鄉,合計,10323,3917,6406,133,10456,28401,32189,36.82,13.79
宜蘭縣,冬山鄉,武淵村,469,134,335,4,473,1262,0,37.48,10.62
宜蘭縣,冬山鄉,珍珠村,694,223,471,11,705,1625,0,43.38,13.72
宜蘭縣,冬山鄉,補城村,455,169,286,3,458,1136,0,40.32,14.88
宜蘭縣,冬山鄉,三奇村,320,120,200,2,322,894,0,36.02,13.42
宜蘭縣,冬山鄉,大興村,348,93,255,7,355,867,0,40.95,10.73
宜蘭縣,冬山鄉,東城村,546,180,366,4,550,1409,0,39.03,12.78
宜蘭縣,冬山鄉,香和村,1092,385,707,13,1105,2951,0,37.44,13.05
宜蘭縣,冬山鄉,南興村,1173,418,755,10,1183,2943,0,40.2,14.2
宜蘭縣,冬山鄉,冬山村,313,127,186,7,320,673,0,47.55,18.87
宜蘭縣,冬山鄉,安平村,281,71,210,3,284,709,0,40.06,10.01
宜蘭縣,冬山鄉,太和村,647,194,453,8,655,1498,0,43.72,12.95
宜蘭縣,冬山鄉,八寶村,357,112,245,4,361,870,0,41.49,12.87
宜蘭縣,冬山鄉,丸山村,546,151,395,3,549,1512,0,36.31,9.99
宜蘭縣,冬山鄉,中山村,206,68,138,2,208,474,0,43.88,14.35
宜蘭縣,冬山鄉,順安村,1828,632,1196,21,1849,4962,0,37.26,12.74
宜蘭縣,冬山鄉,永美村,1193,420,773,12,1205,3096,0,38.92,13.57
宜蘭縣,冬山鄉,群英村,1897,730,1167,26,1923,4619,0,41.63,15.8
宜蘭縣,冬山鄉,清溝村,1523,608,915,14,1537,3769,0,40.78,16.13
宜蘭縣,冬山鄉,鹿埔村,881,275,606,13,894,2557,0,34.96,10.75
宜蘭縣,冬山鄉,得安村,367,156,211,4,371,1080,0,34.35,14.44
宜蘭縣,冬山鄉,廣興村,927,337,590,10,937,2509,0,37.35,13.43
宜蘭縣,冬山鄉,廣安村,693,289,404,5,698,1680,0,41.55,17.2
宜蘭縣,冬山鄉,柯林村,749,287,462,5,754,1761,0,42.82,16.3
宜蘭縣,冬山鄉,大進村,311,96,215,2,313,780,0,40.13,12.31
宜蘭縣,冬山鄉,合計,17816,6275,11541,193,18009,45636,52999,39.46,13.75
宜蘭縣,五結鄉,三興村,804,271,533,6,810,2052,0,39.47,13.21
宜蘭縣,五結鄉,二結村,787,337,450,8,795,1872,0,42.47,18.0
宜蘭縣,五結鄉,鎮安村,1085,400,685,16,1101,2629,0,41.88,15.21
宜蘭縣,五結鄉,上四村,665,272,393,1,666,1563,0,42.61,17.4
宜蘭縣,五結鄉,中興村,502,177,325,2,504,1350,0,37.33,13.11
宜蘭縣,五結鄉,四結村,1108,463,645,11,1119,2551,0,43.87,18.15
宜蘭縣,五結鄉,福興村,740,265,475,6,746,1777,0,41.98,14.91
宜蘭縣,五結鄉,五結村,1351,539,812,9,1360,3725,0,36.51,14.47
宜蘭縣,五結鄉,大吉村,1442,586,856,6,1448,3727,0,38.85,15.72
宜蘭縣,五結鄉,協和村,1208,405,803,16,1224,3260,0,37.55,12.42
宜蘭縣,五結鄉,孝威村,641,204,437,2,643,1654,0,38.88,12.33
宜蘭縣,五結鄉,錦眾村,553,200,353,4,557,1417,0,39.31,14.11
宜蘭縣,五結鄉,利澤村,674,229,445,8,682,1951,0,34.96,11.74
宜蘭縣,五結鄉,成興村,1147,348,799,8,1155,3177,0,36.36,10.95
宜蘭縣,五結鄉,季新村,1000,314,686,6,1006,2761,0,36.44,11.37
宜蘭縣,五結鄉,合計,13707,5010,8697,109,13816,35466,40343,38.96,14.13
宜蘭縣,三星鄉,員山村,83,43,40,0,83,207,0,40.1,20.77
宜蘭縣,三星鄉,天山村,147,61,86,3,150,498,0,30.12,12.25
宜蘭縣,三星鄉,天福村,234,80,154,5,239,712,0,33.57,11.24
宜蘭縣,三星鄉,雙賢村,243,74,169,5,248,553,0,44.85,13.38
宜蘭縣,三星鄉,人和村,158,72,86,1,159,448,0,35.49,16.07
宜蘭縣,三星鄉,義德村,407,178,229,1,408,1133,0,36.01,15.71
宜蘭縣,三星鄉,集慶村,427,171,256,7,434,1145,0,37.9,14.93
宜蘭縣,三星鄉,月眉村,305,124,181,5,310,870,0,35.63,14.25
宜蘭縣,三星鄉,拱照村,394,142,252,3,397,1358,0,29.23,10.46
宜蘭縣,三星鄉,大隱村,1541,573,968,10,1551,4328,0,35.84,13.24
宜蘭縣,三星鄉,行健村,331,102,229,6,337,890,0,37.87,11.46
宜蘭縣,三星鄉,萬德村,238,82,156,3,241,586,0,41.13,13.99
宜蘭縣,三星鄉,貴林村,188,86,102,4,192,525,0,36.57,16.38
宜蘭縣,三星鄉,萬富村,280,107,173,5,285,731,0,38.99,14.64
宜蘭縣,三星鄉,大義村,523,172,351,3,526,1266,0,41.55,13.59
宜蘭縣,三星鄉,尚武村,287,108,179,3,290,758,0,38.26,14.25
宜蘭縣,三星鄉,大洲村,749,247,502,5,754,1581,0,47.69,15.62
宜蘭縣,三星鄉,尾塹村,607,192,415,5,612,1458,0,41.98,13.17
宜蘭縣,三星鄉,合計,7142,2614,4528,74,7216,19047,21219,37.89,13.72
宜蘭縣,大同鄉,寒溪村,287,251,36,3,290,923,0,31.42,27.19
宜蘭縣,大同鄉,崙埤村,187,169,18,2,189,629,0,30.05,26.87
宜蘭縣,大同鄉,松羅村,200,139,61,4,204,701,0,29.1,19.83
宜蘭縣,大同鄉,復興村,99,56,43,1,100,262,0,38.17,21.37
宜蘭縣,大同鄉,英士村,98,79,19,1,99,325,0,30.46,24.31
宜蘭縣,大同鄉,樂水村,111,97,14,2,113,392,0,28.83,24.74
宜蘭縣,大同鄉,太平村,17,11,6,1,18,54,0,33.33,20.37
宜蘭縣,大同鄉,四季村,184,156,28,4,188,763,0,24.64,20.45
宜蘭縣,大同鄉,南山村,126,93,33,2,128,659,0,19.42,14.11
宜蘭縣,大同鄉,茂安村,58,43,15,0,58,207,0,28.02,20.77
宜蘭縣,大同鄉,合計,1367,1094,273,20,1387,4915,6099,28.22,22.26
宜蘭縣,南澳鄉,南澳村,300,255,45,5,305,1156,0,26.38,22.06
宜蘭縣,南澳鄉,碧候村,236,208,28,3,239,955,0,25.03,21.78
宜蘭縣,南澳鄉,東岳村,153,132,21,0,153,435,0,35.17,30.34
宜蘭縣,南澳鄉,金岳村,86,82,4,2,88,406,0,21.67,20.2
宜蘭縣,南澳鄉,武塔村,131,107,24,2,133,430,0,30.93,24.88
宜蘭縣,南澳鄉,金洋村,125,104,21,2,127,475,0,26.74,21.89
宜蘭縣,南澳鄉,澳花村,230,206,24,6,236,707,0,33.38,29.14
宜蘭縣,南澳鄉,合計,1261,1094,167,20,1281,4564,5956,28.07,23.97
宜蘭縣,合計,合計,145541,60498,85043,1500,147041,385260,451946,38.17,15.7
花蓮縣,花蓮市,民立里,624,416,208,2,626,1592,0,39.32,26.13
花蓮縣,花蓮市,民運里,826,565,261,12,838,1985,0,42.22,28.46
花蓮縣,花蓮市,民族里,169,107,62,0,169,422,0,40.05,25.36
花蓮縣,花蓮市,主信里,271,162,109,4,275,664,0,41.42,24.4
花蓮縣,花蓮市,主睦里,206,130,76,0,206,558,0,36.92,23.3
花蓮縣,花蓮市,主和里,1094,697,397,11,1105,2927,0,37.75,23.81
花蓮縣,花蓮市,國威里,577,337,240,6,583,1769,0,32.96,19.05
花蓮縣,花蓮市,國風里,1250,811,439,11,1261,3186,0,39.58,25.46
花蓮縣,花蓮市,民德里,655,442,213,4,659,1486,0,44.35,29.74
花蓮縣,花蓮市,民意里,805,677,128,14,819,2020,0,40.54,33.51
花蓮縣,花蓮市,主義里,197,131,66,1,198,464,0,42.67,28.23
花蓮縣,花蓮市,主工里,227,135,92,1,228,492,0,46.34,27.44
花蓮縣,花蓮市,主農里,1331,873,458,11,1342,3477,0,38.6,25.11
花蓮縣,花蓮市,國治里,304,186,118,1,305,821,0,37.15,22.66
花蓮縣,花蓮市,國富里,1958,1307,651,18,1976,4822,0,40.98,27.1
花蓮縣,花蓮市,民政里,1534,1088,446,14,1548,3629,0,42.66,29.98
花蓮縣,花蓮市,民勤里,1257,890,367,12,1269,3092,0,41.04,28.78
花蓮縣,花蓮市,民生里,423,240,183,7,430,1077,0,39.93,22.28
花蓮縣,花蓮市,主商里,214,119,95,2,216,537,0,40.22,22.16
花蓮縣,花蓮市,主學里,713,453,260,10,723,1821,0,39.7,24.88
花蓮縣,花蓮市,國光里,466,321,145,5,471,1214,0,38.8,26.44
花蓮縣,花蓮市,國聯里,1020,647,373,6,1026,2759,0,37.19,23.45
花蓮縣,花蓮市,國強里,642,440,202,4,646,1757,0,36.77,25.04
花蓮縣,花蓮市,民心里,379,261,118,4,383,932,0,41.09,28.0
花蓮縣,花蓮市,民樂里,239,169,70,1,240,616,0,38.96,27.44
花蓮縣,花蓮市,民主里,209,153,56,0,209,549,0,38.07,27.87
花蓮縣,花蓮市,主勤里,333,207,126,2,335,763,0,43.91,27.13
花蓮縣,花蓮市,主力里,1049,658,391,6,1055,2643,0,39.92,24.9
花蓮縣,花蓮市,國安里,198,131,67,2,200,496,0,40.32,26.41
花蓮縣,花蓮市,國魂里,775,489,286,12,787,1849,0,42.56,26.45
花蓮縣,花蓮市,國慶里,402,237,165,6,408,1069,0,38.17,22.17
花蓮縣,花蓮市,民享里,1217,912,305,12,1229,3012,0,40.8,30.28
花蓮縣,花蓮市,民有里,222,123,99,0,222,584,0,38.01,21.06
花蓮縣,花蓮市,民權里,173,120,53,0,173,419,0,41.29,28.64
花蓮縣,花蓮市,主計里,304,203,101,2,306,817,0,37.45,24.85
花蓮縣,花蓮市,主權里,1974,1320,654,24,1998,5198,0,38.44,25.39
花蓮縣,花蓮市,國華里,869,550,319,5,874,2120,0,41.23,25.94
花蓮縣,花蓮市,國防里,317,196,121,0,317,816,0,38.85,24.02
花蓮縣,花蓮市,國福里,466,330,136,4,470,1480,0,31.76,22.3
花蓮縣,花蓮市,國裕里,1616,1124,492,12,1628,4171,0,39.03,26.95
花蓮縣,花蓮市,主安里,856,577,279,10,866,2412,0,35.9,23.92
花蓮縣,花蓮市,國盛里,1235,824,411,10,1245,3671,0,33.91,22.45
花蓮縣,花蓮市,國興里,1687,1178,509,11,1698,4204,0,40.39,28.02
花蓮縣,花蓮市,民孝里,1406,1026,380,16,1422,3438,0,41.36,29.84
花蓮縣,花蓮市,合計,32689,21962,10727,295,32984,83830,101853,39.35,26.2
花蓮縣,鳳林鎮,鳳仁里,435,307,128,9,444,1166,0,38.08,26.33
花蓮縣,鳳林鎮,鳳義里,261,206,55,5,266,631,0,42.16,32.65
花蓮縣,鳳林鎮,鳳禮里,262,178,84,1,263,575,0,45.74,30.96
花蓮縣,鳳林鎮,鳳智里,408,317,91,4,412,1075,0,38.33,29.49
花蓮縣,鳳林鎮,鳳信里,466,360,106,11,477,1332,0,35.81,27.03
花蓮縣,鳳林鎮,山興里,169,129,40,6,175,539,0,32.47,23.93
花蓮縣,鳳林鎮,大榮里,457,305,152,6,463,1250,0,37.04,24.4
花蓮縣,鳳林鎮,北林里,205,112,93,3,208,538,0,38.66,20.82
花蓮縣,鳳林鎮,南平里,210,137,73,1,211,524,0,40.27,26.15
花蓮縣,鳳林鎮,林榮里,335,237,98,7,342,793,0,43.13,29.89
花蓮縣,鳳林鎮,長橋里,320,215,105,8,328,959,0,34.2,22.42
花蓮縣,鳳林鎮,森榮里,43,36,7,1,44,97,0,45.36,37.11
花蓮縣,鳳林鎮,合計,3571,2539,1032,62,3633,9479,10764,38.33,26.79
花蓮縣,玉里鎮,中城里,1740,1200,540,22,1762,5047,0,34.91,23.78
花蓮縣,玉里鎮,啟模里,474,341,133,8,482,1587,0,30.37,21.49
花蓮縣,玉里鎮,永昌里,334,241,93,6,340,1191,0,28.55,20.24
花蓮縣,玉里鎮,泰昌里,339,260,79,1,340,1281,0,26.54,20.3
花蓮縣,玉里鎮,國武里,446,289,157,5,451,1150,0,39.22,25.13
花蓮縣,玉里鎮,源城里,312,223,89,6,318,1204,0,26.41,18.52
花蓮縣,玉里鎮,長良里,148,113,35,4,152,606,0,25.08,18.65
花蓮縣,玉里鎮,樂合里,281,228,53,6,287,963,0,29.8,23.68
花蓮縣,玉里鎮,東豐里,153,113,40,3,156,521,0,29.94,21.69
花蓮縣,玉里鎮,觀音里,401,305,96,9,410,1500,0,27.33,20.33
花蓮縣,玉里鎮,松浦里,303,236,67,13,316,1449,0,21.81,16.29
花蓮縣,玉里鎮,春日里,248,176,72,14,262,838,0,31.26,21.0
花蓮縣,玉里鎮,德武里,205,164,41,7,212,750,0,28.27,21.87
花蓮縣,玉里鎮,三民里,241,154,87,5,246,864,0,28.47,17.82
花蓮縣,玉里鎮,大禹里,283,213,70,2,285,1039,0,27.43,20.5
花蓮縣,玉里鎮,合計,5908,4256,1652,111,6019,19990,23121,30.11,21.29
花蓮縣,新城鄉,新城村,503,309,194,8,511,1249,0,40.91,24.74
花蓮縣,新城鄉,順安村,306,138,168,12,318,901,0,35.29,15.32
花蓮縣,新城鄉,康樂村,804,557,247,14,818,2413,0,33.9,23.08
花蓮縣,新城鄉,北埔村,1442,1033,409,15,1457,4113,0,35.42,25.12
花蓮縣,新城鄉,佳林村,370,242,128,2,372,992,0,37.5,24.4
花蓮縣,新城鄉,嘉里村,1245,932,313,15,1260,3787,0,33.27,24.61
花蓮縣,新城鄉,嘉新村,390,305,85,8,398,1243,0,32.02,24.54
花蓮縣,新城鄉,大漢村,881,688,193,17,898,2511,0,35.76,27.4
花蓮縣,新城鄉,合計,5941,4204,1737,91,6032,17209,20015,35.05,24.43
花蓮縣,吉安鄉,北昌村,2909,1906,1003,25,2934,7104,0,41.3,26.83
花蓮縣,吉安鄉,勝安村,2015,1297,718,14,2029,4909,0,41.33,26.42
花蓮縣,吉安鄉,太昌村,1271,795,476,30,1301,3726,0,34.92,21.34
花蓮縣,吉安鄉,永安村,1641,1111,530,12,1653,4253,0,38.87,26.12
花蓮縣,吉安鄉,慶豐村,2605,1777,828,22,2627,6951,0,37.79,25.56
花蓮縣,吉安鄉,吉安村,2025,1404,621,18,2043,5283,0,38.67,26.58
花蓮縣,吉安鄉,福興村,1176,746,430,17,1193,2931,0,40.7,25.45
花蓮縣,吉安鄉,南華村,604,355,249,10,614,1568,0,39.16,22.64
花蓮縣,吉安鄉,干城村,415,321,94,4,419,1280,0,32.73,25.08
花蓮縣,吉安鄉,永興村,1008,733,275,10,1018,2922,0,34.84,25.09
花蓮縣,吉安鄉,稻香村,1218,852,366,12,1230,3170,0,38.8,26.88
花蓮縣,吉安鄉,南昌村,1477,1033,444,9,1486,4138,0,35.91,24.96
花蓮縣,吉安鄉,宜昌村,1516,1014,502,10,1526,3933,0,38.8,25.78
花蓮縣,吉安鄉,仁里村,2291,1592,699,22,2313,5995,0,38.58,26.56
花蓮縣,吉安鄉,東昌村,2010,1478,532,29,2039,5503,0,37.05,26.86
花蓮縣,吉安鄉,仁安村,735,489,246,8,743,2360,0,31.48,20.72
花蓮縣,吉安鄉,仁和村,1510,1026,484,12,1522,4520,0,33.67,22.7
花蓮縣,吉安鄉,光華村,755,592,163,12,767,1987,0,38.6,29.79
花蓮縣,吉安鄉,合計,27181,18521,8660,276,27457,72533,83515,37.85,25.53
花蓮縣,壽豐鄉,樹湖村,136,88,48,3,139,352,0,39.49,25.0
花蓮縣,壽豐鄉,溪口村,384,261,123,7,391,1019,0,38.37,25.61
花蓮縣,壽豐鄉,豐山村,651,438,213,12,663,1879,0,35.28,23.31
花蓮縣,壽豐鄉,豐裡村,472,322,150,5,477,1317,0,36.22,24.45
花蓮縣,壽豐鄉,豐坪村,294,212,82,5,299,900,0,33.22,23.56
花蓮縣,壽豐鄉,共和村,317,223,94,2,319,729,0,43.76,30.59
花蓮縣,壽豐鄉,壽豐村,575,381,194,10,585,1627,0,35.96,23.42
花蓮縣,壽豐鄉,光榮村,281,235,46,7,288,772,0,37.31,30.44
花蓮縣,壽豐鄉,池南村,298,194,104,4,302,747,0,40.43,25.97
花蓮縣,壽豐鄉,平和村,530,321,209,10,540,1402,0,38.52,22.9
花蓮縣,壽豐鄉,志學村,935,565,370,6,941,2522,0,37.31,22.4
花蓮縣,壽豐鄉,米棧村,110,83,27,4,114,259,0,44.02,32.05
花蓮縣,壽豐鄉,月眉村,268,214,54,2,270,816,0,33.09,26.23
花蓮縣,壽豐鄉,水璉村,225,165,60,12,237,700,0,33.86,23.57
花蓮縣,壽豐鄉,鹽寮村,167,118,49,1,168,503,0,33.4,23.46
花蓮縣,壽豐鄉,合計,5643,3820,1823,90,5733,15544,17427,36.88,24.58
花蓮縣,光復鄉,大安村,321,210,111,0,321,809,0,39.68,25.96
花蓮縣,光復鄉,大華村,416,263,153,10,426,1258,0,33.86,20.91
花蓮縣,光復鄉,大平村,270,209,61,13,283,918,0,30.83,22.77
花蓮縣,光復鄉,大馬村,253,214,39,5,258,970,0,26.6,22.06
花蓮縣,光復鄉,大同村,352,255,97,5,357,1018,0,35.07,25.05
花蓮縣,光復鄉,大進村,178,137,41,2,180,435,0,41.38,31.49
花蓮縣,光復鄉,大全村,226,147,79,5,231,765,0,30.2,19.22
花蓮縣,光復鄉,大興村,159,134,25,1,160,454,0,35.24,29.52
花蓮縣,光復鄉,大富村,107,65,42,0,107,302,0,35.43,21.52
花蓮縣,光復鄉,大豐村,141,93,48,6,147,409,0,35.94,22.74
花蓮縣,光復鄉,東富村,295,254,41,5,300,990,0,30.3,25.66
花蓮縣,光復鄉,西富村,310,239,71,8,318,928,0,34.27,25.75
花蓮縣,光復鄉,南富村,253,182,71,10,263,820,0,32.07,22.2
花蓮縣,光復鄉,北富村,256,214,42,4,260,880,0,29.55,24.32
花蓮縣,光復鄉,合計,3537,2616,921,74,3611,10956,12280,32.96,23.88
花蓮縣,豐濱鄉,豐濱村,404,313,91,16,420,1596,0,26.32,19.61
花蓮縣,豐濱鄉,新社村,162,127,35,6,168,614,0,27.36,20.68
花蓮縣,豐濱鄉,磯崎村,117,96,21,3,120,390,0,30.77,24.62
花蓮縣,豐濱鄉,港口村,228,161,67,7,235,721,0,32.59,22.33
花蓮縣,豐濱鄉,靜浦村,178,154,24,10,188,645,0,29.15,23.88
花蓮縣,豐濱鄉,合計,1089,851,238,42,1131,3966,4341,28.52,21.46
花蓮縣,瑞穗鄉,瑞穗村,622,438,184,13,635,1828,0,34.74,23.96
花蓮縣,瑞穗鄉,瑞美村,638,442,196,7,645,1800,0,35.83,24.56
花蓮縣,瑞穗鄉,瑞良村,193,131,62,3,196,520,0,37.69,25.19
花蓮縣,瑞穗鄉,瑞祥村,296,197,99,1,297,923,0,32.18,21.34
花蓮縣,瑞穗鄉,瑞北村,160,123,37,7,167,580,0,28.79,21.21
花蓮縣,瑞穗鄉,舞鶴村,300,214,86,6,306,941,0,32.52,22.74
花蓮縣,瑞穗鄉,鶴岡村,250,203,47,3,253,867,0,29.18,23.41
花蓮縣,瑞穗鄉,奇美村,73,60,13,3,76,332,0,22.89,18.07
花蓮縣,瑞穗鄉,富源村,204,143,61,4,208,740,0,28.11,19.32
花蓮縣,瑞穗鄉,富民村,216,182,34,13,229,825,0,27.76,22.06
花蓮縣,瑞穗鄉,富興村,197,118,79,9,206,579,0,35.58,20.38
花蓮縣,瑞穗鄉,合計,3149,2251,898,69,3218,9935,11248,32.39,22.66
花蓮縣,富里鄉,吳江村,126,100,26,3,129,471,0,27.39,21.23
花蓮縣,富里鄉,東里村,228,145,83,9,237,970,0,24.43,14.95
花蓮縣,富里鄉,萬寧村,174,143,31,4,178,613,0,29.04,23.33
花蓮縣,富里鄉,新興村,143,106,37,6,149,573,0,26.0,18.5
花蓮縣,富里鄉,竹田村,319,242,77,1,320,1040,0,30.77,23.27
花蓮縣,富里鄉,羅山村,129,90,39,2,131,428,0,30.61,21.03
花蓮縣,富里鄉,石牌村,230,167,63,9,239,864,0,27.66,19.33
花蓮縣,富里鄉,明里村,132,94,38,2,134,368,0,36.41,25.54
花蓮縣,富里鄉,富里村,398,252,146,8,406,1306,0,31.09,19.3
花蓮縣,富里鄉,永豐村,147,106,41,4,151,442,0,34.16,23.98
花蓮縣,富里鄉,豐南村,161,130,31,8,169,597,0,28.31,21.78
花蓮縣,富里鄉,富南村,132,89,43,6,138,491,0,28.11,18.13
花蓮縣,富里鄉,學田村,192,114,78,11,203,622,0,32.64,18.33
花蓮縣,富里鄉,合計,2511,1778,733,73,2584,8785,9897,29.41,20.24
花蓮縣,秀林鄉,崇德村,382,323,59,2,384,1423,0,26.99,22.7
花蓮縣,秀林鄉,富世村,575,411,164,11,586,1842,0,31.81,22.31
花蓮縣,秀林鄉,秀林村,523,392,131,7,530,1790,0,29.61,21.9
花蓮縣,秀林鄉,水源村,387,327,60,4,391,1188,0,32.91,27.53
花蓮縣,秀林鄉,銅門村,395,330,65,11,406,1217,0,33.36,27.12
花蓮縣,秀林鄉,文蘭村,346,296,50,1,347,1126,0,30.82,26.29
花蓮縣,秀林鄉,景美村,503,377,126,6,509,1791,0,28.42,21.05
花蓮縣,秀林鄉,佳民村,356,306,50,3,359,1048,0,34.26,29.2
花蓮縣,秀林鄉,和平村,458,344,114,2,460,1541,0,29.85,22.32
花蓮縣,秀林鄉,合計,3925,3106,819,47,3972,12966,16204,30.63,23.95
花蓮縣,萬榮鄉,西林村,300,254,46,3,303,1044,0,29.02,24.33
花蓮縣,萬榮鄉,見晴村,121,106,15,0,121,515,0,23.5,20.58
花蓮縣,萬榮鄉,萬榮村,195,161,34,4,199,757,0,26.29,21.27
花蓮縣,萬榮鄉,明利村,181,156,25,3,184,639,0,28.79,24.41
花蓮縣,萬榮鄉,馬遠村,262,209,53,6,268,1075,0,24.93,19.44
花蓮縣,萬榮鄉,紅葉村,261,219,42,1,262,1050,0,24.95,20.86
花蓮縣,萬榮鄉,合計,1320,1105,215,17,1337,5080,6174,26.32,21.75
花蓮縣,卓溪鄉,崙山村,141,129,12,1,142,523,0,27.15,24.67
花蓮縣,卓溪鄉,立山村,233,207,26,9,242,969,0,24.97,21.36
花蓮縣,卓溪鄉,太平村,238,213,25,5,243,691,0,35.17,30.82
花蓮縣,卓溪鄉,卓溪村,192,174,18,2,194,721,0,26.91,24.13
花蓮縣,卓溪鄉,卓清村,231,210,21,5,236,1017,0,23.21,20.65
花蓮縣,卓溪鄉,古風村,288,249,39,5,293,897,0,32.66,27.76
花蓮縣,卓溪鄉,合計,1323,1182,141,27,1350,4818,5997,28.02,24.53
花蓮縣,合計,合計,97787,68191,29596,1274,99061,275091,322836,36.01,24.79
臺東縣,臺東市,富岡里,452,309,143,9,461,1446,0,31.88,21.37
臺東縣,臺東市,富豐里,255,161,94,6,261,865,0,30.17,18.61
臺東縣,臺東市,岩灣里,759,509,250,8,767,2210,0,34.71,23.03
臺東縣,臺東市,南王里,892,611,281,6,898,2796,0,32.12,21.85
臺東縣,臺東市,卑南里,1243,713,530,2,1245,2822,0,44.12,25.27
臺東縣,臺東市,南榮里,895,614,281,10,905,2707,0,33.43,22.68
臺東縣,臺東市,新生里,2327,1536,791,13,2340,6528,0,35.85,23.53
臺東縣,臺東市,民生里,1282,758,524,13,1295,3035,0,42.67,24.98
臺東縣,臺東市,寶桑里,302,167,135,1,303,826,0,36.68,20.22
臺東縣,臺東市,馬蘭里,951,671,280,6,957,2489,0,38.45,26.96
臺東縣,臺東市,中心里,1200,777,423,10,1210,3004,0,40.28,25.87
臺東縣,臺東市,自強里,1591,999,592,8,1599,3981,0,40.17,25.09
臺東縣,臺東市,民族里,481,256,225,1,482,1313,0,36.71,19.5
臺東縣,臺東市,四維里,220,151,69,2,222,638,0,34.8,23.67
臺東縣,臺東市,中華里,564,320,244,4,568,1628,0,34.89,19.66
臺東縣,臺東市,強國里,215,129,86,4,219,620,0,35.32,20.81
臺東縣,臺東市,建國里,399,230,169,2,401,1215,0,33.0,18.93
臺東縣,臺東市,民權里,327,196,131,1,328,813,0,40.34,24.11
臺東縣,臺東市,仁愛里,269,146,123,0,269,683,0,39.39,21.38
臺東縣,臺東市,中正里,348,185,163,0,348,768,0,45.31,24.09
臺東縣,臺東市,大同里,270,169,101,5,275,727,0,37.83,23.25
臺東縣,臺東市,成功里,290,152,138,0,290,762,0,38.06,19.95
臺東縣,臺東市,文化里,244,143,101,1,245,941,0,26.04,15.2
臺東縣,臺東市,中山里,318,187,131,1,319,736,0,43.34,25.41
臺東縣,臺東市,復國里,178,111,67,0,178,575,0,30.96,19.3
臺東縣,臺東市,興國里,269,134,135,2,271,711,0,38.12,18.85
臺東縣,臺東市,復興里,135,84,51,1,136,400,0,34.0,21.0
臺東縣,臺東市,鐵花里,154,83,71,1,155,389,0,39.85,21.34
臺東縣,臺東市,新園里,543,345,198,10,553,1604,0,34.48,21.51
臺東縣,臺東市,豐田里,724,408,316,15,739,2224,0,33.23,18.35
臺東縣,臺東市,豐年里,962,618,344,13,975,3044,0,32.03,20.3
臺東縣,臺東市,光明里,975,667,308,5,980,2559,0,38.3,26.06
臺東縣,臺東市,豐樂里,488,312,176,4,492,1481,0,33.22,21.07
臺東縣,臺東市,永樂里,724,449,275,5,729,2117,0,34.44,21.21
臺東縣,臺東市,康樂里,393,243,150,7,400,1309,0,30.56,18.56
臺東縣,臺東市,東海里,1033,658,375,8,1041,2638,0,39.46,24.94
臺東縣,臺東市,新興里,328,195,133,2,330,940,0,35.11,20.74
臺東縣,臺東市,豐榮里,2905,1949,956,18,2923,8103,0,36.07,24.05
臺東縣,臺東市,豐谷里,1496,1015,481,12,1508,5024,0,30.02,20.2
臺東縣,臺東市,豐里里,745,430,315,9,754,2362,0,31.92,18.2
臺東縣,臺東市,豐原里,408,215,193,15,423,1214,0,34.84,17.71
臺東縣,臺東市,建和里,466,315,151,3,469,1392,0,33.69,22.63
臺東縣,臺東市,建興里,343,194,149,5,348,952,0,36.55,20.38
臺東縣,臺東市,建業里,384,228,156,4,388,1256,0,30.89,18.15
臺東縣,臺東市,知本里,460,301,159,5,465,1365,0,34.07,22.05
臺東縣,臺東市,建農里,570,424,146,15,585,1990,0,29.4,21.31
臺東縣,臺東市,合計,30777,19467,11310,272,31049,87202,104445,35.61,22.32
臺東縣,成功鎮,博愛里,204,169,35,8,212,596,0,35.57,28.36
臺東縣,成功鎮,忠孝里,228,155,73,8,236,935,0,25.24,16.58
臺東縣,成功鎮,三仙里,299,219,80,11,310,1337,0,23.19,16.38
臺東縣,成功鎮,三民里,657,511,146,17,674,2619,0,25.74,19.51
臺東縣,成功鎮,忠智里,576,399,177,8,584,1823,0,32.04,21.89
臺東縣,成功鎮,忠仁里,633,413,220,6,639,2079,0,30.74,19.87
臺東縣,成功鎮,和平里,188,139,49,5,193,725,0,26.62,19.17
臺東縣,成功鎮,信義里,500,397,103,10,510,1773,0,28.76,22.39
臺東縣,成功鎮,合計,3285,2402,883,73,3358,11887,13396,28.25,20.21
臺東縣,關山鎮,德高里,453,302,151,15,468,1682,0,27.82,17.95
臺東縣,關山鎮,豐泉里,381,274,107,1,382,1084,0,35.24,25.28
臺東縣,關山鎮,新福里,271,175,96,18,289,865,0,33.41,20.23
臺東縣,關山鎮,中福里,314,191,123,2,316,752,0,42.02,25.4
臺東縣,關山鎮,里壠里,526,387,139,5,531,1611,0,32.96,24.02
臺東縣,關山鎮,電光里,157,110,47,9,166,528,0,31.44,20.83
臺東縣,關山鎮,月眉里,185,105,80,9,194,689,0,28.16,15.24
臺東縣,關山鎮,合計,2287,1544,743,59,2346,7211,8330,32.53,21.41
臺東縣,卑南鄉,嘉豐村,133,86,47,7,140,486,0,28.81,17.7
臺東縣,卑南鄉,利吉村,155,119,36,0,155,449,0,34.52,26.5
臺東縣,卑南鄉,富山村,150,111,39,4,154,467,0,32.98,23.77
臺東縣,卑南鄉,富源村,119,62,57,1,120,333,0,36.04,18.62
臺東縣,卑南鄉,明峰村,339,194,145,7,346,1149,0,30.11,16.88
臺東縣,卑南鄉,初鹿村,364,233,131,6,370,1236,0,29.94,18.85
臺東縣,卑南鄉,美農村,357,169,188,8,365,1068,0,34.18,15.82
臺東縣,卑南鄉,賓朗村,729,407,322,7,736,2211,0,33.29,18.41
臺東縣,卑南鄉,泰安村,323,213,110,6,329,1122,0,29.32,18.98
臺東縣,卑南鄉,太平村,994,680,314,14,1008,3124,0,32.27,21.77
臺東縣,卑南鄉,利嘉村,396,298,98,12,408,1094,0,37.29,27.24
臺東縣,卑南鄉,東興村,388,324,64,12,400,1133,0,35.3,28.6
臺東縣,卑南鄉,溫泉村,346,142,204,4,350,1066,0,32.83,13.32
臺東縣,卑南鄉,合計,4793,3038,1755,88,4881,14938,16897,32.68,20.34
臺東縣,鹿野鄉,瑞和村,145,92,53,6,151,650,0,23.23,14.15
臺東縣,鹿野鄉,瑞豐村,319,126,193,4,323,871,0,37.08,14.47
臺東縣,鹿野鄉,瑞源村,222,132,90,5,227,835,0,27.19,15.81
臺東縣,鹿野鄉,永安村,427,280,147,0,427,1440,0,29.65,19.44
臺東縣,鹿野鄉,瑞隆村,217,145,72,4,221,858,0,25.76,16.9
臺東縣,鹿野鄉,鹿野村,318,228,90,9,327,1026,0,31.87,22.22
臺東縣,鹿野鄉,龍田村,369,174,195,4,373,1033,0,36.11,16.84
臺東縣,鹿野鄉,合計,2017,1177,840,32,2049,6713,7514,30.52,17.53
臺東縣,池上鄉,福文村,299,169,130,5,304,1091,0,27.86,15.49
臺東縣,池上鄉,慶豐村,213,140,73,7,220,660,0,33.33,21.21
臺東縣,池上鄉,大坡村,72,54,18,3,75,322,0,23.29,16.77
臺東縣,池上鄉,大埔村,253,174,79,5,258,773,0,33.38,22.51
臺東縣,池上鄉,福原村,661,390,271,9,670,1890,0,35.45,20.63
臺東縣,池上鄉,錦園村,95,45,50,3,98,337,0,29.08,13.35
臺東縣,池上鄉,新興村,253,149,104,5,258,832,0,31.01,17.91
臺東縣,池上鄉,萬安村,108,50,58,6,114,304,0,37.5,16.45
臺東縣,池上鄉,富興村,125,88,37,3,128,393,0,32.57,22.39
臺東縣,池上鄉,振興村,79,48,31,2,81,428,0,18.93,11.21
臺東縣,池上鄉,合計,2158,1307,851,48,2206,7030,8018,31.38,18.59
臺東縣,東河鄉,北源村,338,259,79,10,348,1544,0,22.54,16.77
臺東縣,東河鄉,泰源村,247,188,59,9,256,1127,0,22.72,16.68
臺東縣,東河鄉,東河村,265,198,67,3,268,951,0,28.18,20.82
臺東縣,東河鄉,尚德村,81,58,23,1,82,252,0,32.54,23.02
臺東縣,東河鄉,隆昌村,163,113,50,1,164,511,0,32.09,22.11
臺東縣,東河鄉,興昌村,292,180,112,4,296,886,0,33.41,20.32
臺東縣,東河鄉,都蘭村,672,437,235,14,686,2087,0,32.87,20.94
臺東縣,東河鄉,合計,2058,1433,625,42,2100,7358,8123,28.54,19.48
臺東縣,長濱鄉,樟原村,188,143,45,3,191,599,0,31.89,23.87
臺東縣,長濱鄉,三間村,330,278,52,14,344,1145,0,30.04,24.28
臺東縣,長濱鄉,忠勇村,124,83,41,5,129,519,0,24.86,15.99
臺東縣,長濱鄉,長濱村,585,404,181,9,594,1898,0,31.3,21.29
臺東縣,長濱鄉,竹湖村,258,161,97,6,264,853,0,30.95,18.87
臺東縣,長濱鄉,寧埔村,346,282,64,12,358,1154,0,31.02,24.44
臺東縣,長濱鄉,合計,1831,1351,480,49,1880,6168,6828,30.48,21.9
臺東縣,太麻里鄉,美和村,377,167,210,7,384,1297,0,29.61,12.88
臺東縣,太麻里鄉,三和村,194,105,89,3,197,589,0,33.45,17.83
臺東縣,太麻里鄉,華源村,187,93,94,5,192,588,0,32.65,15.82
臺東縣,太麻里鄉,北里村,187,100,87,3,190,564,0,33.69,17.73
臺東縣,太麻里鄉,泰和村,443,289,154,10,453,1352,0,33.51,21.38
臺東縣,太麻里鄉,大王村,575,388,187,12,587,1720,0,34.13,22.56
臺東縣,太麻里鄉,香蘭村,268,175,93,4,272,811,0,33.54,21.58
臺東縣,太麻里鄉,金崙村,426,365,61,8,434,1705,0,25.45,21.41
臺東縣,太麻里鄉,多良村,270,234,36,9,279,900,0,31.0,26.0
臺東縣,太麻里鄉,合計,2927,1916,1011,61,2988,9526,10806,31.37,20.11
臺東縣,大武鄉,大竹村,207,174,33,9,216,733,0,29.47,23.74
臺東縣,大武鄉,大鳥村,289,264,25,6,295,1061,0,27.8,24.88
臺東縣,大武鄉,大武村,343,248,95,8,351,1229,0,28.56,20.18
臺東縣,大武鄉,尚武村,336,176,160,7,343,1341,0,25.58,13.12
臺東縣,大武鄉,南興村,170,138,32,4,174,528,0,32.95,26.14
臺東縣,大武鄉,合計,1345,1000,345,34,1379,4892,5663,28.19,20.44
臺東縣,綠島鄉,公舘村,196,152,44,6,202,986,0,20.49,15.42
臺東縣,綠島鄉,中寮村,171,126,45,1,172,1038,0,16.57,12.14
臺東縣,綠島鄉,南寮村,256,190,66,4,260,1538,0,16.91,12.35
臺東縣,綠島鄉,合計,623,468,155,11,634,3562,4083,17.8,13.14
臺東縣,海端鄉,廣原村,195,168,27,2,197,730,0,26.99,23.01
臺東縣,海端鄉,霧鹿村,104,85,19,1,105,251,0,41.83,33.86
臺東縣,海端鄉,利稻村,67,42,25,1,68,261,0,26.05,16.09
臺東縣,海端鄉,海端村,224,189,35,4,228,957,0,23.82,19.75
臺東縣,海端鄉,崁頂村,165,138,27,0,165,575,0,28.7,24.0
臺東縣,海端鄉,加拿村,142,125,17,3,145,501,0,28.94,24.95
臺東縣,海端鄉,合計,897,747,150,11,908,3275,4132,27.73,22.81
臺東縣,延平鄉,武陵村,182,155,27,6,188,593,0,31.7,26.14
臺東縣,延平鄉,永康村,111,98,13,2,113,318,0,35.53,30.82
臺東縣,延平鄉,紅葉村,133,117,16,5,138,421,0,32.78,27.79
臺東縣,延平鄉,鸞山村,144,129,15,4,148,577,0,25.65,22.36
臺東縣,延平鄉,桃源村,294,204,90,5,299,1003,0,29.81,20.34
臺東縣,延平鄉,合計,864,703,161,22,886,2912,3575,30.43,24.14
臺東縣,金峰鄉,新興村,243,215,28,6,249,512,0,48.63,41.99
臺東縣,金峰鄉,正興村,254,233,21,5,259,603,0,42.95,38.64
臺東縣,金峰鄉,嘉蘭村,378,325,53,9,387,1235,0,31.34,26.32
臺東縣,金峰鄉,賓茂村,122,117,5,2,124,325,0,38.15,36.0
臺東縣,金峰鄉,歷坵村,123,106,17,4,127,329,0,38.6,32.22
臺東縣,金峰鄉,合計,1120,996,124,26,1146,3004,3673,38.15,33.16
臺東縣,達仁鄉,台坂村,230,202,28,5,235,589,0,39.9,34.3
臺東縣,達仁鄉,土坂村,274,234,40,2,276,851,0,32.43,27.5
臺東縣,達仁鄉,新化村,99,82,17,1,100,334,0,29.94,24.55
臺東縣,達仁鄉,安朔村,206,172,34,3,209,548,0,38.14,31.39
臺東縣,達仁鄉,森永村,143,114,29,0,143,359,0,39.83,31.75
臺東縣,達仁鄉,南田村,107,96,11,2,109,309,0,35.28,31.07
臺東縣,達仁鄉,合計,1059,900,159,13,1072,2990,3450,35.85,30.1
臺東縣,蘭嶼鄉,東清村,205,126,79,5,210,1293,0,16.24,9.74
臺東縣,蘭嶼鄉,朗島村,124,57,67,14,138,773,0,17.85,7.37
臺東縣,蘭嶼鄉,紅頭村,271,183,88,6,277,1256,0,22.05,14.57
臺東縣,蘭嶼鄉,椰油村,184,148,36,5,189,968,0,19.52,15.29
臺東縣,蘭嶼鄉,合計,784,514,270,30,814,4290,5199,18.97,11.98
臺東縣,合計,合計,58825,38963,19862,871,59696,182958,214132,32.63,21.3
澎湖縣,馬公市,復興里,136,76,60,1,137,496,0,27.62,15.32
澎湖縣,馬公市,長安里,219,124,95,1,220,534,0,41.2,23.22
澎湖縣,馬公市,中央里,198,99,99,3,201,520,0,38.65,19.04
澎湖縣,馬公市,啟明里,334,159,175,2,336,872,0,38.53,18.23
澎湖縣,馬公市,重慶里,377,173,204,4,381,932,0,40.88,18.56
澎湖縣,馬公市,中興里,269,163,106,2,271,785,0,34.52,20.76
澎湖縣,馬公市,光復里,646,340,306,4,650,1903,0,34.16,17.87
澎湖縣,馬公市,光榮里,1475,1000,475,22,1497,4135,0,36.2,24.18
澎湖縣,馬公市,光明里,411,263,148,5,416,1175,0,35.4,22.38
澎湖縣,馬公市,朝陽里,1659,938,721,10,1669,5179,0,32.23,18.11
澎湖縣,馬公市,陽明里,765,406,359,6,771,2417,0,31.9,16.8
澎湖縣,馬公市,重光里,514,285,229,2,516,1483,0,34.79,19.22
澎湖縣,馬公市,西衛里,1783,1020,763,11,1794,5825,0,30.8,17.51
澎湖縣,馬公市,西文里,998,576,422,4,1002,3202,0,31.29,17.99
澎湖縣,馬公市,東文里,985,544,441,11,996,3283,0,30.34,16.57
澎湖縣,馬公市,案山里,561,304,257,8,569,1855,0,30.67,16.39
澎湖縣,馬公市,光華里,223,143,80,1,224,979,0,22.88,14.61
澎湖縣,馬公市,前寮里,290,142,148,1,291,953,0,30.54,14.9
澎湖縣,馬公市,石泉里,878,532,346,5,883,2661,0,33.18,19.99
澎湖縣,馬公市,菜園里,144,71,73,1,145,439,0,33.03,16.17
澎湖縣,馬公市,東衛里,672,418,254,7,679,2134,0,31.82,19.59
澎湖縣,馬公市,安宅里,199,105,94,5,204,650,0,31.38,16.15
澎湖縣,馬公市,烏崁里,357,130,227,7,364,1060,0,34.34,12.26
澎湖縣,馬公市,興仁里,385,215,170,6,391,1240,0,31.53,17.34
澎湖縣,馬公市,鐵線里,229,77,152,1,230,677,0,33.97,11.37
澎湖縣,馬公市,山水里,514,193,321,7,521,1707,0,30.52,11.31
澎湖縣,馬公市,鎖港里,761,254,507,7,768,2539,0,30.25,10.0
澎湖縣,馬公市,五德里,96,51,45,1,97,470,0,20.64,10.85
澎湖縣,馬公市,井垵里,114,61,53,2,116,378,0,30.69,16.14
澎湖縣,馬公市,嵵裡里,305,182,123,4,309,1162,0,26.59,15.66
澎湖縣,馬公市,風櫃里,382,113,269,5,387,1368,0,28.29,8.26
澎湖縣,馬公市,虎井里,133,82,51,1,134,812,0,16.5,10.1
澎湖縣,馬公市,桶盤里,43,25,18,1,44,314,0,14.01,7.96
澎湖縣,馬公市,合計,17055,9264,7791,158,17213,54139,62912,31.79,17.11
澎湖縣,湖西鄉,湖西村,366,201,165,4,370,1199,0,30.86,16.76
澎湖縣,湖西鄉,湖東村,99,55,44,0,99,358,0,27.65,15.36
澎湖縣,湖西鄉,青螺村,67,36,31,1,68,243,0,27.98,14.81
澎湖縣,湖西鄉,白坑村,87,45,42,4,91,297,0,30.64,15.15
澎湖縣,湖西鄉,南寮村,182,53,129,2,184,683,0,26.94,7.76
澎湖縣,湖西鄉,北寮村,87,49,38,0,87,327,0,26.61,14.98
澎湖縣,湖西鄉,紅羅村,217,91,126,5,222,748,0,29.68,12.17
澎湖縣,湖西鄉,西溪村,168,83,85,3,171,839,0,20.38,9.89
澎湖縣,湖西鄉,成功村,290,137,153,4,294,860,0,34.19,15.93
澎湖縣,湖西鄉,東石村,49,15,34,1,50,123,0,40.65,12.2
澎湖縣,湖西鄉,中西村,73,35,38,2,75,221,0,33.94,15.84
澎湖縣,湖西鄉,潭邊村,109,59,50,1,110,300,0,36.67,19.67
澎湖縣,湖西鄉,鼎灣村,131,77,54,3,134,641,0,20.9,12.01
澎湖縣,湖西鄉,許家村,102,55,47,0,102,389,0,26.22,14.14
澎湖縣,湖西鄉,沙港村,261,66,195,3,264,807,0,32.71,8.18
澎湖縣,湖西鄉,城北村,122,77,45,1,123,334,0,36.83,23.05
澎湖縣,湖西鄉,太武村,31,15,16,1,32,94,0,34.04,15.96
澎湖縣,湖西鄉,隘門村,285,152,133,2,287,911,0,31.5,16.68
澎湖縣,湖西鄉,林投村,296,113,183,7,303,1004,0,30.18,11.25
澎湖縣,湖西鄉,尖山村,195,71,124,0,195,670,0,29.1,10.6
澎湖縣,湖西鄉,龍門村,539,257,282,5,544,1760,0,30.91,14.6
澎湖縣,湖西鄉,菓葉村,226,75,151,7,233,762,0,30.58,9.84
澎湖縣,湖西鄉,合計,3982,1817,2165,56,4038,13570,15248,29.76,13.39
澎湖縣,白沙鄉,中屯村,166,95,71,4,170,525,0,32.38,18.1
澎湖縣,白沙鄉,講美村,207,121,86,0,207,671,0,30.85,18.03
澎湖縣,白沙鄉,城前村,51,27,24,1,52,110,0,47.27,24.55
澎湖縣,白沙鄉,鎮海村,48,36,12,0,48,156,0,30.77,23.08
澎湖縣,白沙鄉,港子村,79,45,34,1,80,297,0,26.94,15.15
澎湖縣,白沙鄉,岐頭村,48,32,16,0,48,216,0,22.22,14.81
澎湖縣,白沙鄉,小赤村,62,32,30,1,63,168,0,37.5,19.05
澎湖縣,白沙鄉,赤崁村,466,250,216,4,470,1719,0,27.34,14.54
澎湖縣,白沙鄉,瓦硐村,90,48,42,0,90,307,0,29.32,15.64
澎湖縣,白沙鄉,後寮村,212,76,136,4,216,766,0,28.2,9.92
澎湖縣,白沙鄉,通梁村,203,88,115,3,206,798,0,25.81,11.03
澎湖縣,白沙鄉,吉貝村,261,49,212,4,265,1412,0,18.77,3.47
澎湖縣,白沙鄉,鳥嶼村,234,174,60,3,237,1110,0,21.35,15.68
澎湖縣,白沙鄉,員貝村,64,55,9,1,65,274,0,23.72,20.07
澎湖縣,白沙鄉,大倉村,50,15,35,1,51,269,0,18.96,5.58
澎湖縣,白沙鄉,合計,2241,1143,1098,27,2268,8798,9915,25.78,12.99
澎湖縣,西嶼鄉,橫礁村,56,19,37,1,57,301,0,18.94,6.31
澎湖縣,西嶼鄉,合界村,98,33,65,2,100,415,0,24.1,7.95
澎湖縣,西嶼鄉,小門村,97,67,30,0,97,285,0,34.04,23.51
澎湖縣,西嶼鄉,竹灣村,219,84,135,3,222,817,0,27.17,10.28
澎湖縣,西嶼鄉,大池村,190,67,123,0,190,665,0,28.57,10.08
澎湖縣,西嶼鄉,二崁村,56,12,44,1,57,145,0,39.31,8.28
澎湖縣,西嶼鄉,池東村,181,81,100,3,184,642,0,28.66,12.62
澎湖縣,西嶼鄉,池西村,63,16,47,1,64,225,0,28.44,7.11
澎湖縣,西嶼鄉,赤馬村,142,43,99,0,142,580,0,24.48,7.41
澎湖縣,西嶼鄉,內垵村,324,104,220,3,327,1265,0,25.85,8.22
澎湖縣,西嶼鄉,外垵村,477,333,144,4,481,2058,0,23.37,16.18
澎湖縣,西嶼鄉,合計,1903,859,1044,18,1921,7398,8309,25.97,11.61
澎湖縣,望安鄉,東安村,130,57,73,3,133,723,0,18.4,7.88
澎湖縣,望安鄉,西安村,92,55,37,0,92,436,0,21.1,12.61
澎湖縣,望安鄉,中社村,53,18,35,2,55,342,0,16.08,5.26
澎湖縣,望安鄉,水垵村,93,33,60,3,96,487,0,19.71,6.78
澎湖縣,望安鄉,將軍村,175,37,138,5,180,1425,0,12.63,2.6
澎湖縣,望安鄉,東坪村,18,6,12,0,18,527,0,3.42,1.14
澎湖縣,望安鄉,西坪村,8,4,4,0,8,220,0,3.64,1.82
澎湖縣,望安鄉,東吉村,38,17,21,0,38,296,0,12.84,5.74
澎湖縣,望安鄉,花嶼村,50,32,18,1,51,323,0,15.79,9.91
澎湖縣,望安鄉,合計,657,259,398,14,671,4779,5401,14.04,5.42
澎湖縣,七美鄉,東湖村,22,9,13,1,23,259,0,8.88,3.47
澎湖縣,七美鄉,西湖村,62,38,24,1,63,573,0,10.99,6.63
澎湖縣,七美鄉,中和村,71,45,26,1,72,643,0,11.2,7.0
澎湖縣,七美鄉,平和村,57,25,32,1,58,367,0,15.8,6.81
澎湖縣,七美鄉,海豐村,45,19,26,1,46,377,0,12.2,5.04
澎湖縣,七美鄉,南港村,141,91,50,5,146,1148,0,12.72,7.93
澎湖縣,七美鄉,合計,398,227,171,10,408,3367,3849,12.12,6.74
澎湖縣,合計,合計,26236,13569,12667,283,26519,92051,105634,28.81,14.74
基隆市,中正區,德義里,307,163,144,2,309,649,0,47.61,25.12
基隆市,中正區,正義里,542,312,230,6,548,1166,0,47.0,26.76
基隆市,中正區,信義里,373,196,177,1,374,874,0,42.79,22.43
基隆市,中正區,義重里,402,223,179,5,407,991,0,41.07,22.5
基隆市,中正區,港通里,582,292,290,5,587,1177,0,49.87,24.81
基隆市,中正區,中船里,465,236,229,2,467,1117,0,41.81,21.13
基隆市,中正區,正船里,537,316,221,3,540,1217,0,44.37,25.97
基隆市,中正區,入船里,320,182,138,8,328,752,0,43.62,24.2
基隆市,中正區,中砂里,549,318,231,4,553,1594,0,34.69,19.95
基隆市,中正區,正砂里,996,612,384,8,1004,2260,0,44.42,27.08
基隆市,中正區,真砂里,605,340,265,6,611,1294,0,47.22,26.28
基隆市,中正區,砂灣里,810,513,297,9,819,1981,0,41.34,25.9
基隆市,中正區,建國里,783,527,256,12,795,1945,0,40.87,27.1
基隆市,中正區,中濱里,511,284,227,3,514,1245,0,41.29,22.81
基隆市,中正區,海濱里,393,243,150,3,396,1125,0,35.2,21.6
基隆市,中正區,社寮里,678,315,363,6,684,1688,0,40.52,18.66
基隆市,中正區,和憲里,298,179,119,5,303,920,0,32.93,19.46
基隆市,中正區,平寮里,459,211,248,1,460,1211,0,37.99,17.42
基隆市,中正區,八斗里,599,170,429,5,604,1442,0,41.89,11.79
基隆市,中正區,碧砂里,402,164,238,3,405,1212,0,33.42,13.53
基隆市,中正區,長潭里,204,60,144,2,206,439,0,46.92,13.67
基隆市,中正區,砂子里,1832,1001,831,14,1846,5622,0,32.84,17.81
基隆市,中正區,中正里,576,305,271,2,578,1615,0,35.79,18.89
基隆市,中正區,正濱里,354,205,149,7,361,907,0,39.8,22.6
基隆市,中正區,新豐里,2153,1320,833,11,2164,5731,0,37.76,23.03
基隆市,中正區,新富里,1620,930,690,11,1631,5124,0,31.83,18.15
基隆市,中正區,合計,17350,9617,7733,144,17494,45298,50967,38.62,21.23
基隆市,七堵區,長興里,1404,802,602,10,1414,3732,0,37.89,21.49
基隆市,七堵區,正光里,1019,525,494,8,1027,2522,0,40.72,20.82
基隆市,七堵區,富民里,1462,840,622,12,1474,3476,0,42.41,24.17
基隆市,七堵區,永平里,832,467,365,6,838,1877,0,44.65,24.88
基隆市,七堵區,永安里,936,557,379,11,947,2193,0,43.18,25.4
基隆市,七堵區,八德里,592,307,285,6,598,1482,0,40.35,20.72
基隆市,七堵區,自強里,471,218,253,8,479,1165,0,41.12,18.71
基隆市,七堵區,六堵里,837,432,405,3,840,2268,0,37.04,19.05
基隆市,七堵區,泰安里,1651,913,738,14,1665,4366,0,38.14,20.91
基隆市,七堵區,堵北里,1386,673,713,10,1396,3616,0,38.61,18.61
基隆市,七堵區,堵南里,730,368,362,10,740,2070,0,35.75,17.78
基隆市,七堵區,瑪南里,164,70,94,2,166,402,0,41.29,17.41
基隆市,七堵區,瑪東里,103,53,50,2,105,317,0,33.12,16.72
基隆市,七堵區,瑪西里,130,57,73,3,133,325,0,40.92,17.54
基隆市,七堵區,友一里,917,565,352,4,921,1965,0,46.87,28.75
基隆市,七堵區,友二里,226,90,136,8,234,448,0,52.23,20.09
基隆市,七堵區,正明里,810,446,364,11,821,1879,0,43.69,23.74
基隆市,七堵區,百福里,2137,1077,1060,12,2149,6051,0,35.51,17.8
基隆市,七堵區,實踐里,1388,704,684,13,1401,3772,0,37.14,18.66
基隆市,七堵區,長安里,844,453,391,4,848,2505,0,33.85,18.08
基隆市,七堵區,合計,18039,9617,8422,157,18196,46431,53534,39.19,20.71
基隆市,暖暖區,八西里,556,305,251,7,563,1390,0,40.5,21.94
基隆市,暖暖區,八堵里,277,142,135,3,280,641,0,43.68,22.15
基隆市,暖暖區,八南里,268,133,135,0,268,754,0,35.54,17.64
基隆市,暖暖區,過港里,1497,878,619,9,1506,3626,0,41.53,24.21
基隆市,暖暖區,碇內里,1049,627,422,7,1056,2636,0,40.06,23.79
基隆市,暖暖區,碇和里,1278,852,426,2,1280,2957,0,43.29,28.81
基隆市,暖暖區,暖同里,1005,587,418,7,1012,2529,0,40.02,23.21
基隆市,暖暖區,暖暖里,1091,600,491,9,1100,2563,0,42.92,23.41
基隆市,暖暖區,暖東里,141,70,71,4,145,405,0,35.8,17.28
基隆市,暖暖區,暖西里,1945,1077,868,14,1959,4724,0,41.47,22.8
基隆市,暖暖區,八中里,174,90,84,1,175,408,0,42.89,22.06
基隆市,暖暖區,碇安里,1999,1137,862,17,2016,4877,0,41.34,23.31
基隆市,暖暖區,碇祥里,2203,1321,882,22,2225,5937,0,37.48,22.25
基隆市,暖暖區,合計,13483,7819,5664,102,13585,33447,38494,40.62,23.38
基隆市,仁愛區,林泉里,643,348,295,6,649,1698,0,38.22,20.49
基隆市,仁愛區,花崗里,428,238,190,4,432,1015,0,42.56,23.45
基隆市,仁愛區,虹橋里,635,340,295,8,643,1481,0,43.42,22.96
基隆市,仁愛區,水錦里,700,401,299,1,701,1716,0,40.85,23.37
基隆市,仁愛區,智仁里,907,522,385,9,916,2263,0,40.48,23.07
基隆市,仁愛區,和明里,686,397,289,7,693,1653,0,41.92,24.02
基隆市,仁愛區,忠勇里,360,175,185,1,361,924,0,39.07,18.94
基隆市,仁愛區,玉田里,420,205,215,1,421,945,0,44.55,21.69
基隆市,仁愛區,仁德里,383,190,193,1,384,840,0,45.71,22.62
基隆市,仁愛區,博愛里,688,372,316,7,695,1413,0,49.19,26.33
基隆市,仁愛區,福仁里,329,142,187,7,336,730,0,46.03,19.45
基隆市,仁愛區,誠仁里,384,182,202,6,390,917,0,42.53,19.85
基隆市,仁愛區,吉仁里,989,492,497,6,995,2538,0,39.2,19.39
基隆市,仁愛區,育仁里,274,108,166,5,279,710,0,39.3,15.21
基隆市,仁愛區,英仁里,475,233,242,3,478,1247,0,38.33,18.68
基隆市,仁愛區,龍門里,314,128,186,3,317,770,0,41.17,16.62
基隆市,仁愛區,德厚里,717,401,316,4,721,1698,0,42.46,23.62
基隆市,仁愛區,曲水里,351,156,195,3,354,790,0,44.81,19.75
基隆市,仁愛區,崇文里,390,201,189,2,392,846,0,46.34,23.76
基隆市,仁愛區,文安里,281,129,152,4,285,820,0,34.76,15.73
基隆市,仁愛區,兆連里,297,172,125,6,303,670,0,45.22,25.67
基隆市,仁愛區,獅球里,341,197,144,4,345,957,0,36.05,20.59
基隆市,仁愛區,書院里,373,186,187,6,379,1056,0,35.89,17.61
基隆市,仁愛區,朝棟里,1148,744,404,12,1160,2712,0,42.77,27.43
基隆市,仁愛區,明德里,313,170,143,2,315,676,0,46.6,25.15
基隆市,仁愛區,同風里,247,119,128,1,248,548,0,45.26,21.72
基隆市,仁愛區,文昌里,368,149,219,1,369,692,0,53.32,21.53
基隆市,仁愛區,新店里,281,146,135,1,282,571,0,49.39,25.57
基隆市,仁愛區,光華里,1034,561,473,2,1036,2507,0,41.32,22.38
基隆市,仁愛區,合計,14756,7804,6952,123,14879,35403,42303,42.03,22.04
基隆市,中山區,新建里,350,194,156,7,357,769,0,46.42,25.23
基隆市,中山區,安民里,493,255,238,5,498,992,0,50.2,25.71
基隆市,中山區,安平里,313,161,152,5,318,750,0,42.4,21.47
基隆市,中山區,中山里,374,167,207,5,379,962,0,39.4,17.36
基隆市,中山區,民治里,346,216,130,4,350,749,0,46.73,28.84
基隆市,中山區,中興里,510,300,210,4,514,1221,0,42.1,24.57
基隆市,中山區,仁正里,309,201,108,1,310,742,0,41.78,27.09
基隆市,中山區,健民里,494,273,221,6,500,1138,0,43.94,23.99
基隆市,中山區,通化里,379,224,155,6,385,961,0,40.06,23.31
基隆市,中山區,居仁里,477,280,197,11,488,1266,0,38.55,22.12
基隆市,中山區,通明里,686,367,319,8,694,1710,0,40.58,21.46
基隆市,中山區,協和里,582,303,279,9,591,1512,0,39.09,20.04
基隆市,中山區,文化里,359,197,162,1,360,1271,0,28.32,15.5
基隆市,中山區,仙洞里,229,122,107,2,231,563,0,41.03,21.67
基隆市,中山區,太白里,316,146,170,4,320,864,0,37.04,16.9
基隆市,中山區,西榮里,273,127,146,7,280,654,0,42.81,19.42
基隆市,中山區,西華里,404,202,202,5,409,828,0,49.4,24.4
基隆市,中山區,西定里,341,172,169,6,347,904,0,38.38,19.03
基隆市,中山區,西康里,569,289,280,11,580,1556,0,37.28,18.57
基隆市,中山區,德和里,2463,1502,961,16,2479,5331,0,46.5,28.17
基隆市,中山區,中和里,2148,1288,860,11,2159,5461,0,39.53,23.59
基隆市,中山區,德安里,1561,840,721,11,1572,3826,0,41.09,21.96
基隆市,中山區,和平里,205,132,73,4,209,431,0,48.49,30.63
基隆市,中山區,和慶里,2197,1205,992,15,2212,6516,0,33.95,18.49
基隆市,中山區,合計,16378,9163,7215,164,16542,40977,46058,40.37,22.36
基隆市,安樂區,西川里,450,254,196,2,452,1179,0,38.34,21.54
基隆市,安樂區,定國里,404,210,194,3,407,1020,0,39.9,20.59
基隆市,安樂區,新西里,485,268,217,1,486,1326,0,36.65,20.21
基隆市,安樂區,定邦里,477,257,220,1,478,998,0,47.9,25.75
基隆市,安樂區,慈仁里,336,138,198,2,338,883,0,38.28,15.63
基隆市,安樂區,干城里,704,372,332,3,707,1988,0,35.56,18.71
基隆市,安樂區,永康里,698,350,348,2,700,1900,0,36.84,18.42
基隆市,安樂區,嘉仁里,1353,653,700,14,1367,3163,0,43.22,20.64
基隆市,安樂區,安和里,373,163,210,3,376,821,0,45.8,19.85
基隆市,安樂區,樂一里,220,102,118,2,222,556,0,39.93,18.35
基隆市,安樂區,外寮里,1437,828,609,12,1449,3892,0,37.23,21.27
基隆市,安樂區,中崙里,691,378,313,4,695,1657,0,41.94,22.81
基隆市,安樂區,內寮里,2052,1165,887,14,2066,5349,0,38.62,21.78
基隆市,安樂區,新崙里,1504,831,673,13,1517,4007,0,37.86,20.74
基隆市,安樂區,三民里,1063,577,486,2,1065,2451,0,43.45,23.54
基隆市,安樂區,四維里,2227,1329,898,12,2239,4656,0,48.09,28.54
基隆市,安樂區,五福里,1485,875,610,7,1492,3415,0,43.69,25.62
基隆市,安樂區,六合里,1815,1108,707,14,1829,3876,0,47.19,28.59
基隆市,安樂區,七賢里,1032,543,489,7,1039,2426,0,42.83,22.38
基隆市,安樂區,鶯歌里,1039,644,395,4,1043,2796,0,37.3,23.03
基隆市,安樂區,武崙里,2079,1227,852,11,2090,4808,0,43.47,25.52
基隆市,安樂區,長樂里,1640,991,649,13,1653,3289,0,50.26,30.13
基隆市,安樂區,興寮里,1709,992,717,18,1727,4694,0,36.79,21.13
基隆市,安樂區,鶯安里,2253,1431,822,17,2270,4907,0,46.26,29.16
基隆市,安樂區,壯觀里,1781,1153,628,16,1797,4239,0,42.39,27.2
基隆市,安樂區,合計,29307,16839,12468,197,29504,70296,81453,41.97,23.95
基隆市,信義區,仁壽里,504,290,214,11,515,1024,0,50.29,28.32
基隆市,信義區,仁義里,600,397,203,2,602,1165,0,51.67,34.08
基隆市,信義區,義昭里,600,350,250,3,603,1243,0,48.51,28.16
基隆市,信義區,義幸里,1086,654,432,6,1092,2232,0,48.92,29.3
基隆市,信義區,義民里,297,159,138,3,300,723,0,41.49,21.99
基隆市,信義區,義和里,567,345,222,4,571,1508,0,37.86,22.88
基隆市,信義區,智慧里,350,215,135,7,357,712,0,50.14,30.2
基隆市,信義區,智誠里,545,268,277,6,551,1483,0,37.15,18.07
基隆市,信義區,禮儀里,714,425,289,6,720,1552,0,46.39,27.38
基隆市,信義區,禮東里,705,450,255,8,713,1439,0,49.55,31.27
基隆市,信義區,信綠里,903,555,348,7,910,1997,0,45.57,27.79
基隆市,信義區,東光里,787,457,330,4,791,1817,0,43.53,25.15
基隆市,信義區,東明里,1467,953,514,6,1473,3468,0,42.47,27.48
基隆市,信義區,東安里,1130,669,461,11,1141,2716,0,42.01,24.63
基隆市,信義區,孝岡里,483,265,218,2,485,1308,0,37.08,20.26
基隆市,信義區,東信里,1861,1202,659,15,1876,4064,0,46.16,29.58
基隆市,信義區,孝深里,1621,966,655,15,1636,4618,0,35.43,20.92
基隆市,信義區,孝賢里,1546,949,597,7,1553,3461,0,44.87,27.42
基隆市,信義區,孝德里,962,541,421,7,969,2604,0,37.21,20.78
基隆市,信義區,孝忠里,2997,1817,1180,7,3004,7553,0,39.77,24.06
基隆市,信義區,合計,19725,11927,7798,137,19862,46687,53082,42.54,25.55
基隆市,合計,合計,129038,72786,56252,1024,130062,318539,365891,40.83,22.85
新竹市,東區,南門里,337,145,192,4,341,689,0,49.49,21.04
新竹市,東區,福德里,653,367,286,4,657,1426,0,46.07,25.74
新竹市,東區,南市里,362,140,222,8,370,860,0,43.02,16.28
新竹市,東區,關帝里,212,83,129,5,217,472,0,45.97,17.58
新竹市,東區,東門里,275,111,164,2,277,527,0,52.56,21.06
新竹市,東區,成功里,281,122,159,3,284,591,0,48.05,20.64
新竹市,東區,寺前里,312,146,166,4,316,712,0,44.38,20.51
新竹市,東區,育賢里,457,258,199,3,460,1657,0,27.76,15.57
新竹市,東區,中正里,242,113,129,3,245,544,0,45.04,20.77
新竹市,東區,公園里,1423,848,575,22,1445,3181,0,45.43,26.66
新竹市,東區,頂竹里,1252,599,653,17,1269,2794,0,45.42,21.44
新竹市,東區,南大里,628,292,336,9,637,1360,0,46.84,21.47
新竹市,東區,振興里,2179,1212,967,20,2199,5451,0,40.34,22.23
新竹市,東區,親仁里,535,326,209,4,539,1058,0,50.95,30.81
新竹市,東區,文華里,2029,1173,856,18,2047,4446,0,46.04,26.38
新竹市,東區,復中里,1897,1091,806,17,1914,4120,0,46.46,26.48
新竹市,東區,三民里,2063,1094,969,19,2082,4584,0,45.42,23.87
新竹市,東區,東園里,2660,1504,1156,33,2693,5827,0,46.22,25.81
新竹市,東區,東勢里,1449,808,641,20,1469,3117,0,47.13,25.92
新竹市,東區,光復里,1312,690,622,18,1330,2796,0,47.57,24.68
新竹市,東區,豐功里,2295,1437,858,17,2312,4392,0,52.64,32.72
新竹市,東區,武功里,2042,1570,472,23,2065,3972,0,51.99,39.53
新竹市,東區,綠水里,2876,1724,1152,34,2910,6185,0,47.05,27.87
新竹市,東區,東山里,1541,944,597,23,1564,3075,0,50.86,30.7
新竹市,東區,光鎮里,1514,805,709,14,1528,3537,0,43.2,22.76
新竹市,東區,新興里,1330,685,645,26,1356,3009,0,45.06,22.77
新竹市,東區,柴橋里,2313,1302,1011,19,2332,5175,0,45.06,25.16
新竹市,東區,高峰里,2453,1329,1124,23,2476,5610,0,44.14,23.69
新竹市,東區,仙宮里,583,353,230,4,587,1240,0,47.34,28.47
新竹市,東區,光明里,1456,989,467,24,1480,2932,0,50.48,33.73
新竹市,東區,立功里,414,323,91,3,417,887,0,47.01,36.41
新竹市,東區,軍功里,1244,861,383,14,1258,2672,0,47.08,32.22
新竹市,東區,建功里,1965,1470,495,19,1984,3777,0,52.53,38.92
新竹市,東區,前溪里,1132,551,581,17,1149,2728,0,42.12,20.2
新竹市,東區,水源里,1443,693,750,24,1467,3260,0,45.0,21.26
新竹市,東區,千甲里,882,502,380,10,892,2117,0,42.14,23.71
新竹市,東區,埔頂里,2628,1459,1169,32,2660,6204,0,42.88,23.52
新竹市,東區,龍山里,4325,2520,1805,38,4363,9368,0,46.57,26.9
新竹市,東區,新莊里,2322,1402,920,19,2341,5305,0,44.13,26.43
新竹市,東區,仙水里,1988,1177,811,25,2013,4355,0,46.22,27.03
新竹市,東區,金山里,2142,1367,775,20,2162,5215,0,41.46,26.21
新竹市,東區,關東里,1959,1215,744,20,1979,4835,0,40.93,25.13
新竹市,東區,科園里,3219,2007,1212,31,3250,6299,0,51.6,31.86
新竹市,東區,建華里,1062,575,487,11,1073,2356,0,45.54,24.41
新竹市,東區,新光里,1441,769,672,21,1462,3398,0,43.03,22.63
新竹市,東區,復興里,2149,1251,898,25,2174,4960,0,43.83,25.22
新竹市,東區,錦華里,852,521,331,6,858,1881,0,45.61,27.7
新竹市,東區,湖濱里,1635,913,722,13,1648,3466,0,47.55,26.34
新竹市,東區,明湖里,1757,1044,713,16,1773,4931,0,35.96,21.17
新竹市,東區,關新里,1924,1088,836,16,1940,3964,0,48.94,27.45
新竹市,東區,榮光里、親仁里,426,255,171,7,433,958,0,45.2,26.62
新竹市,東區,下竹里、竹蓮里,533,267,266,6,539,1175,0,45.87,22.72
新竹市,東區,合計,76403,44490,31913,833,77236,169450,221541,45.58,26.26
新竹市,北區,西門里,253,130,123,2,255,555,0,45.95,23.42
新竹市,北區,仁德里,320,145,175,1,321,728,0,44.09,19.92
新竹市,北區,潛園里,331,146,185,5,336,743,0,45.22,19.65
新竹市,北區,中央里,196,74,122,2,198,464,0,42.67,15.95
新竹市,北區,崇禮里,472,198,274,6,478,1063,0,44.97,18.63
新竹市,北區,興南里,525,250,275,11,536,1170,0,45.81,21.37
新竹市,北區,北門里,441,213,228,4,445,975,0,45.64,21.85
新竹市,北區,中興里,409,199,210,1,410,867,0,47.29,22.95
新竹市,北區,大同里,384,221,163,2,386,775,0,49.81,28.52
新竹市,北區,中山里,380,155,225,2,382,826,0,46.25,18.77
新竹市,北區,長和里,600,281,319,4,604,1365,0,44.25,20.59
新竹市,北區,新民里,680,340,340,6,686,1599,0,42.9,21.26
新竹市,北區,民富里,1901,928,973,18,1919,4837,0,39.67,19.19
新竹市,北區,水田里,1346,723,623,10,1356,3018,0,44.93,23.96
新竹市,北區,文雅里,1783,921,862,20,1803,4021,0,44.84,22.9
新竹市,北區,光田里,953,532,421,12,965,2080,0,46.39,25.58
新竹市,北區,士林里,791,357,434,11,802,1845,0,43.47,19.35
新竹市,北區,福林里,1720,1023,697,16,1736,3780,0,45.93,27.06
新竹市,北區,古賢里,350,142,208,11,361,837,0,43.13,16.97
新竹市,北區,湳雅里,1287,720,567,16,1303,2741,0,47.54,26.27
新竹市,北區,舊社里,2618,1463,1155,33,2651,5956,0,44.51,24.56
新竹市,北區,武陵里,2135,1691,444,24,2159,4508,0,47.89,37.51
新竹市,北區,南寮里,2012,1069,943,26,2038,5777,0,35.28,18.5
新竹市,北區,舊港里,222,114,108,5,227,574,0,39.55,19.86
新竹市,北區,康樂里,1200,603,597,16,1216,2946,0,41.28,20.47
新竹市,北區,港北里,749,329,420,10,759,1982,0,38.29,16.6
新竹市,北區,中寮里,1360,732,628,18,1378,3687,0,37.37,19.85
新竹市,北區,海濱里,1429,739,690,11,1440,4195,0,34.33,17.62
新竹市,北區,客雅里,700,355,345,6,706,1590,0,44.4,22.33
新竹市,北區,育英里,1499,747,752,13,1512,3409,0,44.35,21.91
新竹市,北區,曲溪里,1987,1072,915,23,2010,5102,0,39.4,21.01
新竹市,北區,西雅里,1197,563,634,21,1218,2825,0,43.12,19.93
新竹市,北區,南勢里,1496,617,879,24,1520,3409,0,44.59,18.1
新竹市,北區,境福里,2103,1152,951,35,2138,4668,0,45.8,24.68
新竹市,北區,磐石里,2322,1172,1150,22,2344,5381,0,43.56,21.78
新竹市,北區,新雅里,1663,822,841,21,1684,4426,0,38.05,18.57
新竹市,北區,光華里,1496,820,676,11,1507,4165,0,36.18,19.69
新竹市,北區,金華里,2183,1201,982,25,2208,4801,0,45.99,25.02
新竹市,北區,金竹里,2415,1417,998,21,2436,5732,0,42.5,24.72
新竹市,北區,湳中里,2961,1753,1208,41,3002,6577,0,45.64,26.65
新竹市,北區,金雅里,1316,681,635,14,1330,2938,0,45.27,23.18
新竹市,北區,台溪里,601,313,288,7,608,1564,0,38.87,20.01
新竹市,北區,中雅里,1554,1048,506,26,1580,3326,0,47.5,31.51
新竹市,北區,石坊里、興南里,338,154,184,4,342,684,0,50.0,22.51
新竹市,北區,南勢里、大鵬里,364,187,177,6,370,995,0,37.19,18.79
新竹市,北區,合計,53042,28512,24530,623,53665,125506,152490,42.76,22.72
新竹市,香山區,港南里,1045,397,648,13,1058,2715,0,38.97,14.62
新竹市,香山區,虎山里,2068,939,1129,37,2105,5496,0,38.3,17.09
新竹市,香山區,虎林里,901,454,447,13,914,2275,0,40.18,19.96
新竹市,香山區,浸水里,825,343,482,10,835,2355,0,35.46,14.56
新竹市,香山區,樹下里,906,328,578,15,921,2096,0,43.94,15.65
新竹市,香山區,埔前里,1303,582,721,20,1323,3186,0,41.53,18.27
新竹市,香山區,中埔里,1277,654,623,15,1292,2869,0,45.03,22.8
新竹市,香山區,牛埔里,1721,906,815,20,1741,4595,0,37.89,19.72
新竹市,香山區,頂埔里,1960,1062,898,21,1981,5017,0,39.49,21.17
新竹市,香山區,東香里,1804,1041,763,33,1837,4051,0,45.35,25.7
新竹市,香山區,香村里,1406,789,617,21,1427,3559,0,40.1,22.17
新竹市,香山區,香山里,1582,797,785,18,1600,4357,0,36.72,18.29
新竹市,香山區,大庄里,1065,452,613,17,1082,2843,0,38.06,15.9
新竹市,香山區,美山里,431,176,255,5,436,1121,0,38.89,15.7
新竹市,香山區,朝山里,777,379,398,6,783,2151,0,36.4,17.62
新竹市,香山區,海山里,878,480,398,12,890,2366,0,37.62,20.29
新竹市,香山區,茄苳里,271,146,125,6,277,924,0,29.98,15.8
新竹市,香山區,大湖里,328,161,167,5,333,862,0,38.63,18.68
新竹市,香山區,南隘里,300,170,130,3,303,770,0,39.35,22.08
新竹市,香山區,中隘里,631,377,254,6,637,1828,0,34.85,20.62
新竹市,香山區,內湖里,1483,753,730,21,1504,4280,0,35.14,17.59
新竹市,香山區,鹽水里,549,260,289,10,559,1479,0,37.8,17.58
新竹市,香山區,南港里,335,132,203,6,341,792,0,43.06,16.67
新竹市,香山區,頂福里,1769,966,803,17,1786,4410,0,40.5,21.9
新竹市,香山區,合計,25615,12744,12871,350,25965,66397,78776,39.11,19.19
新竹市,合計,合計,155060,85746,69314,1806,156866,361353,452807,43.41,23.73
嘉義市,東區,荖藤里,1749,745,1004,11,1760,4525,0,38.9,16.46
嘉義市,東區,後湖里,1367,598,769,6,1373,3379,0,40.63,17.7
嘉義市,東區,仁義里,1184,553,631,5,1189,2803,0,42.42,19.73
嘉義市,東區,中庄里,1322,652,670,6,1328,3208,0,41.4,20.32
嘉義市,東區,頂庄里,905,456,449,3,908,2125,0,42.73,21.46
嘉義市,東區,圳頭里,1770,980,790,11,1781,4239,0,42.01,23.12
嘉義市,東區,新店里,1849,948,901,15,1864,4140,0,45.02,22.9
嘉義市,東區,後庄里,1698,893,805,11,1709,3945,0,43.32,22.64
嘉義市,東區,王田里,1055,548,507,9,1064,2249,0,47.31,24.37
嘉義市,東區,東川里,806,443,363,3,809,1740,0,46.49,25.46
嘉義市,東區,太平里,1777,926,851,15,1792,4209,0,42.58,22.0
嘉義市,東區,盧厝里,801,376,425,7,808,1933,0,41.8,19.45
嘉義市,東區,鹿寮里,379,161,218,3,382,1058,0,36.11,15.22
嘉義市,東區,長竹里,1294,633,661,9,1303,2882,0,45.21,21.96
嘉義市,東區,短竹里,1082,565,517,6,1088,2346,0,46.38,24.08
嘉義市,東區,新開里,851,410,441,7,858,1953,0,43.93,20.99
嘉義市,東區,宣信里,492,203,289,5,497,1241,0,40.05,16.36
嘉義市,東區,興南里,636,240,396,6,642,1578,0,40.68,15.21
嘉義市,東區,豐年里,519,224,295,1,520,1231,0,42.24,18.2
嘉義市,東區,芳草里,1298,580,718,12,1310,3435,0,38.14,16.89
嘉義市,東區,芳安里,947,446,501,10,957,2160,0,44.31,20.65
嘉義市,東區,頂寮里,1066,442,624,10,1076,2474,0,43.49,17.87
嘉義市,東區,安寮里,1128,498,630,8,1136,2693,0,42.18,18.49
嘉義市,東區,興安里,1158,544,614,14,1172,2905,0,40.34,18.73
嘉義市,東區,興村里,1526,729,797,11,1537,3865,0,39.77,18.86
嘉義市,東區,興仁里,1519,737,782,10,1529,3606,0,42.4,20.44
嘉義市,東區,過溝里,907,366,541,3,910,1993,0,45.66,18.36
嘉義市,東區,民族里,666,282,384,3,669,1684,0,39.73,16.75
嘉義市,東區,朝陽里,844,343,501,8,852,1923,0,44.31,17.84
嘉義市,東區,華南里,801,337,464,9,810,1928,0,42.01,17.48
嘉義市,東區,東興里,848,373,475,7,855,1797,0,47.58,20.76
嘉義市,東區,中山里,900,458,442,7,907,1852,0,48.97,24.73
嘉義市,東區,中央里,994,379,615,7,1001,2130,0,47.0,17.79
嘉義市,東區,林森里,975,431,544,0,975,2284,0,42.69,18.87
嘉義市,東區,北門里,952,380,572,12,964,2085,0,46.24,18.23
嘉義市,東區,蘭潭里,910,457,453,3,913,2195,0,41.59,20.82
嘉義市,東區,文雅里,1625,806,819,8,1633,3695,0,44.19,21.81
嘉義市,東區,安業里,776,373,403,7,783,1950,0,40.15,19.13
嘉義市,東區,義教里,1042,482,560,3,1045,2719,0,38.43,17.73
嘉義市,東區,合計,42418,19997,22421,291,42709,100157,119170,42.64,19.97
嘉義市,西區,香湖里,302,120,182,3,305,819,0,37.24,14.65
嘉義市,西區,湖邊里,804,307,497,6,810,2045,0,39.61,15.01
嘉義市,西區,北榮里,1021,382,639,10,1031,2205,0,46.76,17.32
嘉義市,西區,重興里,764,306,458,11,775,1945,0,39.85,15.73
嘉義市,西區,竹圍里,1735,722,1013,19,1754,4451,0,39.41,16.22
嘉義市,西區,新厝里,1740,623,1117,18,1758,4153,0,42.33,15.0
嘉義市,西區,保安里,1304,560,744,7,1311,3225,0,40.65,17.36
嘉義市,西區,北湖里,1175,458,717,6,1181,2954,0,39.98,15.5
嘉義市,西區,下埤里,591,228,363,8,599,1556,0,38.5,14.65
嘉義市,西區,竹村里,426,182,244,7,433,1125,0,38.49,16.18
嘉義市,西區,大溪里,818,301,517,6,824,2143,0,38.45,14.05
嘉義市,西區,福全里,1612,708,904,20,1632,4114,0,39.67,17.21
嘉義市,西區,西平里,1339,561,778,13,1352,3239,0,41.74,17.32
嘉義市,西區,磚磘里,1395,574,821,11,1406,3497,0,40.21,16.41
嘉義市,西區,港坪里,1359,622,737,6,1365,3363,0,40.59,18.5
嘉義市,西區,頭港里,752,319,433,7,759,1847,0,41.09,17.27
嘉義市,西區,劉厝里,2652,1252,1400,21,2673,6843,0,39.06,18.3
嘉義市,西區,新西里,792,335,457,11,803,2010,0,39.95,16.67
嘉義市,西區,書院里,869,378,491,9,878,1889,0,46.48,20.01
嘉義市,西區,培元里,773,444,329,3,776,1615,0,48.05,27.49
嘉義市,西區,垂楊里,680,291,389,11,691,1915,0,36.08,15.2
嘉義市,西區,車店里,2339,1012,1327,18,2357,5748,0,41.01,17.61
嘉義市,西區,福民里,2122,977,1145,14,2136,5437,0,39.29,17.97
嘉義市,西區,湖內里,1768,692,1076,6,1774,4510,0,39.33,15.34
嘉義市,西區,美源里,1534,672,862,7,1541,3560,0,43.29,18.88
嘉義市,西區,育英里,778,325,453,2,780,1726,0,45.19,18.83
嘉義市,西區,致遠里,817,610,207,6,823,1739,0,47.33,35.08
嘉義市,西區,光路里,2151,995,1156,29,2180,5111,0,42.65,19.47
嘉義市,西區,翠岱里,651,494,157,6,657,1383,0,47.51,35.72
嘉義市,西區,自強里,697,319,378,6,703,1622,0,43.34,19.67
嘉義市,西區,永和里,779,335,444,2,781,1864,0,41.9,17.97
嘉義市,西區,新富里,734,231,503,5,739,1627,0,45.42,14.2
嘉義市,西區,文化里,1026,397,629,6,1032,2211,0,46.68,17.96
嘉義市,西區,西榮里,1001,375,626,10,1011,2209,0,45.77,16.98
嘉義市,西區,國華里,548,240,308,3,551,1253,0,43.97,19.15
嘉義市,西區,番社里,636,242,394,9,645,1355,0,47.6,17.86
嘉義市,西區,導明里,688,277,411,6,694,1512,0,45.9,18.32
嘉義市,西區,慶安里,635,245,390,6,641,1521,0,42.14,16.11
嘉義市,西區,後驛里,805,303,502,6,811,2042,0,39.72,14.84
嘉義市,西區,福安里,1711,727,984,7,1718,4195,0,40.95,17.33
嘉義市,西區,獅子里,1142,501,641,7,1149,2686,0,42.78,18.65
嘉義市,西區,紅瓦里,648,247,401,3,651,1570,0,41.46,15.73
嘉義市,西區,保福里,1367,605,762,4,1371,3637,0,37.7,16.63
嘉義市,西區,保生里,1836,756,1080,10,1846,4295,0,42.98,17.6
嘉義市,西區,北新里,507,190,317,4,511,1115,0,45.83,17.04
嘉義市,西區,合計,49823,21440,28383,395,50218,120881,145551,41.54,17.74
嘉義市,合計,合計,92241,41437,50804,686,92927,221038,264721,42.04,18.75
金門縣,金城鎮,東門里,956,851,105,10,966,4809,0,20.09,17.7
金門縣,金城鎮,西門里,2026,1811,215,14,2040,9671,0,21.09,18.73
金門縣,金城鎮,南門里,1067,919,148,13,1080,5344,0,20.21,17.2
金門縣,金城鎮,北門里,725,636,89,8,733,3979,0,18.42,15.98
金門縣,金城鎮,古城里,730,625,105,7,737,4023,0,18.32,15.54
金門縣,金城鎮,金水里,458,399,59,4,462,2226,0,20.75,17.92
金門縣,金城鎮,珠沙里,501,440,61,5,506,2885,0,17.54,15.25
金門縣,金城鎮,賢庵里,845,704,141,6,851,4730,0,17.99,14.88
金門縣,金城鎮,合計,7308,6385,923,67,7375,37667,42770,19.58,16.95
金門縣,金沙鎮,汶沙里,967,874,93,12,979,5076,0,19.29,17.22
金門縣,金沙鎮,三山里,335,302,33,8,343,1955,0,17.54,15.45
金門縣,金沙鎮,大洋里,216,197,19,4,220,1153,0,19.08,17.09
金門縣,金沙鎮,光前里,437,375,62,4,441,2348,0,18.78,15.97
金門縣,金沙鎮,何斗里,376,347,29,7,383,2045,0,18.73,16.97
金門縣,金沙鎮,西園里,264,245,19,1,265,1592,0,16.65,15.39
金門縣,金沙鎮,官嶼里,367,336,31,5,372,2210,0,16.83,15.2
金門縣,金沙鎮,浦山里,448,404,44,5,453,2345,0,19.32,17.23
金門縣,金沙鎮,合計,3410,3080,330,46,3456,18724,20622,18.46,16.45
金門縣,金湖鎮,新市里,840,750,90,14,854,3969,0,21.52,18.9
金門縣,金湖鎮,山外里,655,572,83,15,670,3328,0,20.13,17.19
金門縣,金湖鎮,正義里,514,452,62,12,526,2699,0,19.49,16.75
金門縣,金湖鎮,料羅里,424,362,62,5,429,2132,0,20.12,16.98
金門縣,金湖鎮,瓊林里,653,566,87,10,663,3259,0,20.34,17.37
金門縣,金湖鎮,新湖里,1539,1286,253,10,1549,8073,0,19.19,15.93
金門縣,金湖鎮,溪湖里,236,218,18,6,242,1560,0,15.51,13.97
金門縣,金湖鎮,蓮庵里,354,316,38,4,358,1704,0,21.01,18.54
金門縣,金湖鎮,合計,5215,4522,693,76,5291,26724,30316,19.8,16.92
金門縣,金寧鄉,古寧村,479,411,68,4,483,3363,0,14.36,12.22
金門縣,金寧鄉,安美村,822,702,120,17,839,5049,0,16.62,13.9
金門縣,金寧鄉,后盤村,301,263,38,4,305,1618,0,18.85,16.25
金門縣,金寧鄉,湖埔村,1523,1228,295,12,1535,7551,0,20.33,16.26
金門縣,金寧鄉,榜林村,927,800,127,12,939,5268,0,17.82,15.19
金門縣,金寧鄉,盤山村,1283,950,333,10,1293,6403,0,20.19,14.84
金門縣,金寧鄉,合計,5335,4354,981,59,5394,29252,32749,18.44,14.88
金門縣,烈嶼鄉,上岐村,456,422,34,9,465,2843,0,16.36,14.84
金門縣,烈嶼鄉,上林村,184,168,16,6,190,1428,0,13.31,11.76
金門縣,烈嶼鄉,西口村,342,300,42,9,351,2415,0,14.53,12.42
金門縣,烈嶼鄉,林湖村,611,553,58,5,616,3328,0,18.51,16.62
金門縣,烈嶼鄉,黃埔村,229,213,16,3,232,1642,0,14.13,12.97
金門縣,烈嶼鄉,合計,1822,1656,166,32,1854,11656,12646,15.91,14.21
金門縣,烏坵鄉,大坵村,19,15,4,0,19,270,0,7.04,5.56
金門縣,烏坵鄉,小坵村,18,15,3,0,18,299,0,6.02,5.02
金門縣,烏坵鄉,合計,37,30,7,0,37,569,661,6.5,5.27
金門縣,合計,合計,23127,20027,3100,280,23407,124592,139764,18.79,16.07
連江縣,南竿鄉,介壽村,646,567,79,6,652,1982,0,32.9,28.61
連江縣,南竿鄉,復興村、福沃村,466,399,67,7,473,1682,0,28.12,23.72
連江縣,南竿鄉,清水村、珠螺村,333,279,54,1,334,1223,0,27.31,22.81
連江縣,南竿鄉,仁愛村、津沙村、馬祖村、四維村,438,387,51,3,441,1618,0,27.26,23.92
連江縣,南竿鄉,合計,1883,1632,251,17,1900,6505,7644,29.21,25.09
連江縣,北竿鄉,塘岐村、后沃村,331,279,52,4,335,1310,0,25.57,21.3
連江縣,北竿鄉,橋仔村、芹壁村、坂里村、白沙村,285,249,36,4,289,1227,0,23.55,20.29
連江縣,北竿鄉,合計,616,528,88,8,624,2537,2846,24.6,20.81
連江縣,莒光鄉,青帆村、田沃村、西坵村,157,132,25,1,158,668,0,23.65,19.76
連江縣,莒光鄉,福正村、大坪村,140,126,14,1,141,695,0,20.29,18.13
連江縣,莒光鄉,合計,297,258,39,2,299,1363,1496,21.94,18.93
連江縣,東引鄉,中柳村、樂華村,293,258,35,2,295,1268,0,23.26,20.35
連江縣,東引鄉,合計,293,258,35,2,295,1268,1463,23.26,20.35
連江縣,合計,合計,3089,2676,413,29,3118,11673,13449,26.71,22.92
