縣市,鄉鎮市區,村里,valid_ticket,agree_ticket,disagree_ticket,invalid_ticket,vote_ticket,votable_population,population,vote_to_votable,agree_to_votable
臺北市,松山區,莊敬里,2014,1077,937,19,2033,4467,0,45.51,24.11
臺北市,松山區,東榮里,3396,1681,1715,19,3415,6468,0,52.8,25.99
臺北市,松山區,三民里,2928,1580,1348,20,2948,5723,0,51.51,27.61
臺北市,松山區,新益里,1989,984,1005,16,2005,3881,0,51.66,25.35
臺北市,松山區,富錦里,2173,1146,1027,16,2189,4281,0,51.13,26.77
臺北市,松山區,新東里,2048,1106,942,19,2067,4135,0,49.99,26.75
臺北市,松山區,富泰里,1886,1120,766,15,1901,3884,0,48.94,28.84
臺北市,松山區,介壽里,1790,890,900,15,1805,3540,0,50.99,25.14
臺北市,松山區,精忠里,1781,953,828,13,1794,3553,0,50.49,26.82
臺北市,松山區,東光里,3031,1689,1342,30,3061,6051,0,50.59,27.91
臺北市,松山區,龍田里,4266,2742,1524,38,4304,8377,0,51.38,32.73
臺北市,松山區,東昌里,1172,537,635,8,1180,2184,0,54.03,24.59
臺北市,松山區,東勢里,1771,883,888,17,1788,3518,0,50.82,25.1
臺北市,松山區,中華里,2635,1435,1200,32,2667,5140,0,51.89,27.92
臺北市,松山區,民有里,3779,1797,1982,34,3813,7351,0,51.87,24.45
臺北市,松山區,民福里,2826,1642,1184,27,2853,5381,0,53.02,30.51
臺北市,松山區,慈祐里,2741,1272,1469,21,2762,7162,0,38.56,17.76
臺北市,松山區,安平里,3322,1635,1687,27,3349,7230,0,46.32,22.61
臺北市,松山區,鵬程里,2273,1387,886,25,2298,4616,0,49.78,30.05
臺北市,松山區,自強里,3978,2904,1074,45,4023,7730,0,52.04,37.57
臺北市,松山區,吉祥里,3370,1810,1560,27,3397,6959,0,48.81,26.01
臺北市,松山區,新聚里,3078,1517,1561,37,3115,6657,0,46.79,22.79
臺北市,松山區,復盛里,2629,1436,1193,31,2660,5286,0,50.32,27.17
臺北市,松山區,中正里,3460,1654,1806,31,3491,7611,0,45.87,21.73
臺北市,松山區,中崙里,1570,778,792,19,1589,3317,0,47.9,23.45
臺北市,松山區,美仁里,1412,669,743,10,1422,2882,0,49.34,23.21
臺北市,松山區,吉仁里,1480,739,741,10,1490,3234,0,46.07,22.85
臺北市,松山區,敦化里,2883,1420,1463,32,2915,5590,0,52.15,25.4
臺北市,松山區,復源里,1325,722,603,17,1342,2642,0,50.79,27.33
臺北市,松山區,復建里,1804,974,830,20,1824,3714,0,49.11,26.23
臺北市,松山區,復勢里,2507,1193,1314,23,2530,5206,0,48.6,22.92
臺北市,松山區,福成里,1049,496,553,16,1065,2147,0,49.6,23.1
臺北市,松山區,松基里,1463,715,748,14,1477,3047,0,48.47,23.47
臺北市,松山區,合計,79829,42583,37246,743,80572,162964,196890,49.44,26.13
臺北市,信義區,西村里,2102,1449,653,26,2128,4958,0,42.92,29.23
臺北市,信義區,正和里,1965,1165,800,18,1983,3767,0,52.64,30.93
臺北市,信義區,興隆里,1009,597,412,10,1019,2224,0,45.82,26.84
臺北市,信義區,中興里,1295,710,585,12,1307,2903,0,45.02,24.46
臺北市,信義區,新仁里,1330,793,537,15,1345,2732,0,49.23,29.03
臺北市,信義區,興雅里,2176,1148,1028,27,2203,4753,0,46.35,24.15
臺北市,信義區,敦厚里,1984,1068,916,18,2002,4357,0,45.95,24.51
臺北市,信義區,廣居里,3047,1664,1383,35,3082,6335,0,48.65,26.27
臺北市,信義區,安康里,3903,2093,1810,37,3940,8511,0,46.29,24.59
臺北市,信義區,六藝里,1417,718,699,16,1433,3102,0,46.2,23.15
臺北市,信義區,雅祥里,2018,970,1048,23,2041,4266,0,47.84,22.74
臺北市,信義區,五常里,1476,772,704,11,1487,3106,0,47.88,24.86
臺北市,信義區,五全里,1948,860,1088,13,1961,4081,0,48.05,21.07
臺北市,信義區,永吉里,1414,548,866,8,1422,3370,0,42.2,16.26
臺北市,信義區,長春里,1556,758,798,20,1576,3629,0,43.43,20.89
臺北市,信義區,四育里,2326,1072,1254,24,2350,4754,0,49.43,22.55
臺北市,信義區,四維里,2121,1163,958,24,2145,4535,0,47.3,25.64
臺北市,信義區,永春里,1914,933,981,33,1947,4223,0,46.1,22.09
臺北市,信義區,富台里,1722,1069,653,24,1746,3723,0,46.9,28.71
臺北市,信義區,國業里,2822,1517,1305,23,2845,6147,0,46.28,24.68
臺北市,信義區,松隆里,872,462,410,7,879,1924,0,45.69,24.01
臺北市,信義區,松友里,2527,1358,1169,20,2547,5536,0,46.01,24.53
臺北市,信義區,松光里,1949,947,1002,15,1964,4245,0,46.27,22.31
臺北市,信義區,中坡里,1865,943,922,22,1887,3791,0,49.78,24.87
臺北市,信義區,中行里,3059,1458,1601,27,3086,6724,0,45.9,21.68
臺北市,信義區,大道里,2474,1164,1310,14,2488,5177,0,48.06,22.48
臺北市,信義區,大仁里,1520,770,750,8,1528,3445,0,44.35,22.35
臺北市,信義區,景新里,2039,1194,845,23,2062,4324,0,47.69,27.61
臺北市,信義區,惠安里,2535,1496,1039,29,2564,5572,0,46.02,26.85
臺北市,信義區,三張里,3542,1985,1557,33,3575,7503,0,47.65,26.46
臺北市,信義區,三犁里,2010,1131,879,23,2033,4453,0,45.65,25.4
臺北市,信義區,六合里,2658,1625,1033,29,2687,5784,0,46.46,28.09
臺北市,信義區,泰和里,2730,1530,1200,25,2755,6519,0,42.26,23.47
臺北市,信義區,景聯里,1913,1044,869,18,1931,3961,0,48.75,26.36
臺北市,信義區,景勤里,1478,851,627,11,1489,3292,0,45.23,25.85
臺北市,信義區,雙和里,2930,1693,1237,22,2952,6033,0,48.93,28.06
臺北市,信義區,嘉興里,1322,708,614,14,1336,2713,0,49.24,26.1
臺北市,信義區,黎順里,1553,873,680,15,1568,3427,0,45.75,25.47
臺北市,信義區,黎平里,2906,1637,1269,40,2946,5973,0,49.32,27.41
臺北市,信義區,黎忠里,1990,1116,874,15,2005,4141,0,48.42,26.95
臺北市,信義區,黎安里,733,470,263,16,749,1734,0,43.19,27.1
臺北市,信義區,合計,84150,45522,38628,843,84993,181747,210936,46.76,25.05
臺北市,大安區,德安里,2293,1377,916,15,2308,4632,0,49.83,29.73
臺北市,大安區,仁慈里,2172,1084,1088,15,2187,4304,0,50.81,25.19
臺北市,大安區,和安里,2631,1478,1153,16,2647,5471,0,48.38,27.02
臺北市,大安區,民炤里,3229,1671,1558,23,3252,6608,0,49.21,25.29
臺北市,大安區,仁愛里,1910,1012,898,19,1929,4212,0,45.8,24.03
臺北市,大安區,義村里,2463,1578,885,17,2480,4707,0,52.69,33.52
臺北市,大安區,民輝里,2708,1404,1304,25,2733,5704,0,47.91,24.61
臺北市,大安區,昌隆里,1359,669,690,10,1369,2713,0,50.46,24.66
臺北市,大安區,誠安里,1666,848,818,18,1684,3427,0,49.14,24.74
臺北市,大安區,光武里,2846,1508,1338,28,2874,6211,0,46.27,24.28
臺北市,大安區,龍坡里,2339,1261,1078,30,2369,4608,0,51.41,27.37
臺北市,大安區,龍泉里,1909,983,926,18,1927,4046,0,47.63,24.3
臺北市,大安區,古風里,1794,935,859,15,1809,3495,0,51.76,26.75
臺北市,大安區,古莊里,2894,1534,1360,20,2914,6074,0,47.97,25.26
臺北市,大安區,龍安里,2440,1235,1205,22,2462,6710,0,36.69,18.41
臺北市,大安區,錦安里,2353,1286,1067,16,2369,4806,0,49.29,26.76
臺北市,大安區,福住里,2381,1221,1160,13,2394,5061,0,47.3,24.13
臺北市,大安區,永康里,1431,761,670,10,1441,2977,0,48.4,25.56
臺北市,大安區,光明里,1466,782,684,23,1489,2987,0,49.85,26.18
臺北市,大安區,錦泰里,1496,861,635,18,1514,3004,0,50.4,28.66
臺北市,大安區,錦華里,2362,1312,1050,18,2380,4627,0,51.44,28.36
臺北市,大安區,龍圖里,2699,1559,1140,25,2724,5613,0,48.53,27.77
臺北市,大安區,新龍里,2882,1897,985,25,2907,5527,0,52.6,34.32
臺北市,大安區,龍陣里,1468,820,648,17,1485,2947,0,50.39,27.82
臺北市,大安區,龍雲里,1994,1061,933,19,2013,3937,0,51.13,26.95
臺北市,大安區,龍生里,2747,1553,1194,34,2781,5409,0,51.41,28.71
臺北市,大安區,住安里,1877,1072,805,16,1893,4245,0,44.59,25.25
臺北市,大安區,義安里,2073,1186,887,12,2085,4455,0,46.8,26.62
臺北市,大安區,通化里,2475,1219,1256,29,2504,5249,0,47.7,23.22
臺北市,大安區,通安里,2183,1150,1033,26,2209,4590,0,48.13,25.05
臺北市,大安區,臨江里,1628,870,758,23,1651,3527,0,46.81,24.67
臺北市,大安區,法治里,1867,1132,735,19,1886,3732,0,50.54,30.33
臺北市,大安區,全安里,1788,1026,762,15,1803,3699,0,48.74,27.74
臺北市,大安區,群賢里,2397,1449,948,26,2423,4899,0,49.46,29.58
臺北市,大安區,群英里,3129,2209,920,33,3162,5848,0,54.07,37.77
臺北市,大安區,虎嘯里,1553,853,700,10,1563,3137,0,49.82,27.19
臺北市,大安區,臥龍里,870,508,362,13,883,1729,0,51.07,29.38
臺北市,大安區,龍淵里,3680,1955,1725,31,3711,7435,0,49.91,26.29
臺北市,大安區,龍門里,1840,960,880,20,1860,3529,0,52.71,27.2
臺北市,大安區,大學里,3640,1963,1677,37,3677,6961,0,52.82,28.2
臺北市,大安區,芳和里,2338,1337,1001,23,2361,4904,0,48.14,27.26
臺北市,大安區,黎元里,2088,1130,958,34,2122,4683,0,45.31,24.13
臺北市,大安區,黎孝里,3195,1742,1453,37,3232,6467,0,49.98,26.94
臺北市,大安區,黎和里,1876,1097,779,25,1901,3938,0,48.27,27.86
臺北市,大安區,建安里,1821,1009,812,11,1832,4048,0,45.26,24.93
臺北市,大安區,建倫里,2267,1231,1036,24,2291,5023,0,45.61,24.51
臺北市,大安區,敦安里,2345,1222,1123,26,2371,5100,0,46.49,23.96
臺北市,大安區,正聲里,1761,995,766,19,1780,3818,0,46.62,26.06
臺北市,大安區,敦煌里,2336,1229,1107,26,2362,4922,0,47.99,24.97
臺北市,大安區,華聲里,1577,860,717,10,1587,3473,0,45.7,24.76
臺北市,大安區,車層里,2435,1273,1162,23,2458,5221,0,47.08,24.38
臺北市,大安區,光信里,3054,1675,1379,43,3097,6249,0,49.56,26.8
臺北市,大安區,學府里,970,579,391,12,982,2171,0,45.23,26.67
臺北市,大安區,合計,116995,64621,52374,1132,118127,242869,296546,48.64,26.61
臺北市,中山區,正守里,1271,603,668,15,1286,2806,0,45.83,21.49
臺北市,中山區,正義里,1848,920,928,14,1862,4541,0,41.0,20.26
臺北市,中山區,正得里,1370,669,701,17,1387,3136,0,44.23,21.33
臺北市,中山區,民安里,1820,809,1011,17,1837,3798,0,48.37,21.3
臺北市,中山區,康樂里,1005,518,487,9,1014,2307,0,43.95,22.45
臺北市,中山區,中山里,2493,1161,1332,25,2518,5902,0,42.66,19.67
臺北市,中山區,聚盛里,1463,761,702,10,1473,3728,0,39.51,20.41
臺北市,中山區,集英里,2719,1166,1553,21,2740,5936,0,46.16,19.64
臺北市,中山區,聚葉里,1488,667,821,10,1498,3471,0,43.16,19.22
臺北市,中山區,恆安里,1776,823,953,17,1793,4310,0,41.6,19.1
臺北市,中山區,晴光里,1939,977,962,18,1957,4704,0,41.6,20.77
臺北市,中山區,圓山里,1542,700,842,16,1558,3587,0,43.43,19.51
臺北市,中山區,劍潭里,1553,1169,384,19,1572,3095,0,50.79,37.77
臺北市,中山區,大直里,3692,2037,1655,39,3731,7456,0,50.04,27.32
臺北市,中山區,成功里,2473,1201,1272,29,2502,5305,0,47.16,22.64
臺北市,中山區,永安里,3811,1979,1832,41,3852,7732,0,49.82,25.59
臺北市,中山區,大佳里,412,134,278,4,416,904,0,46.02,14.82
臺北市,中山區,新喜里,1948,823,1125,14,1962,4399,0,44.6,18.71
臺北市,中山區,新庄里,1996,883,1113,21,2017,4267,0,47.27,20.69
臺北市,中山區,新福里,2108,822,1286,19,2127,4414,0,48.19,18.62
臺北市,中山區,松江里,2564,1132,1432,22,2586,5384,0,48.03,21.03
臺北市,中山區,新生里,1854,788,1066,20,1874,4061,0,46.15,19.4
臺北市,中山區,中庄里,1953,817,1136,19,1972,4318,0,45.67,18.92
臺北市,中山區,行政里,2333,1112,1221,21,2354,6616,0,35.58,16.81
臺北市,中山區,行仁里,3073,1303,1770,22,3095,6794,0,45.55,19.18
臺北市,中山區,行孝里,1587,632,955,14,1601,3692,0,43.36,17.12
臺北市,中山區,下埤里,3074,1353,1721,28,3102,6421,0,48.31,21.07
臺北市,中山區,江寧里,2844,1382,1462,25,2869,5828,0,49.23,23.71
臺北市,中山區,江山里,3104,1377,1727,24,3128,6371,0,49.1,21.61
臺北市,中山區,中吉里,2267,970,1297,18,2285,4719,0,48.42,20.56
臺北市,中山區,中原里,2191,933,1258,9,2200,4380,0,50.23,21.3
臺北市,中山區,興亞里,2151,978,1173,22,2173,4589,0,47.35,21.31
臺北市,中山區,中央里,1468,669,799,10,1478,3031,0,48.76,22.07
臺北市,中山區,朱馥里,2073,1021,1052,17,2090,4892,0,42.72,20.87
臺北市,中山區,龍洲里,2233,1496,737,23,2256,4278,0,52.73,34.97
臺北市,中山區,朱園里,1861,820,1041,14,1875,3885,0,48.26,21.11
臺北市,中山區,埤頭里,1308,638,670,12,1320,2772,0,47.62,23.02
臺北市,中山區,朱崙里,1208,549,659,12,1220,2553,0,47.79,21.5
臺北市,中山區,力行里,2483,1102,1381,26,2509,5215,0,48.11,21.13
臺北市,中山區,復華里,1932,1048,884,26,1958,4000,0,48.95,26.2
臺北市,中山區,金泰里,2896,1520,1376,24,2920,6417,0,45.5,23.69
臺北市,中山區,北安里,1079,620,459,11,1090,2179,0,50.02,28.45
臺北市,中山區,合計,86263,41082,45181,794,87057,188193,219840,46.26,21.83
臺北市,中正區,水源里,1188,586,602,18,1206,2569,0,46.94,22.81
臺北市,中正區,富水里,893,575,318,7,900,2107,0,42.71,27.29
臺北市,中正區,文盛里,1113,573,540,7,1120,2181,0,51.35,26.27
臺北市,中正區,林興里,1894,1074,820,11,1905,4011,0,47.49,26.78
臺北市,中正區,河堤里,1947,1109,838,12,1959,3802,0,51.53,29.17
臺北市,中正區,頂東里,2678,1398,1280,29,2707,5155,0,52.51,27.12
臺北市,中正區,網溪里,2485,1320,1165,27,2512,4893,0,51.34,26.98
臺北市,中正區,板溪里,1299,712,587,14,1313,2775,0,47.32,25.66
臺北市,中正區,螢圃里,2369,1319,1050,18,2387,4773,0,50.01,27.63
臺北市,中正區,螢雪里,1765,960,805,15,1780,3653,0,48.73,26.28
臺北市,中正區,永功里,2466,1246,1220,28,2494,5214,0,47.83,23.9
臺北市,中正區,永昌里,1980,1044,936,19,1999,4177,0,47.86,24.99
臺北市,中正區,龍興里,1328,653,675,14,1342,2906,0,46.18,22.47
臺北市,中正區,忠勤里,2327,1329,998,34,2361,5486,0,43.04,24.23
臺北市,中正區,廈安里,1586,750,836,15,1601,3475,0,46.07,21.58
臺北市,中正區,愛國里,1229,607,622,11,1240,2583,0,48.01,23.5
臺北市,中正區,南門里,1119,642,477,12,1131,2153,0,52.53,29.82
臺北市,中正區,龍光里,1352,745,607,13,1365,2662,0,51.28,27.99
臺北市,中正區,南福里,4408,2364,2044,38,4446,8918,0,49.85,26.51
臺北市,中正區,龍福里,2023,1067,956,23,2046,4216,0,48.53,25.31
臺北市,中正區,新營里,3274,1893,1381,27,3301,6851,0,48.18,27.63
臺北市,中正區,建國里,562,319,243,5,567,1240,0,45.73,25.73
臺北市,中正區,光復里,1400,719,681,14,1414,3153,0,44.85,22.8
臺北市,中正區,黎明里,1076,567,509,7,1083,2719,0,39.83,20.85
臺北市,中正區,梅花里,1288,611,677,10,1298,2626,0,49.43,23.27
臺北市,中正區,幸福里,1907,1030,877,20,1927,4871,0,39.56,21.15
臺北市,中正區,幸市里,1926,961,965,15,1941,3689,0,52.62,26.05
臺北市,中正區,東門里,1500,864,636,20,1520,3113,0,48.83,27.75
臺北市,中正區,文北里,2296,1185,1111,21,2317,4517,0,51.3,26.23
臺北市,中正區,文祥里,3067,1602,1465,35,3102,6282,0,49.38,25.5
臺北市,中正區,三愛里,3374,1737,1637,45,3419,6997,0,48.86,24.82
臺北市,中正區,合計,59119,31561,27558,584,59703,123767,153172,48.24,25.5
臺北市,大同區,玉泉里,1136,461,675,13,1149,2534,0,45.34,18.19
臺北市,大同區,建明里,1219,492,727,10,1229,2790,0,44.05,17.63
臺北市,大同區,建功里,1732,717,1015,19,1751,3999,0,43.79,17.93
臺北市,大同區,建泰里,1423,550,873,26,1449,3039,0,47.68,18.1
臺北市,大同區,永樂里,2040,766,1274,11,2051,4399,0,46.62,17.41
臺北市,大同區,朝陽里,1797,753,1044,17,1814,3812,0,47.59,19.75
臺北市,大同區,星明里,2179,927,1252,18,2197,4940,0,44.47,18.77
臺北市,大同區,光能里,1952,775,1177,8,1960,4161,0,47.1,18.63
臺北市,大同區,大有里,1808,650,1158,22,1830,3943,0,46.41,16.48
臺北市,大同區,延平里,1595,679,916,9,1604,3592,0,44.65,18.9
臺北市,大同區,雙連里,3431,1392,2039,25,3456,7671,0,45.05,18.15
臺北市,大同區,南芳里,1541,588,953,11,1552,3376,0,45.97,17.42
臺北市,大同區,民權里,2476,1044,1432,27,2503,5223,0,47.92,19.99
臺北市,大同區,景星里,981,368,613,10,991,2231,0,44.42,16.49
臺北市,大同區,隆和里,1412,517,895,11,1423,2898,0,49.1,17.84
臺北市,大同區,蓬萊里,1951,793,1158,16,1967,4213,0,46.69,18.82
臺北市,大同區,國順里,1001,361,640,7,1008,2305,0,43.73,15.66
臺北市,大同區,國慶里,1903,754,1149,15,1918,3894,0,49.26,19.36
臺北市,大同區,揚雅里,1424,531,893,12,1436,4063,0,35.34,13.07
臺北市,大同區,斯文里,1811,677,1134,12,1823,4057,0,44.93,16.69
臺北市,大同區,鄰江里,2592,979,1613,22,2614,5537,0,47.21,17.68
臺北市,大同區,至聖里,3178,1252,1926,30,3208,6748,0,47.54,18.55
臺北市,大同區,老師里,2155,785,1370,16,2171,4953,0,43.83,15.85
臺北市,大同區,重慶里,2688,1195,1493,15,2703,5666,0,47.71,21.09
臺北市,大同區,保安里,1855,685,1170,20,1875,3771,0,49.72,18.16
臺北市,大同區,合計,47280,18691,28589,402,47682,103815,122719,45.93,18.0
臺北市,萬華區,福星里,1952,1028,924,25,1977,4638,0,42.63,22.16
臺北市,萬華區,萬壽里,1115,579,536,19,1134,2831,0,40.06,20.45
臺北市,萬華區,西門里,1338,698,640,15,1353,3187,0,42.45,21.9
臺北市,萬華區,新起里,2697,1297,1400,39,2736,5920,0,46.22,21.91
臺北市,萬華區,菜園里,2505,1105,1400,25,2530,5356,0,47.24,20.63
臺北市,萬華區,青山里,2255,1006,1249,17,2272,5124,0,44.34,19.63
臺北市,萬華區,富民里,1960,778,1182,29,1989,4299,0,46.27,18.1
臺北市,萬華區,福音里,1569,661,908,9,1578,3366,0,46.88,19.64
臺北市,萬華區,仁德里,2022,929,1093,16,2038,4094,0,49.78,22.69
臺北市,萬華區,富福里,1914,775,1139,21,1935,5354,0,36.14,14.48
臺北市,萬華區,頂碩里,2810,1170,1640,32,2842,6064,0,46.87,19.29
臺北市,萬華區,雙園里,1769,755,1014,23,1792,3864,0,46.38,19.54
臺北市,萬華區,新忠里,1525,1160,365,15,1540,2993,0,51.45,38.76
臺北市,萬華區,新和里,3760,2663,1097,53,3813,7108,0,53.64,37.46
臺北市,萬華區,糖廍里,2204,937,1267,16,2220,4679,0,47.45,20.03
臺北市,萬華區,和平里,2477,889,1588,31,2508,5752,0,43.6,15.46
臺北市,萬華區,綠堤里,1513,736,777,16,1529,3698,0,41.35,19.9
臺北市,萬華區,華江里,3195,1421,1774,24,3219,7226,0,44.55,19.67
臺北市,萬華區,柳鄉里,1899,756,1143,18,1917,4403,0,43.54,17.17
臺北市,萬華區,日善里,1450,621,829,12,1462,3103,0,47.12,20.01
臺北市,萬華區,新安里,2213,1291,922,31,2244,5228,0,42.92,24.69
臺北市,萬華區,忠德里,1749,726,1023,14,1763,3813,0,46.24,19.04
臺北市,萬華區,孝德里,1315,504,811,7,1322,2802,0,47.18,17.99
臺北市,萬華區,和德里,2298,958,1340,20,2318,5570,0,41.62,17.2
臺北市,萬華區,錦德里,2097,925,1172,21,2118,4714,0,44.93,19.62
臺北市,萬華區,全德里,1681,776,905,26,1707,3631,0,47.01,21.37
臺北市,萬華區,保德里,1335,597,738,12,1347,2752,0,48.95,21.69
臺北市,萬華區,銘德里,1770,752,1018,16,1786,3985,0,44.82,18.87
臺北市,萬華區,榮德里,1486,635,851,17,1503,3075,0,48.88,20.65
臺北市,萬華區,壽德里,1946,907,1039,17,1963,4233,0,46.37,21.43
臺北市,萬華區,興德里,1739,764,975,18,1757,3911,0,44.92,19.53
臺北市,萬華區,華中里,2447,1032,1415,27,2474,5226,0,47.34,19.75
臺北市,萬華區,日祥里,2560,1580,980,22,2582,5167,0,49.97,30.58
臺北市,萬華區,忠貞里,1947,1279,668,32,1979,4179,0,47.36,30.61
臺北市,萬華區,凌霄里,1458,919,539,23,1481,3097,0,47.82,29.67
臺北市,萬華區,騰雲里,1334,821,513,19,1353,2636,0,51.33,31.15
臺北市,萬華區,合計,71304,34430,36874,777,72081,157078,179485,45.89,21.92
臺北市,文山區,景行里,2890,1515,1375,24,2914,6344,0,45.93,23.88
臺北市,文山區,景東里,2821,1778,1043,18,2839,5987,0,47.42,29.7
臺北市,文山區,景美里,2058,1091,967,10,2068,4219,0,49.02,25.86
臺北市,文山區,景慶里,2630,1480,1150,29,2659,5431,0,48.96,27.25
臺北市,文山區,景仁里,2337,1375,962,30,2367,4675,0,50.63,29.41
臺北市,文山區,景華里,2365,1403,962,20,2385,4768,0,50.02,29.43
臺北市,文山區,萬有里,2330,1385,945,12,2342,4621,0,50.68,29.97
臺北市,文山區,萬祥里,1864,1039,825,21,1885,3814,0,49.42,27.24
臺北市,文山區,萬隆里,3012,1804,1208,29,3041,6067,0,50.12,29.73
臺北市,文山區,萬年里,2252,1264,988,22,2274,4515,0,50.37,28.0
臺北市,文山區,萬和里,1434,972,462,24,1458,2826,0,51.59,34.39
臺北市,文山區,萬盛里,1945,1138,807,13,1958,3978,0,49.22,28.61
臺北市,文山區,興豐里,2120,1247,873,34,2154,4213,0,51.13,29.6
臺北市,文山區,興光里,1452,873,579,22,1474,3144,0,46.88,27.77
臺北市,文山區,興家里,3101,1937,1164,30,3131,6323,0,49.52,30.63
臺北市,文山區,興得里,2398,1460,938,32,2430,5161,0,47.08,28.29
臺北市,文山區,興業里,2266,1467,799,18,2284,4630,0,49.33,31.68
臺北市,文山區,興安里,2891,1791,1100,26,2917,5698,0,51.19,31.43
臺北市,文山區,興福里,2291,1275,1016,20,2311,4637,0,49.84,27.5
臺北市,文山區,興旺里,3245,2059,1186,32,3277,7009,0,46.75,29.38
臺北市,文山區,興泰里,1735,1009,726,16,1751,3527,0,49.65,28.61
臺北市,文山區,興昌里,2712,1687,1025,26,2738,5643,0,48.52,29.9
臺北市,文山區,試院里,2905,1860,1045,34,2939,5797,0,50.7,32.09
臺北市,文山區,華興里,3785,2326,1459,49,3834,7631,0,50.24,30.48
臺北市,文山區,明義里,1537,900,637,14,1551,3738,0,41.49,24.08
臺北市,文山區,明興里,2794,1701,1093,21,2815,5826,0,48.32,29.2
臺北市,文山區,木柵里,3841,2537,1304,37,3878,7776,0,49.87,32.63
臺北市,文山區,木新里,3461,1918,1543,24,3485,8867,0,39.3,21.63
臺北市,文山區,順興里,2981,1702,1279,28,3009,6234,0,48.27,27.3
臺北市,文山區,樟林里,3284,2056,1228,27,3311,7099,0,46.64,28.96
臺北市,文山區,樟新里,2290,1412,878,23,2313,4662,0,49.61,30.29
臺北市,文山區,樟腳里,2241,1285,956,25,2266,4648,0,48.75,27.65
臺北市,文山區,萬芳里,3203,1984,1219,25,3228,6704,0,48.15,29.59
臺北市,文山區,博嘉里,2359,1337,1022,16,2375,5050,0,47.03,26.48
臺北市,文山區,萬興里,3499,1962,1537,30,3529,7045,0,50.09,27.85
臺北市,文山區,指南里,1533,777,756,13,1546,3435,0,45.01,22.62
臺北市,文山區,老泉里,344,125,219,5,349,778,0,44.86,16.07
臺北市,文山區,忠順里,1895,1257,638,19,1914,3647,0,52.48,34.47
臺北市,文山區,萬美里,2821,1728,1093,23,2844,6271,0,45.35,27.56
臺北市,文山區,政大里,3003,1738,1265,41,3044,6269,0,48.56,27.72
臺北市,文山區,樟文里,2450,1384,1066,28,2478,5223,0,47.44,26.5
臺北市,文山區,興邦里,2145,1449,696,17,2162,4301,0,50.27,33.69
臺北市,文山區,樟樹里,1907,1058,849,15,1922,3996,0,48.1,26.48
臺北市,文山區,合計,106427,63545,42882,1022,107449,222227,264975,48.35,28.59
臺北市,南港區,南港里,2167,1093,1074,14,2181,5637,0,38.69,19.39
臺北市,南港區,中南里,1235,568,667,10,1245,3127,0,39.81,18.16
臺北市,南港區,新富里,1471,667,804,17,1488,3300,0,45.09,20.21
臺北市,南港區,三重里,2705,1397,1308,16,2721,6452,0,42.17,21.65
臺北市,南港區,東新里,2586,1273,1313,19,2605,6152,0,42.34,20.69
臺北市,南港區,新光里,1457,782,675,6,1463,3170,0,46.15,24.67
臺北市,南港區,東明里,2309,1281,1028,24,2333,4785,0,48.76,26.77
臺北市,南港區,西新里,1785,731,1054,18,1803,4037,0,44.66,18.11
臺北市,南港區,玉成里,1857,862,995,15,1872,4075,0,45.94,21.15
臺北市,南港區,合成里,2715,1352,1363,19,2734,5716,0,47.83,23.65
臺北市,南港區,成福里,3037,1735,1302,30,3067,6413,0,47.82,27.05
臺北市,南港區,萬福里,1886,1028,858,18,1904,3623,0,52.55,28.37
臺北市,南港區,鴻福里,1849,950,899,18,1867,3885,0,48.06,24.45
臺北市,南港區,百福里,1994,979,1015,23,2017,4544,0,44.39,21.54
臺北市,南港區,聯成里,1998,1070,928,26,2024,4274,0,47.36,25.04
臺北市,南港區,舊莊里,3008,1465,1543,30,3038,7580,0,40.08,19.33
臺北市,南港區,中研里,3573,1751,1822,41,3614,7890,0,45.8,22.19
臺北市,南港區,九如里,2386,1375,1011,28,2414,5386,0,44.82,25.53
臺北市,南港區,仁福里,2360,1459,901,19,2379,4777,0,49.8,30.54
臺北市,南港區,重陽里,2102,1158,944,18,2120,4541,0,46.69,25.5
臺北市,南港區,合計,44480,22976,21504,409,44889,99364,117188,45.18,23.12
臺北市,內湖區,西湖里,2892,1407,1485,23,2915,6163,0,47.3,22.83
臺北市,內湖區,西康里,3964,2182,1782,52,4016,8190,0,49.04,26.64
臺北市,內湖區,西安里,2741,1454,1287,38,2779,5644,0,49.24,25.76
臺北市,內湖區,港墘里,2462,1243,1219,16,2478,5115,0,48.45,24.3
臺北市,內湖區,港都里,2123,1058,1065,19,2142,4642,0,46.14,22.79
臺北市,內湖區,港富里,3758,1974,1784,33,3791,7960,0,47.63,24.8
臺北市,內湖區,港華里,3547,1812,1735,35,3582,7644,0,46.86,23.7
臺北市,內湖區,內湖里,2605,1439,1166,20,2625,5561,0,47.2,25.88
臺北市,內湖區,湖濱里,3660,2115,1545,33,3693,7099,0,52.02,29.79
臺北市,內湖區,紫星里,3333,1639,1694,28,3361,6865,0,48.96,23.87
臺北市,內湖區,大湖里,2219,1179,1040,14,2233,4641,0,48.11,25.4
臺北市,內湖區,金龍里,2132,1164,968,12,2144,4647,0,46.14,25.05
臺北市,內湖區,金瑞里,2846,1419,1427,26,2872,5790,0,49.6,24.51
臺北市,內湖區,碧山里,2897,1559,1338,31,2928,6061,0,48.31,25.72
臺北市,內湖區,紫雲里,2364,1423,941,19,2383,4880,0,48.83,29.16
臺北市,內湖區,清白里,3530,1920,1610,31,3561,7269,0,48.99,26.41
臺北市,內湖區,葫洲里,2684,1528,1156,24,2708,5983,0,45.26,25.54
臺北市,內湖區,紫陽里,3377,1776,1601,34,3411,7104,0,48.02,25.0
臺北市,內湖區,瑞陽里,3422,2120,1302,35,3457,6596,0,52.41,32.14
臺北市,內湖區,瑞光里,1946,1204,742,18,1964,3925,0,50.04,30.68
臺北市,內湖區,五分里,3426,1722,1704,30,3456,8758,0,39.46,19.66
臺北市,內湖區,東湖里,2952,1503,1449,24,2976,6861,0,43.38,21.91
臺北市,內湖區,樂康里,2902,1472,1430,22,2924,6927,0,42.21,21.25
臺北市,內湖區,內溝里,1792,949,843,20,1812,4037,0,44.88,23.51
臺北市,內湖區,週美里,3312,1581,1731,27,3339,7466,0,44.72,21.18
臺北市,內湖區,行善里,2937,1417,1520,31,2968,6099,0,48.66,23.23
臺北市,內湖區,石潭里,1444,770,674,11,1455,3369,0,43.19,22.86
臺北市,內湖區,湖興里,2731,1424,1307,23,2754,7424,0,37.1,19.18
臺北市,內湖區,湖元里,2102,1061,1041,24,2126,4537,0,46.86,23.39
臺北市,內湖區,安湖里,2865,1451,1414,28,2893,6387,0,45.3,22.72
臺北市,內湖區,秀湖里,2580,1487,1093,33,2613,5366,0,48.7,27.71
臺北市,內湖區,安泰里,1956,1044,912,12,1968,4591,0,42.87,22.74
臺北市,內湖區,金湖里,3782,2092,1690,46,3828,8128,0,47.1,25.74
臺北市,內湖區,康寧里,3339,1845,1494,27,3366,7322,0,45.97,25.2
臺北市,內湖區,明湖里,1992,952,1040,15,2007,4501,0,44.59,21.15
臺北市,內湖區,蘆洲里,390,163,227,9,399,1126,0,35.44,14.48
臺北市,內湖區,麗山里,2286,1067,1219,21,2307,4994,0,46.2,21.37
臺北市,內湖區,寶湖里,3694,2065,1629,37,3731,7959,0,46.88,25.95
臺北市,內湖區,南湖里,2133,1201,932,36,2169,4674,0,46.41,25.7
臺北市,內湖區,合計,107117,56881,50236,1017,108134,232305,279598,46.55,24.49
臺北市,士林區,仁勇里,1550,629,921,10,1560,3285,0,47.49,19.15
臺北市,士林區,義信里,1239,592,647,9,1248,2736,0,45.61,21.64
臺北市,士林區,福林里,1131,521,610,19,1150,2482,0,46.33,20.99
臺北市,士林區,福德里,1833,928,905,13,1846,5079,0,36.35,18.27
臺北市,士林區,福志里,3378,1699,1679,21,3399,6507,0,52.24,26.11
臺北市,士林區,舊佳里,2597,1200,1397,19,2616,5295,0,49.41,22.66
臺北市,士林區,福佳里,3179,1479,1700,36,3215,6549,0,49.09,22.58
臺北市,士林區,後港里,2950,1184,1766,23,2973,6846,0,43.43,17.29
臺北市,士林區,福中里,2641,1078,1563,16,2657,5673,0,46.84,19.0
臺北市,士林區,前港里,1731,666,1065,20,1751,3851,0,45.47,17.29
臺北市,士林區,百齡里,2778,1126,1652,28,2806,5841,0,48.04,19.28
臺北市,士林區,承德里,2182,1048,1134,19,2201,4783,0,46.02,21.91
臺北市,士林區,福華里,2249,959,1290,28,2277,5342,0,42.62,17.95
臺北市,士林區,明勝里,1993,888,1105,13,2006,4156,0,48.27,21.37
臺北市,士林區,福順里,2168,830,1338,26,2194,4679,0,46.89,17.74
臺北市,士林區,富光里,2234,851,1383,28,2262,5082,0,44.51,16.75
臺北市,士林區,葫蘆里,2900,1251,1649,32,2932,6264,0,46.81,19.97
臺北市,士林區,葫東里,1608,642,966,8,1616,3514,0,45.99,18.27
臺北市,士林區,社子里,2423,907,1516,23,2446,5517,0,44.34,16.44
臺北市,士林區,社新里,3260,1172,2088,34,3294,7737,0,42.57,15.15
臺北市,士林區,社園里,2756,945,1811,37,2793,6210,0,44.98,15.22
臺北市,士林區,永倫里,2686,960,1726,22,2708,6117,0,44.27,15.69
臺北市,士林區,福安里,1896,450,1446,19,1915,4416,0,43.37,10.19
臺北市,士林區,富洲里,2263,602,1661,28,2291,5424,0,42.24,11.1
臺北市,士林區,岩山里,1335,693,642,10,1345,2895,0,46.46,23.94
臺北市,士林區,名山里,3100,1539,1561,22,3122,6048,0,51.62,25.45
臺北市,士林區,德行里,1865,857,1008,12,1877,3773,0,49.75,22.71
臺北市,士林區,德華里,2287,1028,1259,17,2304,4821,0,47.79,21.32
臺北市,士林區,聖山里,2139,1164,975,13,2152,4319,0,49.83,26.95
臺北市,士林區,忠誠里,2254,1361,893,19,2273,4739,0,47.96,28.72
臺北市,士林區,芝山里,3149,1478,1671,38,3187,6439,0,49.5,22.95
臺北市,士林區,東山里,2095,1167,928,25,2120,4371,0,48.5,26.7
臺北市,士林區,三玉里,2348,1148,1200,18,2366,4881,0,48.47,23.52
臺北市,士林區,蘭雅里,3425,1642,1783,40,3465,7425,0,46.67,22.11
臺北市,士林區,蘭興里,2680,1223,1457,19,2699,5452,0,49.5,22.43
臺北市,士林區,天福里,2432,1176,1256,16,2448,5286,0,46.31,22.25
臺北市,士林區,天祿里,2111,947,1164,16,2127,4413,0,48.2,21.46
臺北市,士林區,天壽里,2068,980,1088,17,2085,4299,0,48.5,22.8
臺北市,士林區,天和里,2996,1446,1550,36,3032,6370,0,47.6,22.7
臺北市,士林區,天山里,2794,1429,1365,34,2828,5880,0,48.1,24.3
臺北市,士林區,天玉里,3535,1726,1809,29,3564,7345,0,48.52,23.5
臺北市,士林區,天母里,2684,1326,1358,29,2713,5559,0,48.8,23.85
臺北市,士林區,永福里,520,185,335,5,525,1083,0,48.48,17.08
臺北市,士林區,公館里,497,159,338,7,504,1228,0,41.04,12.95
臺北市,士林區,新安里,792,295,497,11,803,1668,0,48.14,17.69
臺北市,士林區,陽明里,1111,505,606,14,1125,2666,0,42.2,18.94
臺北市,士林區,菁山里,557,219,338,5,562,1421,0,39.55,15.41
臺北市,士林區,平等里,551,140,411,4,555,1306,0,42.5,10.72
臺北市,士林區,溪山里,565,223,342,7,572,1328,0,43.07,16.79
臺北市,士林區,翠山里,1198,784,414,10,1208,2345,0,51.51,33.43
臺北市,士林區,臨溪里,1160,600,560,9,1169,2508,0,46.61,23.92
臺北市,士林區,合計,107873,48047,59826,1013,108886,233253,274056,46.68,20.6
臺北市,北投區,建民里,1847,794,1053,11,1858,3704,0,50.16,21.44
臺北市,北投區,文林里,1703,721,982,12,1715,3685,0,46.54,19.57
臺北市,北投區,石牌里,2130,937,1193,25,2155,4492,0,47.97,20.86
臺北市,北投區,福興里,2885,1356,1529,33,2918,5935,0,49.17,22.85
臺北市,北投區,榮光里,2596,1239,1357,32,2628,6019,0,43.66,20.58
臺北市,北投區,榮華里,3125,1511,1614,22,3147,6221,0,50.59,24.29
臺北市,北投區,裕民里,3049,1469,1580,23,3072,6632,0,46.32,22.15
臺北市,北投區,振華里,2987,1497,1490,20,3007,6389,0,47.07,23.43
臺北市,北投區,永和里,3718,1744,1974,20,3738,7885,0,47.41,22.12
臺北市,北投區,永欣里,3254,1683,1571,26,3280,6840,0,47.95,24.61
臺北市,北投區,永明里,1984,994,990,18,2002,4020,0,49.8,24.73
臺北市,北投區,東華里,1893,1006,887,19,1912,3773,0,50.68,26.66
臺北市,北投區,吉利里,2590,1370,1220,30,2620,5623,0,46.59,24.36
臺北市,北投區,吉慶里,2001,831,1170,15,2016,4216,0,47.82,19.71
臺北市,北投區,尊賢里,1839,727,1112,13,1852,3960,0,46.77,18.36
臺北市,北投區,立賢里,2094,972,1122,19,2113,4612,0,45.82,21.08
臺北市,北投區,立農里,3619,1663,1956,35,3654,7578,0,48.22,21.95
臺北市,北投區,八仙里,2148,985,1163,13,2161,4729,0,45.7,20.83
臺北市,北投區,洲美里,934,316,618,7,941,1949,0,48.28,16.21
臺北市,北投區,奇岩里,4442,2067,2375,37,4479,9427,0,47.51,21.93
臺北市,北投區,清江里,3373,1536,1837,39,3412,8533,0,39.99,18.0
臺北市,北投區,中央里,3073,1309,1764,29,3102,7167,0,43.28,18.26
臺北市,北投區,長安里,2209,982,1227,21,2230,5324,0,41.89,18.44
臺北市,北投區,大同里,2164,879,1285,25,2189,4700,0,46.57,18.7
臺北市,北投區,溫泉里,2611,1193,1418,22,2633,5643,0,46.66,21.14
臺北市,北投區,林泉里,1023,534,489,5,1028,2679,0,38.37,19.93
臺北市,北投區,中心里,2350,1159,1191,19,2369,5695,0,41.6,20.35
臺北市,北投區,中庸里,1532,671,861,17,1549,3547,0,43.67,18.92
臺北市,北投區,開明里,2667,1347,1320,43,2710,5783,0,46.86,23.29
臺北市,北投區,中和里,2073,1024,1049,22,2095,4233,0,49.49,24.19
臺北市,北投區,智仁里,2252,1120,1132,17,2269,5189,0,43.73,21.58
臺北市,北投區,秀山里,1230,625,605,18,1248,2834,0,44.04,22.05
臺北市,北投區,文化里,1700,1109,591,20,1720,3518,0,48.89,31.52
臺北市,北投區,豐年里,1488,735,753,8,1496,3811,0,39.25,19.29
臺北市,北投區,稻香里,2063,1144,919,16,2079,4730,0,43.95,24.19
臺北市,北投區,桃源里,2391,1029,1362,18,2409,5227,0,46.09,19.69
臺北市,北投區,一德里,2724,1178,1546,32,2756,6316,0,43.64,18.65
臺北市,北投區,關渡里,4193,1979,2214,49,4242,9738,0,43.56,20.32
臺北市,北投區,泉源里,821,333,488,10,831,2119,0,39.22,15.71
臺北市,北投區,湖山里,580,253,327,9,589,1446,0,40.73,17.5
臺北市,北投區,大屯里,415,139,276,2,417,1087,0,38.36,12.79
臺北市,北投區,湖田里,317,133,184,2,319,826,0,38.62,16.1
臺北市,北投區,合計,94087,44293,49794,873,94960,207834,247333,45.69,21.31
臺北市,合計,合計,1004924,514232,490692,9609,1014533,2155416,2562738,47.07,23.86
新北市,板橋區,留侯里,699,388,311,6,705,1395,0,50.54,27.81
新北市,板橋區,流芳里,559,253,306,3,562,1228,0,45.77,20.6
新北市,板橋區,赤松里,421,208,213,2,423,838,0,50.48,24.82
新北市,板橋區,黃石里,464,190,274,8,472,1026,0,46.0,18.52
新北市,板橋區,挹秀里,829,477,352,6,835,1648,0,50.67,28.94
新北市,板橋區,湳興里,1908,902,1006,25,1933,4525,0,42.72,19.93
新北市,板橋區,新興里,1139,523,616,12,1151,2846,0,40.44,18.38
新北市,板橋區,社後里,2470,1151,1319,21,2491,8998,0,27.68,12.79
新北市,板橋區,香社里,1734,728,1006,11,1745,3907,0,44.66,18.63
新北市,板橋區,中正里,1873,827,1046,16,1889,4691,0,40.27,17.63
新北市,板橋區,自強里,2329,1268,1061,23,2352,4425,0,53.15,28.66
新北市,板橋區,自立里,1154,468,686,6,1160,2471,0,46.94,18.94
新北市,板橋區,光華里,1103,560,543,11,1114,2357,0,47.26,23.76
新北市,板橋區,國光里,1792,1238,554,16,1808,3349,0,53.99,36.97
新北市,板橋區,港尾里,1225,590,635,10,1235,2463,0,50.14,23.95
新北市,板橋區,金華里,1456,620,836,14,1470,3446,0,42.66,17.99
新北市,板橋區,港德里,1695,688,1007,17,1712,4107,0,41.68,16.75
新北市,板橋區,民權里,1139,570,569,12,1151,2304,0,49.96,24.74
新北市,板橋區,建國里,1420,575,845,23,1443,3109,0,46.41,18.49
新北市,板橋區,漢生里,1793,839,954,18,1811,3542,0,51.13,23.69
新北市,板橋區,公舘里,1466,588,878,12,1478,3318,0,44.54,17.72
新北市,板橋區,新民里,1661,772,889,19,1680,3648,0,46.05,21.16
新北市,板橋區,幸福里,1403,579,824,13,1416,3487,0,40.61,16.6
新北市,板橋區,忠誠里,1862,1255,607,15,1877,3605,0,52.07,34.81
新北市,板橋區,百壽里,1035,465,570,10,1045,2364,0,44.2,19.67
新北市,板橋區,介壽里,1075,513,562,15,1090,2555,0,42.66,20.08
新北市,板橋區,新埔里,932,367,565,8,940,1865,0,50.4,19.68
新北市,板橋區,華江里,2820,1289,1531,20,2840,6159,0,46.11,20.93
新北市,板橋區,江翠里,1926,731,1195,17,1943,4582,0,42.41,15.95
新北市,板橋區,純翠里,1986,784,1202,9,1995,4774,0,41.79,16.42
新北市,板橋區,溪頭里,2431,985,1446,14,2445,5675,0,43.08,17.36
新北市,板橋區,聯翠里,1456,716,740,11,1467,3287,0,44.63,21.78
新北市,板橋區,宏翠里,1987,917,1070,15,2002,4715,0,42.46,19.45
新北市,板橋區,仁翠里,1125,386,739,15,1140,2555,0,44.62,15.11
新北市,板橋區,新翠里,3171,1305,1866,19,3190,7107,0,44.89,18.36
新北市,板橋區,吉翠里,1499,574,925,13,1512,3275,0,46.17,17.53
新北市,板橋區,德翠里,2755,1303,1452,32,2787,6174,0,45.14,21.1
新北市,板橋區,滿翠里,1123,384,739,14,1137,2666,0,42.65,14.4
新北市,板橋區,明翠里,1829,744,1085,14,1843,4242,0,43.45,17.54
新北市,板橋區,松翠里,1298,504,794,10,1308,2962,0,44.16,17.02
新北市,板橋區,柏翠里,1776,745,1031,20,1796,4168,0,43.09,17.87
新北市,板橋區,龍翠里,1900,759,1141,19,1919,4391,0,43.7,17.29
新北市,板橋區,華翠里,1421,571,850,23,1444,3044,0,47.44,18.76
新北市,板橋區,忠翠里,4151,1937,2214,42,4193,9043,0,46.37,21.42
新北市,板橋區,嵐翠里,922,329,593,6,928,2150,0,43.16,15.3
新北市,板橋區,文翠里,1562,657,905,10,1572,3515,0,44.72,18.69
新北市,板橋區,青翠里,1119,431,688,12,1131,2638,0,42.87,16.34
新北市,板橋區,懷翠里,2085,800,1285,10,2095,5414,0,38.7,14.78
新北市,板橋區,福翠里,534,248,286,5,539,1221,0,44.14,20.31
新北市,板橋區,港嘴里,2284,962,1322,20,2304,5318,0,43.32,18.09
新北市,板橋區,振興里,1803,764,1039,13,1816,3920,0,46.33,19.49
新北市,板橋區,振義里,1676,650,1026,24,1700,3731,0,45.56,17.42
新北市,板橋區,光復里,1284,535,749,10,1294,2939,0,44.03,18.2
新北市,板橋區,埔墘里,2384,1015,1369,23,2407,5578,0,43.15,18.2
新北市,板橋區,長壽里,1188,480,708,14,1202,2572,0,46.73,18.66
新北市,板橋區,福壽里,1309,663,646,16,1325,2920,0,45.38,22.71
新北市,板橋區,海山里,2939,1305,1634,23,2962,6417,0,46.16,20.34
新北市,板橋區,九如里,1080,395,685,13,1093,2522,0,43.34,15.66
新北市,板橋區,玉光里,1875,775,1100,24,1899,4586,0,41.41,16.9
新北市,板橋區,光仁里,1121,490,631,15,1136,2444,0,46.48,20.05
新北市,板橋區,埤墘里,1792,736,1056,14,1806,3765,0,47.97,19.55
新北市,板橋區,永安里,1327,512,815,11,1338,3069,0,43.6,16.68
新北市,板橋區,雙玉里,1579,653,926,16,1595,3525,0,45.25,18.52
新北市,板橋區,廣新里,1219,522,697,17,1236,3031,0,40.78,17.22
新北市,板橋區,深丘里,3215,1604,1611,36,3251,7123,0,45.64,22.52
新北市,板橋區,香丘里,1345,565,780,6,1351,3179,0,42.5,17.77
新北市,板橋區,西安里,1018,440,578,8,1026,2350,0,43.66,18.72
新北市,板橋區,東丘里,1766,687,1079,20,1786,3895,0,45.85,17.64
新北市,板橋區,長安里,1747,673,1074,19,1766,3802,0,46.45,17.7
新北市,板橋區,福丘里,2003,1050,953,19,2022,4141,0,48.83,25.36
新北市,板橋區,福祿里,1465,775,690,12,1477,3382,0,43.67,22.92
新北市,板橋區,民族里,1758,803,955,17,1775,3878,0,45.77,20.71
新北市,板橋區,國泰里,1425,698,727,31,1456,3111,0,46.8,22.44
新北市,板橋區,福德里,2033,903,1130,13,2046,4371,0,46.81,20.66
新北市,板橋區,景星里,1284,620,664,18,1302,3021,0,43.1,20.52
新北市,板橋區,福星里,1511,697,814,8,1519,3064,0,49.58,22.75
新北市,板橋區,鄉雲里,1554,754,800,23,1577,3320,0,47.5,22.71
新北市,板橋區,廣德里,2628,1248,1380,22,2650,5909,0,44.85,21.12
新北市,板橋區,大豐里,1804,908,896,10,1814,4094,0,44.31,22.18
新北市,板橋區,重慶里,3112,1501,1611,33,3145,7469,0,42.11,20.1
新北市,板橋區,仁愛里,1237,699,538,10,1247,2702,0,46.15,25.87
新北市,板橋區,和平里,1403,769,634,12,1415,3281,0,43.13,23.44
新北市,板橋區,廣福里,1335,597,738,17,1352,3505,0,38.57,17.03
新北市,板橋區,華興里,1708,794,914,16,1724,3734,0,46.17,21.26
新北市,板橋區,華貴里,1037,435,602,12,1049,2257,0,46.48,19.27
新北市,板橋區,華德里,2448,1169,1279,25,2473,6150,0,40.21,19.01
新北市,板橋區,華東里,3348,1772,1576,25,3373,6979,0,48.33,25.39
新北市,板橋區,信義里,1598,744,854,15,1613,3812,0,42.31,19.52
新北市,板橋區,浮洲里,1352,507,845,14,1366,3334,0,40.97,15.21
新北市,板橋區,華中里,1923,749,1174,15,1938,4625,0,41.9,16.19
新北市,板橋區,僑中里,1437,557,880,8,1445,3700,0,39.05,15.05
新北市,板橋區,中山里,2506,1240,1266,19,2525,6074,0,41.57,20.41
新北市,板橋區,復興里,430,242,188,9,439,873,0,50.29,27.72
新北市,板橋區,大安里,1472,634,838,12,1484,3466,0,42.82,18.29
新北市,板橋區,福安里,2638,1335,1303,27,2665,6234,0,42.75,21.41
新北市,板橋區,聚安里,1785,725,1060,14,1799,4615,0,38.98,15.71
新北市,板橋區,龍安里,1068,424,644,19,1087,2464,0,44.12,17.21
新北市,板橋區,崑崙里,3333,1488,1845,35,3368,8523,0,39.52,17.46
新北市,板橋區,溪洲里,2014,837,1177,22,2036,5148,0,39.55,16.26
新北市,板橋區,溪北里,1293,565,728,14,1307,3079,0,42.45,18.35
新北市,板橋區,香雅里,1027,465,562,9,1036,2397,0,43.22,19.4
新北市,板橋區,新生里,1656,691,965,14,1670,3742,0,44.63,18.47
新北市,板橋區,文德里,1191,554,637,5,1196,2692,0,44.43,20.58
新北市,板橋區,文化里,1329,519,810,13,1342,2948,0,45.52,17.61
新北市,板橋區,新海里,1289,516,773,9,1298,3027,0,42.88,17.05
新北市,板橋區,莒光里,1132,457,675,13,1145,2449,0,46.75,18.66
新北市,板橋區,富貴里,1003,439,564,8,1011,2040,0,49.56,21.52
新北市,板橋區,正泰里,1223,527,696,14,1237,2595,0,47.67,20.31
新北市,板橋區,民生里,904,356,548,6,910,1940,0,46.91,18.35
新北市,板橋區,後埔里,1526,735,791,23,1549,3280,0,47.23,22.41
新北市,板橋區,華福里,821,383,438,8,829,1789,0,46.34,21.41
新北市,板橋區,堂春里,1465,652,813,20,1485,3718,0,39.94,17.54
新北市,板橋區,成和里,2168,985,1183,23,2191,6055,0,36.18,16.27
新北市,板橋區,光榮里,1028,524,504,9,1037,2287,0,45.34,22.91
新北市,板橋區,民安里,834,406,428,5,839,1772,0,47.35,22.91
新北市,板橋區,陽明里,1125,429,696,9,1134,2400,0,47.25,17.88
新北市,板橋區,朝陽里,1227,437,790,20,1247,2973,0,41.94,14.7
新北市,板橋區,松柏里,953,381,572,16,969,2012,0,48.16,18.94
新北市,板橋區,文聖里,1497,560,937,13,1510,3479,0,43.4,16.1
新北市,板橋區,居仁里,1434,589,845,16,1450,3379,0,42.91,17.43
新北市,板橋區,莊敬里,1663,772,891,15,1678,3540,0,47.4,21.81
新北市,板橋區,東安里,825,330,495,12,837,2026,0,41.31,16.29
新北市,板橋區,五權里,1582,692,890,13,1595,3585,0,44.49,19.3
新北市,板橋區,溪福里,4718,2185,2533,32,4750,12217,0,38.88,17.88
新北市,板橋區,大觀里,1245,458,787,14,1259,3210,0,39.22,14.27
新北市,板橋區,歡園里,498,186,312,2,500,1091,0,45.83,17.05
新北市,板橋區,合計,202768,90594,112174,1931,204699,466918,555551,43.84,19.4
新北市,三重區,大有里,2039,788,1251,16,2055,4726,0,43.48,16.67
新北市,三重區,二重里,565,212,353,9,574,1436,0,39.97,14.76
新北市,三重區,頂崁里,968,332,636,1,969,2322,0,41.73,14.3
新北市,三重區,谷王里,444,166,278,4,448,904,0,49.56,18.36
新北市,三重區,中興里,1651,613,1038,14,1665,3568,0,46.66,17.18
新北市,三重區,德厚里,177,58,119,1,178,351,0,50.71,16.52
新北市,三重區,成功里,2615,1189,1426,16,2631,5671,0,46.39,20.97
新北市,三重區,福祉里,2170,900,1270,15,2185,4889,0,44.69,18.41
新北市,三重區,福民里,1345,553,792,8,1353,3007,0,45.0,18.39
新北市,三重區,過田里,2498,1139,1359,22,2520,8822,0,28.56,12.91
新北市,三重區,錦田里,829,343,486,6,835,1860,0,44.89,18.44
新北市,三重區,重明里,1498,626,872,16,1514,3239,0,46.74,19.33
新北市,三重區,光田里,1890,782,1108,19,1909,3937,0,48.49,19.86
新北市,三重區,光陽里,2726,1163,1563,20,2746,5711,0,48.08,20.36
新北市,三重區,田心里,1542,594,948,11,1553,3667,0,42.35,16.2
新北市,三重區,福田里,1467,592,875,13,1480,3107,0,47.63,19.05
新北市,三重區,田中里,2418,856,1562,33,2451,5458,0,44.91,15.68
新北市,三重區,田安里,2414,974,1440,27,2441,5517,0,44.25,17.65
新北市,三重區,三民里,1184,459,725,13,1197,2877,0,41.61,15.95
新北市,三重區,光明里,2794,1232,1562,20,2814,6525,0,43.13,18.88
新北市,三重區,光正里,1088,529,559,4,1092,2380,0,45.88,22.23
新北市,三重區,同安里,491,215,276,4,495,1288,0,38.43,16.69
新北市,三重區,同慶里,695,311,384,3,698,1582,0,44.12,19.66
新北市,三重區,菜寮里,898,376,522,7,905,1982,0,45.66,18.97
新北市,三重區,永春里,735,330,405,7,742,1664,0,44.59,19.83
新北市,三重區,中正里,596,263,333,5,601,1261,0,47.66,20.86
新北市,三重區,吉利里,535,231,304,6,541,1289,0,41.97,17.92
新北市,三重區,大同里,767,321,446,3,770,1819,0,42.33,17.65
新北市,三重區,中民里,506,227,279,1,507,1130,0,44.87,20.09
新北市,三重區,平和里,608,268,340,12,620,1363,0,45.49,19.66
新北市,三重區,大安里,636,297,339,4,640,1483,0,43.16,20.03
新北市,三重區,仁德里,719,296,423,11,730,1785,0,40.9,16.58
新北市,三重區,忠孝里,711,304,407,8,719,1629,0,44.14,18.66
新北市,三重區,仁義里,511,213,298,5,516,1175,0,43.91,18.13
新北市,三重區,光榮里,538,230,308,4,542,1315,0,41.22,17.49
新北市,三重區,光輝里,611,261,350,5,616,1391,0,44.28,18.76
新北市,三重區,福星里,556,239,317,2,558,1098,0,50.82,21.77
新北市,三重區,福利里,925,423,502,6,931,2035,0,45.75,20.79
新北市,三重區,清和里,1691,744,947,19,1710,3628,0,47.13,20.51
新北市,三重區,永興里,609,266,343,3,612,1275,0,48.0,20.86
新北市,三重區,中山里,1085,454,631,8,1093,2448,0,44.65,18.55
新北市,三重區,大園里,1005,383,622,6,1011,2453,0,41.21,15.61
新北市,三重區,國隆里,1137,540,597,12,1149,2406,0,47.76,22.44
新北市,三重區,重陽里,1319,552,767,12,1331,3178,0,41.88,17.37
新北市,三重區,民生里,1648,590,1058,13,1661,3797,0,43.75,15.54
新北市,三重區,重新里,642,204,438,10,652,1352,0,48.22,15.09
新北市,三重區,正德里,466,195,271,1,467,1030,0,45.34,18.93
新北市,三重區,正義里,774,314,460,8,782,1597,0,48.97,19.66
新北市,三重區,正安里,801,356,445,6,807,1771,0,45.57,20.1
新北市,三重區,自強里,695,254,441,8,703,1652,0,42.55,15.38
新北市,三重區,文化里,955,397,558,5,960,2007,0,47.83,19.78
新北市,三重區,中央里,684,253,431,7,691,1674,0,41.28,15.11
新北市,三重區,雙園里,396,193,203,3,399,855,0,46.67,22.57
新北市,三重區,錦通里,628,268,360,13,641,1344,0,47.69,19.94
新北市,三重區,錦安里,679,284,395,5,684,1672,0,40.91,16.99
新北市,三重區,長安里,818,317,501,9,827,1939,0,42.65,16.35
新北市,三重區,光華里,886,364,522,6,892,2070,0,43.09,17.58
新北市,三重區,長生里,345,130,215,8,353,813,0,43.42,15.99
新北市,三重區,開元里,656,274,382,13,669,1385,0,48.3,19.78
新北市,三重區,大德里,354,150,204,4,358,770,0,46.49,19.48
新北市,三重區,長元里,941,405,536,12,953,2229,0,42.75,18.17
新北市,三重區,長江里,816,330,486,12,828,1876,0,44.14,17.59
新北市,三重區,長泰里,845,338,507,11,856,2003,0,42.74,16.87
新北市,三重區,長福里,589,234,355,8,597,1436,0,41.57,16.3
新北市,三重區,介壽里,464,208,256,9,473,1039,0,45.52,20.02
新北市,三重區,萬壽里,817,345,472,12,829,1775,0,46.7,19.44
新北市,三重區,錦江里,805,291,514,8,813,2123,0,38.29,13.71
新北市,三重區,龍濱里,1265,510,755,17,1282,2926,0,43.81,17.43
新北市,三重區,龍門里,683,293,390,4,687,1678,0,40.94,17.46
新北市,三重區,秀江里,468,179,289,6,474,1136,0,41.73,15.76
新北市,三重區,奕壽里,721,278,443,8,729,1549,0,47.06,17.95
新北市,三重區,三安里,1004,400,604,7,1011,2410,0,41.95,16.6
新北市,三重區,福安里,1180,454,726,15,1195,2698,0,44.29,16.83
新北市,三重區,信安里,720,314,406,6,726,1802,0,40.29,17.43
新北市,三重區,安慶里,813,293,520,5,818,1889,0,43.3,15.51
新北市,三重區,幸福里,1782,692,1090,13,1795,4172,0,43.02,16.59
新北市,三重區,六合里,1452,565,887,19,1471,3336,0,44.09,16.94
新北市,三重區,六福里,2036,750,1286,18,2054,4936,0,41.61,15.19
新北市,三重區,順德里,882,342,540,20,902,2027,0,44.5,16.87
新北市,三重區,承德里,716,270,446,6,722,1631,0,44.27,16.55
新北市,三重區,瑞德里,932,378,554,15,947,2145,0,44.15,17.62
新北市,三重區,崇德里,1543,572,971,11,1554,3509,0,44.29,16.3
新北市,三重區,厚德里,1468,597,871,8,1476,3088,0,47.8,19.33
新北市,三重區,維德里,1167,441,726,18,1185,2545,0,46.56,17.33
新北市,三重區,尚德里,1126,461,665,9,1135,2674,0,42.45,17.24
新北市,三重區,培德里,1499,559,940,8,1507,3267,0,46.13,17.11
新北市,三重區,永德里,1805,674,1131,21,1826,4360,0,41.88,15.46
新北市,三重區,永盛里,1236,452,784,15,1251,2861,0,43.73,15.8
新北市,三重區,永福里,2046,763,1283,19,2065,4596,0,44.93,16.6
新北市,三重區,永清里,1899,639,1260,10,1909,4710,0,40.53,13.57
新北市,三重區,永安里,1516,575,941,11,1527,3553,0,42.98,16.18
新北市,三重區,永煇里,971,334,637,13,984,2263,0,43.48,14.76
新北市,三重區,溪美里,3390,1320,2070,32,3422,7625,0,44.88,17.31
新北市,三重區,福隆里,1623,612,1011,11,1634,3940,0,41.47,15.53
新北市,三重區,五常里,1604,615,989,21,1625,3874,0,41.95,15.88
新北市,三重區,五福里,1350,533,817,11,1361,3407,0,39.95,15.64
新北市,三重區,仁忠里,1017,403,614,11,1028,2802,0,36.69,14.38
新北市,三重區,慈福里,859,286,573,10,869,1998,0,43.49,14.31
新北市,三重區,慈生里,934,369,565,9,943,2046,0,46.09,18.04
新北市,三重區,慈惠里,911,299,612,5,916,2029,0,45.15,14.74
新北市,三重區,慈愛里,1387,497,890,15,1402,3070,0,45.67,16.19
新北市,三重區,慈化里,929,351,578,8,937,2229,0,42.04,15.75
新北市,三重區,慈祐里,1835,701,1134,11,1846,4356,0,42.38,16.09
新北市,三重區,五華里,1926,738,1188,17,1943,4540,0,42.8,16.26
新北市,三重區,富貴里,2469,1094,1375,16,2485,5713,0,43.5,19.15
新北市,三重區,富華里,1143,460,683,15,1158,2882,0,40.18,15.96
新北市,三重區,富福里,683,251,432,3,686,1839,0,37.3,13.65
新北市,三重區,碧華里,3112,1418,1694,28,3140,7294,0,43.05,19.44
新北市,三重區,五谷里,818,322,496,10,828,1740,0,47.59,18.51
新北市,三重區,博愛里,1795,742,1053,12,1807,4013,0,45.03,18.49
新北市,三重區,福德里,1567,680,887,11,1578,3686,0,42.81,18.45
新北市,三重區,永吉里,1031,408,623,12,1043,2539,0,41.08,16.07
新北市,三重區,永發里,2248,777,1471,17,2265,5046,0,44.89,15.4
新北市,三重區,永順里,1665,570,1095,12,1677,4437,0,37.8,12.85
新北市,三重區,永豐里,2064,739,1325,21,2085,5061,0,41.2,14.6
新北市,三重區,立德里,1339,523,816,20,1359,2994,0,45.39,17.47
新北市,三重區,福樂里,1354,502,852,12,1366,3293,0,41.48,15.24
新北市,三重區,仁華里,1683,677,1006,18,1701,3764,0,45.19,17.99
新北市,三重區,五順里,1346,517,829,10,1356,3524,0,38.48,14.67
新北市,三重區,合計,141922,56727,85195,1312,143234,330362,383135,43.36,17.17
新北市,中和區,中原里,2693,1348,1345,20,2713,6550,0,41.42,20.58
新北市,中和區,平河里,3632,1906,1726,34,3666,7974,0,45.97,23.9
新北市,中和區,信和里,1705,803,902,18,1723,3796,0,45.39,21.15
新北市,中和區,仁和里,1406,723,683,12,1418,3469,0,40.88,20.84
新北市,中和區,中正里,1350,657,693,17,1367,3452,0,39.6,19.03
新北市,中和區,建和里,1551,943,608,17,1568,3096,0,50.65,30.46
新北市,中和區,連和里,1026,663,363,8,1034,2171,0,47.63,30.54
新北市,中和區,連城里,2718,1597,1121,20,2738,5682,0,48.19,28.11
新北市,中和區,力行里,2522,1314,1208,23,2545,5265,0,48.34,24.96
新北市,中和區,枋寮里,1508,768,740,15,1523,3312,0,45.98,23.19
新北市,中和區,漳和里,1569,834,735,13,1582,3410,0,46.39,24.46
新北市,中和區,廟美里,1802,924,878,14,1816,3887,0,46.72,23.77
新北市,中和區,福真里,1685,845,840,16,1701,3709,0,45.86,22.78
新北市,中和區,福善里,1787,928,859,17,1804,3832,0,47.08,24.22
新北市,中和區,福美里,1868,986,882,19,1887,3903,0,48.35,25.26
新北市,中和區,福祥里,2127,1052,1075,21,2148,4460,0,48.16,23.59
新北市,中和區,瓦磘里,2077,1052,1025,15,2092,4916,0,42.55,21.4
新北市,中和區,福和里,1490,765,725,14,1504,3253,0,46.23,23.52
新北市,中和區,佳和里,2089,1097,992,31,2120,4420,0,47.96,24.82
新北市,中和區,安樂里,1683,1033,650,15,1698,3265,0,52.01,31.64
新北市,中和區,安和里,1410,793,617,7,1417,2767,0,51.21,28.66
新北市,中和區,安平里,2692,1688,1004,36,2728,5289,0,51.58,31.92
新北市,中和區,中安里,2083,1316,767,15,2098,3903,0,53.75,33.72
新北市,中和區,泰安里,1465,797,668,19,1484,3171,0,46.8,25.13
新北市,中和區,新南里,3302,1788,1514,30,3332,7115,0,46.83,25.13
新北市,中和區,南山里,2156,1226,930,14,2170,4499,0,48.23,27.25
新北市,中和區,秀山里,1863,1089,774,10,1873,4018,0,46.62,27.1
新北市,中和區,秀成里,1435,814,621,16,1451,3062,0,47.39,26.58
新北市,中和區,秀福里,2061,1175,886,20,2081,4298,0,48.42,27.34
新北市,中和區,秀景里,2766,1733,1033,32,2798,5620,0,49.79,30.84
新北市,中和區,秀明里,2124,1405,719,19,2143,4436,0,48.31,31.67
新北市,中和區,秀峰里,2033,1235,798,19,2052,4318,0,47.52,28.6
新北市,中和區,秀仁里,1301,788,513,15,1316,2931,0,44.9,26.89
新北市,中和區,頂南里,1251,798,453,12,1263,2614,0,48.32,30.53
新北市,中和區,華新里,2730,1697,1033,29,2759,6686,0,41.27,25.38
新北市,中和區,東南里,1790,1329,461,22,1812,3818,0,47.46,34.81
新北市,中和區,華南里,2003,1285,718,20,2023,4482,0,45.14,28.67
新北市,中和區,忠孝里,1709,1097,612,21,1730,4171,0,41.48,26.3
新北市,中和區,崇南里,1904,1212,692,31,1935,3856,0,50.18,31.43
新北市,中和區,景南里,1240,766,474,18,1258,2778,0,45.28,27.57
新北市,中和區,橫路里,142,61,81,0,142,310,0,45.81,19.68
新北市,中和區,內南里,1888,1133,755,28,1916,4421,0,43.34,25.63
新北市,中和區,壽南里,964,550,414,11,975,2183,0,44.66,25.19
新北市,中和區,外南里,1622,879,743,10,1632,6944,0,23.5,12.66
新北市,中和區,復興里,2083,1166,917,9,2092,4423,0,47.3,26.36
新北市,中和區,和興里,1893,1087,806,30,1923,3949,0,48.7,27.53
新北市,中和區,景平里,2382,1438,944,28,2410,4885,0,49.33,29.44
新北市,中和區,景新里,1540,886,654,19,1559,3210,0,48.57,27.6
新北市,中和區,景福里,2374,1427,947,29,2403,5145,0,46.71,27.74
新北市,中和區,景安里,2192,1307,885,28,2220,4350,0,51.03,30.05
新北市,中和區,景文里,1615,952,663,18,1633,3381,0,48.3,28.16
新北市,中和區,錦和里,2112,1124,988,22,2134,4740,0,45.02,23.71
新北市,中和區,錦昌里,948,573,375,10,958,1986,0,48.24,28.85
新北市,中和區,灰磘里,277,117,160,4,281,699,0,40.2,16.74
新北市,中和區,積穗里,3452,1753,1699,26,3478,7243,0,48.02,24.2
新北市,中和區,民享里,1081,447,634,8,1089,2221,0,49.03,20.13
新北市,中和區,員山里,2431,1172,1259,23,2454,5500,0,44.62,21.31
新北市,中和區,嘉穗里,1111,534,577,10,1121,2534,0,44.24,21.07
新北市,中和區,文元里,2037,923,1114,22,2059,4552,0,45.23,20.28
新北市,中和區,嘉新里,1467,694,773,19,1486,3544,0,41.93,19.58
新北市,中和區,民安里,1972,913,1059,17,1989,4463,0,44.57,20.46
新北市,中和區,安穗里,1710,758,952,12,1722,4026,0,42.77,18.83
新北市,中和區,瑞穗里,979,522,457,10,989,2090,0,47.32,24.98
新北市,中和區,明穗里,1832,840,992,11,1843,3932,0,46.87,21.36
新北市,中和區,清穗里,1303,611,692,11,1314,2811,0,46.74,21.74
新北市,中和區,自強里,1855,823,1032,17,1872,4374,0,42.8,18.82
新北市,中和區,德穗里,1818,928,890,24,1842,4038,0,45.62,22.98
新北市,中和區,民生里,1745,848,897,29,1774,3746,0,47.36,22.64
新北市,中和區,國光里,1590,808,782,18,1608,3413,0,47.11,23.67
新北市,中和區,壽德里,1950,1274,676,24,1974,3950,0,49.97,32.25
新北市,中和區,明德里,1430,640,790,19,1449,3434,0,42.2,18.64
新北市,中和區,秀水里,1466,920,546,16,1482,3329,0,44.52,27.64
新北市,中和區,德行里,2813,1578,1235,27,2840,5696,0,49.86,27.7
新北市,中和區,宜安里,863,526,337,13,876,1721,0,50.9,30.56
新北市,中和區,安順里,1976,1195,781,31,2007,3886,0,51.65,30.75
新北市,中和區,秀義里,1190,639,551,15,1205,2405,0,50.1,26.57
新北市,中和區,秀士里,1008,633,375,12,1020,2226,0,45.82,28.44
新北市,中和區,興南里,1250,761,489,20,1270,2756,0,46.08,27.61
新北市,中和區,景本里,932,543,389,15,947,1883,0,50.29,28.84
新北市,中和區,福南里,1671,1084,587,20,1691,3773,0,44.82,28.73
新北市,中和區,中興里,2646,1512,1134,24,2670,5825,0,45.84,25.96
新北市,中和區,吉興里,1192,723,469,6,1198,2623,0,45.67,27.56
新北市,中和區,中山里,998,480,518,10,1008,2395,0,42.09,20.04
新北市,中和區,碧河里,2038,1055,983,23,2061,4326,0,47.64,24.39
新北市,中和區,錦中里,1552,790,762,18,1570,3643,0,43.1,21.69
新北市,中和區,錦盛里,1484,679,805,19,1503,3432,0,43.79,19.78
新北市,中和區,民有里,1176,574,602,8,1184,2486,0,47.63,23.09
新北市,中和區,員富里,1357,618,739,14,1371,3236,0,42.37,19.1
新北市,中和區,嘉慶里,1507,708,799,10,1517,3862,0,39.28,18.33
新北市,中和區,冠穗里,1454,651,803,15,1469,2946,0,49.86,22.1
新北市,中和區,國華里,1312,602,710,17,1329,2987,0,44.49,20.15
新北市,中和區,正南里,1287,824,463,11,1298,3087,0,42.05,26.69
新北市,中和區,正行里,1174,633,541,3,1177,2564,0,45.9,24.69
新北市,中和區,合計,161747,89185,72562,1657,163404,355238,408654,46.0,25.11
新北市,永和區,福林里,1369,793,576,10,1379,2917,0,47.27,27.19
新北市,永和區,文化里,1189,722,467,11,1200,2476,0,48.47,29.16
新北市,永和區,豫溪里,1555,948,607,22,1577,4502,0,35.03,21.06
新北市,永和區,光明里,1335,813,522,15,1350,2581,0,52.31,31.5
新北市,永和區,仁愛里,1229,720,509,13,1242,2419,0,51.34,29.76
新北市,永和區,永貞里,1465,829,636,22,1487,2938,0,50.61,28.22
新北市,永和區,永福里,1243,728,515,7,1250,2396,0,52.17,30.38
新北市,永和區,民治里,1063,645,418,10,1073,2525,0,42.5,25.54
新北市,永和區,永成里,411,321,90,5,416,876,0,47.49,36.64
新北市,永和區,忠義里,347,278,69,5,352,704,0,50.0,39.49
新北市,永和區,永元里,1979,1146,833,19,1998,4085,0,48.91,28.05
新北市,永和區,秀林里,1720,881,839,12,1732,3437,0,50.39,25.63
新北市,永和區,保安里,3045,1717,1328,33,3078,6137,0,50.15,27.98
新北市,永和區,中溪里,2117,1163,954,22,2139,4473,0,47.82,26.0
新北市,永和區,永安里,1873,1142,731,14,1887,3634,0,51.93,31.43
新北市,永和區,民族里,1935,1159,776,18,1953,3986,0,49.0,29.08
新北市,永和區,民權里,1836,1081,755,13,1849,3852,0,48.0,28.06
新北市,永和區,中興里,1307,762,545,17,1324,2760,0,47.97,27.61
新北市,永和區,勵行里,491,226,265,4,495,1091,0,45.37,20.71
新北市,永和區,秀朗里,1518,834,684,16,1534,3358,0,45.68,24.84
新北市,永和區,秀成里,1195,667,528,10,1205,2545,0,47.35,26.21
新北市,永和區,上溪里,783,430,353,6,789,1702,0,46.36,25.26
新北市,永和區,竹林里,1499,937,562,14,1513,3222,0,46.96,29.08
新北市,永和區,雙和里,1761,1027,734,18,1779,3413,0,52.12,30.09
新北市,永和區,安和里,1663,991,672,19,1682,3354,0,50.15,29.55
新北市,永和區,水源里,1787,1045,742,17,1804,3469,0,52.0,30.12
新北市,永和區,協和里,1272,726,546,10,1282,2623,0,48.88,27.68
新北市,永和區,河堤里,1381,842,539,12,1393,2995,0,46.51,28.11
新北市,永和區,頂溪里,1115,648,467,20,1135,2205,0,51.47,29.39
新北市,永和區,潭墘里,1975,1264,711,20,1995,3956,0,50.43,31.95
新北市,永和區,潭安里,2000,1266,734,29,2029,4105,0,49.43,30.84
新北市,永和區,大新里,1151,684,467,14,1165,2298,0,50.7,29.77
新北市,永和區,保平里,2025,1106,919,23,2048,4115,0,49.77,26.88
新北市,永和區,民本里,1508,861,647,11,1519,3433,0,44.25,25.08
新北市,永和區,民樂里,2051,1285,766,21,2072,4047,0,51.2,31.75
新北市,永和區,光復里,713,426,287,5,718,1527,0,47.02,27.9
新北市,永和區,復興里,1040,647,393,8,1048,2119,0,49.46,30.53
新北市,永和區,福和里,2203,1343,860,17,2220,4495,0,49.39,29.88
新北市,永和區,得和里,1934,1233,701,21,1955,3718,0,52.58,33.16
新北市,永和區,智光里,1219,724,495,16,1235,2845,0,43.41,25.45
新北市,永和區,新生里,382,269,113,6,388,809,0,47.96,33.25
新北市,永和區,大同里,443,318,125,3,446,907,0,49.17,35.06
新北市,永和區,前溪里,911,572,339,8,919,1894,0,48.52,30.2
新北市,永和區,和平里,1939,1114,825,21,1960,4232,0,46.31,26.32
新北市,永和區,新廍里,1011,602,409,12,1023,1996,0,51.25,30.16
新北市,永和區,下溪里,1907,1077,830,23,1930,3972,0,48.59,27.11
新北市,永和區,秀和里,2094,1216,878,24,2118,4293,0,49.34,28.33
新北市,永和區,河濱里,1326,777,549,8,1334,2797,0,47.69,27.78
新北市,永和區,民生里,1614,926,688,6,1620,3428,0,47.26,27.01
新北市,永和區,秀得里,1073,637,436,12,1085,2304,0,47.09,27.65
新北市,永和區,上林里,1522,988,534,12,1534,3036,0,50.53,32.54
新北市,永和區,網溪里,465,302,163,4,469,1031,0,45.49,29.29
新北市,永和區,正興里,925,558,367,17,942,1963,0,47.99,28.43
新北市,永和區,永興里,1286,774,512,14,1300,2764,0,47.03,28.0
新北市,永和區,桂林里,1492,956,536,16,1508,3259,0,46.27,29.33
新北市,永和區,店街里,1642,971,671,10,1652,3607,0,45.8,26.92
新北市,永和區,信義里,1156,676,480,10,1166,2350,0,49.62,28.77
新北市,永和區,後溪里,899,469,430,9,908,1783,0,50.93,26.3
新北市,永和區,民富里,1153,677,476,14,1167,2527,0,46.18,26.79
新北市,永和區,秀元里,1268,734,534,11,1279,2627,0,48.69,27.94
新北市,永和區,永樂里,978,517,461,11,989,2095,0,47.21,24.68
新北市,永和區,保順里,4135,2407,1728,36,4171,9013,0,46.28,26.71
新北市,永和區,合計,88923,52597,36326,886,89809,186020,217795,48.28,28.27
新北市,新莊區,海山里,2119,886,1233,17,2136,4736,0,45.1,18.71
新北市,新莊區,頭前里,3570,1518,2052,43,3613,8383,0,43.1,18.11
新北市,新莊區,國泰里,561,231,330,2,563,1293,0,43.54,17.87
新北市,新莊區,全安里,1861,755,1106,11,1872,3916,0,47.8,19.28
新北市,新莊區,福基里,2018,913,1105,12,2030,4570,0,44.42,19.98
新北市,新莊區,豐年里,1356,547,809,14,1370,3237,0,42.32,16.9
新北市,新莊區,忠孝里,2050,881,1169,21,2071,4625,0,44.78,19.05
新北市,新莊區,恆安里,1739,757,982,12,1751,3906,0,44.83,19.38
新北市,新莊區,後港里,2780,1128,1652,24,2804,6314,0,44.41,17.87
新北市,新莊區,文衡里,907,371,536,4,911,1879,0,48.48,19.74
新北市,新莊區,中美里,2335,983,1352,15,2350,5211,0,45.1,18.86
新北市,新莊區,八德里,1020,410,610,10,1030,2744,0,37.54,14.94
新北市,新莊區,興漢里,1404,706,698,16,1420,2917,0,48.68,24.2
新北市,新莊區,中和里,1818,770,1048,17,1835,4028,0,45.56,19.12
新北市,新莊區,西盛里,4302,1818,2484,37,4339,10595,0,40.95,17.16
新北市,新莊區,榮和里,1296,570,726,10,1306,5142,0,25.4,11.09
新北市,新莊區,中泰里,1565,546,1019,19,1584,3896,0,40.66,14.01
新北市,新莊區,瓊林里,2026,748,1278,21,2047,5058,0,40.47,14.79
新北市,新莊區,文德里,731,353,378,9,740,1553,0,47.65,22.73
新北市,新莊區,中誠里,761,263,498,4,765,1903,0,40.2,13.82
新北市,新莊區,裕民里,2398,915,1483,25,2423,6057,0,40.0,15.11
新北市,新莊區,文明里,663,263,400,10,673,1547,0,43.5,17.0
新北市,新莊區,中港里,2323,943,1380,26,2349,5390,0,43.58,17.5
新北市,新莊區,富國里,854,349,505,11,865,2056,0,42.07,16.97
新北市,新莊區,思源里,1986,772,1214,20,2006,4652,0,43.12,16.6
新北市,新莊區,立人里,837,502,335,12,849,1674,0,50.72,29.99
新北市,新莊區,南港里,1765,729,1036,26,1791,4664,0,38.4,15.63
新北市,新莊區,仁愛里,942,353,589,4,946,2389,0,39.6,14.78
新北市,新莊區,立德里,1047,484,563,4,1051,2305,0,45.6,21.0
新北市,新莊區,信義里,1874,781,1093,23,1897,4652,0,40.78,16.79
新北市,新莊區,立言里,1878,846,1032,16,1894,4324,0,43.8,19.57
新北市,新莊區,民安里,1966,869,1097,21,1987,5143,0,38.64,16.9
新北市,新莊區,和平里,1717,616,1101,22,1739,4178,0,41.62,14.74
新北市,新莊區,立功里,1250,482,768,9,1259,3266,0,38.55,14.76
新北市,新莊區,民本里,1007,357,650,7,1014,2666,0,38.03,13.39
新北市,新莊區,化成里,1489,565,924,9,1498,3422,0,43.78,16.51
新北市,新莊區,立志里,1475,553,922,18,1493,3451,0,43.26,16.02
新北市,新莊區,光華里,2231,933,1298,22,2253,6136,0,36.72,15.21
新北市,新莊區,思賢里,1629,659,970,10,1639,3692,0,44.39,17.85
新北市,新莊區,營盤里,770,336,434,5,775,1701,0,45.56,19.75
新北市,新莊區,光榮里,1344,597,747,12,1356,3835,0,35.36,15.57
新北市,新莊區,自強里,841,325,516,9,850,2341,0,36.31,13.88
新北市,新莊區,丹鳳里,2911,1317,1594,27,2938,7720,0,38.06,17.06
新北市,新莊區,光明里,1425,569,856,14,1439,4165,0,34.55,13.66
新北市,新莊區,自立里,1897,703,1194,29,1926,4667,0,41.27,15.06
新北市,新莊區,合鳳里,1497,606,891,16,1513,4014,0,37.69,15.1
新北市,新莊區,幸福里,1495,509,986,10,1505,3807,0,39.53,13.37
新北市,新莊區,雙鳳里,3801,1769,2032,29,3830,9790,0,39.12,18.07
新北市,新莊區,自信里,865,311,554,8,873,2188,0,39.9,14.21
新北市,新莊區,龍鳳里,3416,1523,1893,22,3438,8555,0,40.19,17.8
新北市,新莊區,中華里,1128,468,660,7,1135,2558,0,44.37,18.3
新北市,新莊區,中隆里,1708,709,999,17,1725,4343,0,39.72,16.33
新北市,新莊區,中原里,4524,1975,2549,46,4570,11108,0,41.14,17.78
新北市,新莊區,中信里,3012,1216,1796,26,3038,7280,0,41.73,16.7
新北市,新莊區,四維里,1458,573,885,24,1482,4090,0,36.23,14.01
新北市,新莊區,建福里,951,393,558,8,959,2178,0,44.03,18.04
新北市,新莊區,中宏里,1343,555,788,15,1358,3219,0,42.19,17.24
新北市,新莊區,中全里,1195,377,818,9,1204,3118,0,38.61,12.09
新北市,新莊區,立泰里,1851,814,1037,24,1875,4308,0,43.52,18.9
新北市,新莊區,全泰里,2091,997,1094,20,2111,4287,0,49.24,23.26
新北市,新莊區,仁義里,1274,454,820,7,1281,3271,0,39.16,13.88
新北市,新莊區,立基里,2466,1097,1369,18,2484,5316,0,46.73,20.64
新北市,新莊區,昌明里,1374,569,805,9,1383,3181,0,43.48,17.89
新北市,新莊區,昌平里,2959,1421,1538,24,2983,7008,0,42.57,20.28
新北市,新莊區,文聖里,1436,681,755,12,1448,2960,0,48.92,23.01
新北市,新莊區,萬安里,1275,507,768,8,1283,3234,0,39.67,15.68
新北市,新莊區,龍安里,768,319,449,14,782,2075,0,37.69,15.37
新北市,新莊區,福營里,1002,399,603,2,1004,2274,0,44.15,17.55
新北市,新莊區,後德里,1275,547,728,12,1287,2720,0,47.32,20.11
新北市,新莊區,建安里,2312,935,1377,16,2328,5875,0,39.63,15.91
新北市,新莊區,成德里,1616,670,946,8,1624,4416,0,36.78,15.17
新北市,新莊區,福興里,2278,935,1343,20,2298,5247,0,43.8,17.82
新北市,新莊區,昌信里,1352,562,790,6,1358,3272,0,41.5,17.18
新北市,新莊區,昌隆里,1656,730,926,20,1676,3858,0,43.44,18.92
新北市,新莊區,中平里,3260,1538,1722,20,3280,7749,0,42.33,19.85
新北市,新莊區,立廷里,4165,1932,2233,33,4198,9967,0,42.12,19.38
新北市,新莊區,泰豐里,956,411,545,16,972,2206,0,44.06,18.63
新北市,新莊區,富民里,1454,632,822,7,1461,3404,0,42.92,18.57
新北市,新莊區,龍福里,793,379,414,8,801,1990,0,40.25,19.05
新北市,新莊區,祥鳳里,851,379,472,11,862,2133,0,40.41,17.77
新北市,新莊區,民全里,1332,569,763,8,1340,3307,0,40.52,17.21
新北市,新莊區,民有里,1532,687,845,20,1552,3548,0,43.74,19.36
新北市,新莊區,光正里,1455,606,849,19,1474,3815,0,38.64,15.88
新北市,新莊區,光和里,903,319,584,4,907,2430,0,37.33,13.13
新北市,新莊區,合計,144817,61045,83772,1312,146129,352098,422668,41.5,17.34
新北市,新店區,國豐里,1412,916,496,15,1427,2846,0,50.14,32.19
新北市,新店區,明德里,1684,1054,630,15,1699,3541,0,47.98,29.77
新北市,新店區,大豐里,1597,947,650,9,1606,3306,0,48.58,28.64
新北市,新店區,大同里,1831,1096,735,21,1852,3497,0,52.96,31.34
新北市,新店區,江陵里,2477,1571,906,30,2507,4908,0,51.08,32.01
新北市,新店區,寶興里,2525,1550,975,31,2556,4879,0,52.39,31.77
新北市,新店區,寶安里,2457,1548,909,26,2483,4940,0,50.26,31.34
新北市,新店區,信義里,2989,1731,1258,27,3016,6086,0,49.56,28.44
新北市,新店區,忠孝里,1075,715,360,9,1084,2525,0,42.93,28.32
新北市,新店區,大鵬里,1405,1130,275,20,1425,2477,0,57.53,45.62
新北市,新店區,太平里,1279,801,478,9,1288,2805,0,45.92,28.56
新北市,新店區,頂城里,576,330,246,7,583,1541,0,37.83,21.41
新北市,新店區,下城里,1276,640,636,12,1288,2878,0,44.75,22.24
新北市,新店區,柴埕里,3368,1986,1382,27,3395,8098,0,41.92,24.52
新北市,新店區,永安里,1992,1086,906,12,2004,4606,0,43.51,23.58
新北市,新店區,公崙里,4956,2956,2000,41,4997,11616,0,43.02,25.45
新北市,新店區,德安里,2210,1196,1014,28,2238,5492,0,40.75,21.78
新北市,新店區,雙城里,2121,1160,961,15,2136,5146,0,41.51,22.54
新北市,新店區,日興里,1984,1005,979,17,2001,5288,0,37.84,19.01
新北市,新店區,玫瑰里,2368,1497,871,16,2384,5383,0,44.29,27.81
新北市,新店區,塗潭里,378,91,287,4,382,928,0,41.16,9.81
新北市,新店區,美潭里,2081,1250,831,18,2099,4705,0,44.61,26.57
新北市,新店區,員潭里,1962,1159,803,24,1986,4714,0,42.13,24.59
新北市,新店區,雙坑里,250,96,154,5,255,726,0,35.12,13.22
新北市,新店區,粗坑里,1386,661,725,11,1397,2813,0,49.66,23.5
新北市,新店區,屈尺里,946,446,500,5,951,2253,0,42.21,19.8
新北市,新店區,龜山里,636,279,357,4,640,1598,0,40.05,17.46
新北市,新店區,廣興里,495,185,310,7,502,1264,0,39.72,14.64
新北市,新店區,直潭里,510,193,317,6,516,1196,0,43.14,16.14
新北市,新店區,青潭里,2060,1168,892,19,2079,4825,0,43.09,24.21
新北市,新店區,新店里,757,369,388,4,761,1629,0,46.72,22.65
新北市,新店區,張南里,1076,650,426,7,1083,2137,0,50.68,30.42
新北市,新店區,國校里,1027,564,463,10,1037,2320,0,44.7,24.31
新北市,新店區,文中里,731,475,256,10,741,1575,0,47.05,30.16
新北市,新店區,廣明里,409,178,231,8,417,782,0,53.32,22.76
新北市,新店區,文明里,1130,595,535,7,1137,2230,0,50.99,26.68
新北市,新店區,中興里,2404,1549,855,21,2425,6858,0,35.36,22.59
新北市,新店區,新生里,2615,1629,986,34,2649,5204,0,50.9,31.3
新北市,新店區,新德里,1082,615,467,12,1094,2418,0,45.24,25.43
新北市,新店區,張北里,3673,2351,1322,40,3713,8055,0,46.1,29.19
新北市,新店區,五峯里,3338,2057,1281,24,3362,6910,0,48.65,29.77
新北市,新店區,新安里,1742,1141,601,20,1762,3647,0,48.31,31.29
新北市,新店區,忠誠里,1150,705,445,9,1159,2185,0,53.04,32.27
新北市,新店區,中正里,2617,1672,945,28,2645,5458,0,48.46,30.63
新北市,新店區,中華里,1877,1282,595,15,1892,3832,0,49.37,33.46
新北市,新店區,仁愛里,927,598,329,10,937,1791,0,52.32,33.39
新北市,新店區,百忍里,1642,1069,573,21,1663,3376,0,49.26,31.66
新北市,新店區,百和里,1409,876,533,11,1420,2847,0,49.88,30.77
新北市,新店區,福德里,1567,973,594,21,1588,3469,0,45.78,28.05
新北市,新店區,百福里,1681,1042,639,12,1693,3294,0,51.4,31.63
新北市,新店區,福民里,1833,1319,514,15,1848,3726,0,49.6,35.4
新北市,新店區,中山里,2324,1565,759,22,2346,4191,0,55.98,37.34
新北市,新店區,和平里,552,355,197,11,563,1240,0,45.4,28.63
新北市,新店區,中央里,2872,1898,974,15,2887,5278,0,54.7,35.96
新北市,新店區,明城里,1469,972,497,5,1474,3130,0,47.09,31.05
新北市,新店區,安和里,3082,1756,1326,42,3124,7029,0,44.44,24.98
新北市,新店區,吉祥里,2032,1375,657,20,2052,4302,0,47.7,31.96
新北市,新店區,寶福里,3214,1978,1236,34,3248,6458,0,50.29,30.63
新北市,新店區,小城里,1656,1080,576,17,1673,3305,0,50.62,32.68
新北市,新店區,香坡里,4470,2979,1491,36,4506,10096,0,44.63,29.51
新北市,新店區,建國里,1385,930,455,15,1400,2786,0,50.25,33.38
新北市,新店區,復興里,1191,704,487,10,1201,2930,0,40.99,24.03
新北市,新店區,美城里,1132,678,454,16,1148,2466,0,46.55,27.49
新北市,新店區,安昌里,2245,1360,885,35,2280,4853,0,46.98,28.02
新北市,新店區,長春里,1220,757,463,15,1235,2304,0,53.6,32.86
新北市,新店區,新和里,1655,1075,580,17,1672,3718,0,44.97,28.91
新北市,新店區,永平里,2184,1265,919,27,2211,4949,0,44.68,25.56
新北市,新店區,達觀里,1670,1174,496,9,1679,3614,0,46.46,32.48
新北市,新店區,華城里,1301,773,528,18,1319,2551,0,51.71,30.3
新北市,新店區,合計,122627,74826,47801,1193,123820,265823,301768,46.58,28.15
新北市,樹林區,三多里,1392,538,854,8,1400,3594,0,38.95,14.97
新北市,樹林區,三福里,1335,605,730,18,1353,3437,0,39.37,17.6
新北市,樹林區,三興里,1568,665,903,12,1580,4203,0,37.59,15.82
新北市,樹林區,圳安里,1331,481,850,13,1344,3354,0,40.07,14.34
新北市,樹林區,保安里,2346,1021,1325,28,2374,5473,0,43.38,18.66
新北市,樹林區,潭底里,1554,627,927,10,1564,4463,0,35.04,14.05
新北市,樹林區,獇寮里,1549,547,1002,12,1561,4406,0,35.43,12.41
新北市,樹林區,樹德里,1488,693,795,13,1501,3190,0,47.05,21.72
新北市,樹林區,樹西里,2097,924,1173,17,2114,4496,0,47.02,20.55
新北市,樹林區,樹南里,1623,709,914,13,1636,3699,0,44.23,19.17
新北市,樹林區,樹人里,1221,629,592,8,1229,2937,0,41.85,21.42
新北市,樹林區,坡內里,585,222,363,6,591,1506,0,39.24,14.74
新北市,樹林區,樹東里,445,219,226,1,446,1073,0,41.57,20.41
新北市,樹林區,大同里,1314,636,678,9,1323,3130,0,42.27,20.32
新北市,樹林區,和平里,1338,557,781,16,1354,3345,0,40.48,16.65
新北市,樹林區,彭厝里,1555,589,966,12,1567,4373,0,35.83,13.47
新北市,樹林區,彭福里,1813,766,1047,20,1833,4657,0,39.36,16.45
新北市,樹林區,東山里,1096,449,647,16,1112,2876,0,38.66,15.61
新北市,樹林區,東陽里,1984,864,1120,16,2000,5229,0,38.25,16.52
新北市,樹林區,東昇里,1759,751,1008,33,1792,4435,0,40.41,16.93
新北市,樹林區,樂山里,627,262,365,7,634,1769,0,35.84,14.81
新北市,樹林區,東園里,603,179,424,2,605,1494,0,40.5,11.98
新北市,樹林區,西園里,636,202,434,11,647,1602,0,40.39,12.61
新北市,樹林區,南園里,5258,2808,2450,36,5294,12321,0,42.97,22.79
新北市,樹林區,北園里,788,250,538,8,796,1967,0,40.47,12.71
新北市,樹林區,柑園里,3484,1804,1680,36,3520,8030,0,43.84,22.47
新北市,樹林區,樹北里,427,187,240,3,430,853,0,50.41,21.92
新北市,樹林區,圳福里,1533,675,858,10,1543,3833,0,40.26,17.61
新北市,樹林區,樹興里,1331,616,715,9,1340,3184,0,42.09,19.35
新北市,樹林區,樹福里,1502,756,746,20,1522,3145,0,48.39,24.04
新北市,樹林區,光興里,1357,539,818,12,1369,3600,0,38.03,14.97
新北市,樹林區,金寮里,1460,568,892,26,1486,3906,0,38.04,14.54
新北市,樹林區,彭興里,1825,714,1111,10,1835,5086,0,36.08,14.04
新北市,樹林區,文林里,1840,833,1007,21,1861,4401,0,42.29,18.93
新北市,樹林區,山佳里,1875,773,1102,16,1891,5096,0,37.11,15.17
新北市,樹林區,中山里,1833,745,1088,24,1857,4640,0,40.02,16.06
新北市,樹林區,育英里,1245,559,686,13,1258,2790,0,45.09,20.04
新北市,樹林區,中華里,1107,528,579,9,1116,3019,0,36.97,17.49
新北市,樹林區,太順里,861,357,504,3,864,2412,0,35.82,14.8
新北市,樹林區,圳民里,1030,475,555,14,1044,2578,0,40.5,18.43
新北市,樹林區,圳生里,610,189,421,4,614,1430,0,42.94,13.22
新北市,樹林區,三龍里,820,323,497,5,825,1875,0,44.0,17.23
新北市,樹林區,合計,61445,26834,34611,580,62025,152907,182668,40.56,17.55
新北市,鶯歌區,東鶯里,439,190,249,7,446,946,0,47.15,20.08
新北市,鶯歌區,西鶯里,863,401,462,5,868,1968,0,44.11,20.38
新北市,鶯歌區,南鶯里,2135,922,1213,14,2149,4997,0,43.01,18.45
新北市,鶯歌區,北鶯里,1483,724,759,12,1495,3748,0,39.89,19.32
新北市,鶯歌區,中鶯里,464,198,266,4,468,940,0,49.79,21.06
新北市,鶯歌區,建德里,240,100,140,1,241,518,0,46.53,19.31
新北市,鶯歌區,同慶里,636,259,377,2,638,1386,0,46.03,18.69
新北市,鶯歌區,永昌里,2842,1276,1566,28,2870,7317,0,39.22,17.44
新北市,鶯歌區,南靖里,1318,507,811,11,1329,3154,0,42.14,16.07
新北市,鶯歌區,尖山里,2946,1276,1670,24,2970,7755,0,38.3,16.45
新北市,鶯歌區,二橋里,2657,1105,1552,21,2678,7334,0,36.51,15.07
新北市,鶯歌區,二甲里,376,156,220,5,381,836,0,45.57,18.66
新北市,鶯歌區,東湖里,149,60,89,1,150,250,0,60.0,24.0
新北市,鶯歌區,大湖里,1873,901,972,17,1890,4527,0,41.75,19.9
新北市,鶯歌區,鳳鳴里,1757,773,984,14,1771,4996,0,35.45,15.47
新北市,鶯歌區,鳳福里,1473,653,820,14,1487,3896,0,38.17,16.76
新北市,鶯歌區,永吉里,1710,810,900,18,1728,4275,0,40.42,18.95
新北市,鶯歌區,中湖里,1827,855,972,14,1841,5088,0,36.18,16.8
新北市,鶯歌區,鳳祥里,1450,633,817,10,1460,3878,0,37.65,16.32
新北市,鶯歌區,建國里,2304,964,1340,19,2323,6172,0,37.64,15.62
新北市,鶯歌區,合計,28942,12763,16179,241,29183,73981,88131,39.45,17.25
新北市,三峽區,三峽里,161,73,88,3,164,285,0,57.54,25.61
新北市,三峽區,秀川里,227,95,132,3,230,575,0,40.0,16.52
新北市,三峽區,八張里,1353,629,724,12,1365,3542,0,38.54,17.76
新北市,三峽區,中埔里,1061,558,503,13,1074,3013,0,35.65,18.52
新北市,三峽區,弘道里,366,125,241,2,368,1027,0,35.83,12.17
新北市,三峽區,永舘里,2548,1158,1390,27,2575,6463,0,39.84,17.92
新北市,三峽區,礁溪里,1920,902,1018,14,1934,5237,0,36.93,17.22
新北市,三峽區,鳶山里,3067,1388,1679,34,3101,8816,0,35.17,15.74
新北市,三峽區,龍埔里,3091,1509,1582,37,3128,8410,0,37.19,17.94
新北市,三峽區,大埔里,1346,696,650,11,1357,3676,0,36.92,18.93
新北市,三峽區,嘉添里,840,441,399,12,852,2111,0,40.36,20.89
新北市,三峽區,添福里,379,143,236,7,386,1045,0,36.94,13.68
新北市,三峽區,金圳里,176,64,112,4,180,486,0,37.04,13.17
新北市,三峽區,五寮里,231,104,127,5,236,794,0,29.72,13.1
新北市,三峽區,插角里,279,88,191,3,282,632,0,44.62,13.92
新北市,三峽區,有木里,216,63,153,2,218,683,0,31.92,9.22
新北市,三峽區,溪北里,871,350,521,8,879,2123,0,41.4,16.49
新北市,三峽區,溪南里,587,232,355,7,594,1375,0,43.2,16.87
新北市,三峽區,溪東里,986,454,532,10,996,2733,0,36.44,16.61
新北市,三峽區,成福里,395,149,246,5,400,860,0,46.51,17.33
新北市,三峽區,安坑里,445,151,294,12,457,1294,0,35.32,11.67
新北市,三峽區,竹崙里,640,235,405,4,644,1870,0,34.44,12.57
新北市,三峽區,介壽里,2006,895,1111,12,2018,6055,0,33.33,14.78
新北市,三峽區,安溪里,2319,1149,1170,25,2344,6654,0,35.23,17.27
新北市,三峽區,中正里,1581,710,871,18,1599,4616,0,34.64,15.38
新北市,三峽區,二鬮里,1201,650,551,13,1214,3228,0,37.61,20.14
新北市,三峽區,龍學里,5476,3050,2426,40,5516,12581,0,43.84,24.24
新北市,三峽區,龍恩里,2404,1325,1079,14,2418,5980,0,40.43,22.16
新北市,三峽區,合計,36172,17386,18786,357,36529,96164,116549,37.99,18.08
新北市,淡水區,中和里,194,68,126,3,197,557,0,35.37,12.21
新北市,淡水區,屯山里,323,117,206,4,327,994,0,32.9,11.77
新北市,淡水區,賢孝里,475,231,244,9,484,1447,0,33.45,15.96
新北市,淡水區,興仁里,566,245,321,8,574,1510,0,38.01,16.23
新北市,淡水區,蕃薯里,341,169,172,1,342,973,0,35.15,17.37
新北市,淡水區,義山里,804,376,428,9,813,2422,0,33.57,15.52
新北市,淡水區,忠山里,323,149,174,7,330,803,0,41.1,18.56
新北市,淡水區,崁頂里,6099,3407,2692,46,6145,17538,0,35.04,19.43
新北市,淡水區,埤島里,579,261,318,4,583,1616,0,36.08,16.15
新北市,淡水區,新興里,2520,1348,1172,27,2547,6573,0,38.75,20.51
新北市,淡水區,水碓里,1979,916,1063,27,2006,5098,0,39.35,17.97
新北市,淡水區,北投里,3657,1936,1721,30,3687,9067,0,40.66,21.35
新北市,淡水區,水源里,743,259,484,8,751,1974,0,38.04,13.12
新北市,淡水區,忠寮里,401,145,256,5,406,1054,0,38.52,13.76
新北市,淡水區,樹興里,548,255,293,6,554,1361,0,40.71,18.74
新北市,淡水區,坪頂里,543,262,281,5,548,1263,0,43.39,20.74
新北市,淡水區,福德里,3086,1680,1406,23,3109,6369,0,48.81,26.38
新北市,淡水區,竹圍里,2567,1346,1221,22,2589,5639,0,45.91,23.87
新北市,淡水區,民生里,2761,1355,1406,13,2774,6465,0,42.91,20.96
新北市,淡水區,八勢里,2561,1351,1210,32,2593,6014,0,43.12,22.46
新北市,淡水區,竿蓁里,4064,2211,1853,38,4102,10029,0,40.9,22.05
新北市,淡水區,鄧公里,2290,1177,1113,23,2313,5542,0,41.74,21.24
新北市,淡水區,中興里,1395,660,735,18,1413,3650,0,38.71,18.08
新北市,淡水區,長庚里,608,269,339,9,617,1326,0,46.53,20.29
新北市,淡水區,清文里,422,169,253,3,425,1068,0,39.79,15.82
新北市,淡水區,草東里,305,123,182,5,310,682,0,45.45,18.04
新北市,淡水區,協元里,519,225,294,3,522,1339,0,38.98,16.8
新北市,淡水區,永吉里,397,173,224,3,400,804,0,49.75,21.52
新北市,淡水區,民安里,315,130,185,8,323,624,0,51.76,20.83
新北市,淡水區,新生里,184,81,103,2,186,396,0,46.97,20.45
新北市,淡水區,文化里,666,353,313,6,672,1587,0,42.34,22.24
新北市,淡水區,油車里,2042,1094,948,20,2062,4932,0,41.81,22.18
新北市,淡水區,沙崙里,1590,842,748,9,1599,4158,0,38.46,20.25
新北市,淡水區,新義里,1350,566,784,13,1363,3658,0,37.26,15.47
新北市,淡水區,新春里,2937,1449,1488,23,2960,7974,0,37.12,18.17
新北市,淡水區,新民里,1759,882,877,14,1773,4269,0,41.53,20.66
新北市,淡水區,正德里,1644,892,752,13,1657,4169,0,39.75,21.4
新北市,淡水區,北新里,962,491,471,4,966,2486,0,38.86,19.75
新北市,淡水區,民權里,1926,906,1020,15,1941,4221,0,45.98,21.46
新北市,淡水區,幸福里,1410,655,755,18,1428,3477,0,41.07,18.84
新北市,淡水區,學府里,1574,832,742,10,1584,4251,0,37.26,19.57
新北市,淡水區,大庄里,3809,2121,1688,40,3849,9198,0,41.85,23.06
新北市,淡水區,合計,63238,32177,31061,586,63824,158577,184450,40.25,20.29
新北市,汐止區,義民里,528,264,264,4,532,1238,0,42.97,21.32
新北市,汐止區,禮門里,449,194,255,3,452,980,0,46.12,19.8
新北市,汐止區,智慧里,1869,1049,820,11,1880,4239,0,44.35,24.75
新北市,汐止區,信望里,145,68,77,2,147,320,0,45.94,21.25
新北市,汐止區,橋東里,1243,610,633,11,1254,2889,0,43.41,21.11
新北市,汐止區,秀峰里,1407,668,739,19,1426,4888,0,29.17,13.67
新北市,汐止區,新昌里,1951,943,1008,22,1973,4758,0,41.47,19.82
新北市,汐止區,復興里,3158,1699,1459,33,3191,6286,0,50.76,27.03
新北市,汐止區,茄苳里,1379,661,718,12,1391,3956,0,35.16,16.71
新北市,汐止區,長安里,631,291,340,8,639,1489,0,42.91,19.54
新北市,汐止區,保安里,544,256,288,7,551,1494,0,36.88,17.14
新北市,汐止區,保長里,1665,789,876,23,1688,4194,0,40.25,18.81
新北市,汐止區,鄉長里,933,427,506,9,942,2101,0,44.84,20.32
新北市,汐止區,江北里,2112,1035,1077,18,2130,5478,0,38.88,18.89
新北市,汐止區,拱北里,1597,828,769,11,1608,4648,0,34.6,17.81
新北市,汐止區,烘內里,626,312,314,7,633,1479,0,42.8,21.1
新北市,汐止區,八連里,339,139,200,3,342,921,0,37.13,15.09
新北市,汐止區,樟樹里,764,350,414,10,774,1990,0,38.89,17.59
新北市,汐止區,北峰里,1722,756,966,13,1735,4527,0,38.33,16.7
新北市,汐止區,北山里,2414,1236,1178,16,2430,5282,0,46.01,23.4
新北市,汐止區,白雲里,1603,806,797,14,1617,3974,0,40.69,20.28
新北市,汐止區,橫科里,1827,943,884,23,1850,4272,0,43.31,22.07
新北市,汐止區,東山里,216,101,115,2,218,542,0,40.22,18.63
新北市,汐止區,福山里,1546,817,729,11,1557,3388,0,45.96,24.11
新北市,汐止區,宜興里,1328,783,545,10,1338,2728,0,49.05,28.7
新北市,汐止區,中興里,2723,1289,1434,29,2752,7130,0,38.6,18.08
新北市,汐止區,湖光里,2472,1382,1090,28,2500,5589,0,44.73,24.73
新北市,汐止區,仁德里,733,375,358,14,747,1675,0,44.6,22.39
新北市,汐止區,厚德里,2443,1326,1117,18,2461,6767,0,36.37,19.6
新北市,汐止區,忠孝里,2936,1549,1387,21,2957,7500,0,39.43,20.65
新北市,汐止區,自強里,2146,1078,1068,20,2166,5118,0,42.32,21.06
新北市,汐止區,文化里,1728,870,858,12,1740,4130,0,42.13,21.07
新北市,汐止區,金龍里,1931,976,955,22,1953,4841,0,40.34,20.16
新北市,汐止區,福德里,1133,545,588,10,1143,2985,0,38.29,18.26
新北市,汐止區,興福里,1273,674,599,3,1276,2904,0,43.94,23.21
新北市,汐止區,康福里,1863,962,901,23,1886,4716,0,39.99,20.4
新北市,汐止區,忠山里,1629,985,644,20,1649,3115,0,52.94,31.62
新北市,汐止區,環河里,513,194,319,4,517,1145,0,45.15,16.94
新北市,汐止區,東勢里,2072,1164,908,20,2092,4238,0,49.36,27.47
新北市,汐止區,山光里,894,524,370,7,901,2598,0,34.68,20.17
新北市,汐止區,大同里,1088,575,513,5,1093,2552,0,42.83,22.53
新北市,汐止區,崇德里,1922,969,953,19,1941,4444,0,43.68,21.8
新北市,汐止區,湖興里,2745,1631,1114,19,2764,6020,0,45.91,27.09
新北市,汐止區,長青里,452,248,204,9,461,872,0,52.87,28.44
新北市,汐止區,福安里,2263,1140,1123,21,2284,5639,0,40.5,20.22
新北市,汐止區,秀山里,1671,889,782,18,1689,3952,0,42.74,22.49
新北市,汐止區,建成里,2115,1191,924,29,2144,4633,0,46.28,25.71
新北市,汐止區,城中里,1848,1036,812,14,1862,4091,0,45.51,25.32
新北市,汐止區,湖蓮里,1351,831,520,16,1367,2514,0,54.38,33.05
新北市,汐止區,保新里,1033,587,446,8,1041,2680,0,38.84,21.9
新北市,汐止區,合計,74973,39015,35958,711,75684,179909,205551,42.07,21.69
新北市,瑞芳區,龍潭里,303,139,164,3,306,728,0,42.03,19.09
新北市,瑞芳區,龍興里,784,385,399,7,791,1862,0,42.48,20.68
新北市,瑞芳區,龍鎮里,465,230,235,4,469,1203,0,38.99,19.12
新北市,瑞芳區,龍川里,592,279,313,3,595,1573,0,37.83,17.74
新北市,瑞芳區,龍山里,482,266,216,3,485,1281,0,37.86,20.77
新北市,瑞芳區,龍安里,217,112,105,5,222,598,0,37.12,18.73
新北市,瑞芳區,爪峯里,1294,554,740,14,1308,3539,0,36.96,15.65
新北市,瑞芳區,柑坪里,367,144,223,4,371,1041,0,35.64,13.83
新北市,瑞芳區,東和里,565,263,302,4,569,1589,0,35.81,16.55
新北市,瑞芳區,上天里,469,225,244,3,472,1272,0,37.11,17.69
新北市,瑞芳區,吉慶里,558,291,267,8,566,1680,0,33.69,17.32
新北市,瑞芳區,吉安里,978,476,502,13,991,2918,0,33.96,16.31
新北市,瑞芳區,傑魚里,663,280,383,7,670,1891,0,35.43,14.81
新北市,瑞芳區,猴硐里,142,53,89,0,142,434,0,32.72,12.21
新北市,瑞芳區,光復里,91,35,56,3,94,241,0,39.0,14.52
新北市,瑞芳區,弓橋里,116,37,79,3,119,264,0,45.08,14.02
新北市,瑞芳區,碩仁里,72,34,38,1,73,138,0,52.9,24.64
新北市,瑞芳區,基山里,180,77,103,3,183,417,0,43.88,18.47
新北市,瑞芳區,永慶里,128,60,68,0,128,408,0,31.37,14.71
新北市,瑞芳區,崇文里,114,46,68,2,116,296,0,39.19,15.54
新北市,瑞芳區,福住里,69,38,31,2,71,164,0,43.29,23.17
新北市,瑞芳區,頌德里,119,61,58,1,120,326,0,36.81,18.71
新北市,瑞芳區,新山里,107,53,54,2,109,339,0,32.15,15.63
新北市,瑞芳區,瓜山里,72,42,30,2,74,164,0,45.12,25.61
新北市,瑞芳區,銅山里,80,33,47,2,82,186,0,44.09,17.74
新北市,瑞芳區,石山里,110,63,47,0,110,321,0,34.27,19.63
新北市,瑞芳區,濓新里,79,35,44,1,80,286,0,27.97,12.24
新北市,瑞芳區,濓洞里,167,96,71,3,170,459,0,37.04,20.92
新北市,瑞芳區,海濱里,335,188,147,3,338,1241,0,27.24,15.15
新北市,瑞芳區,瑞濱里,590,284,306,6,596,1905,0,31.29,14.91
新北市,瑞芳區,深澳里,366,202,164,1,367,1290,0,28.45,15.66
新北市,瑞芳區,南雅里,119,46,73,1,120,264,0,45.45,17.42
新北市,瑞芳區,鼻頭里,265,92,173,5,270,853,0,31.65,10.79
新北市,瑞芳區,新峰里,907,444,463,11,918,3060,0,30.0,14.51
新北市,瑞芳區,合計,11965,5663,6302,130,12095,34231,38764,35.33,16.54
新北市,土城區,埤塘里,1287,584,703,10,1297,5065,0,25.61,11.53
新北市,土城區,土城里,741,351,390,12,753,1838,0,40.97,19.1
新北市,土城區,員林里,2579,1281,1298,24,2603,6368,0,40.88,20.12
新北市,土城區,員仁里,1845,866,979,17,1862,4879,0,38.16,17.75
新北市,土城區,長風里,989,714,275,9,998,1844,0,54.12,38.72
新北市,土城區,日新里,1715,737,978,21,1736,4107,0,42.27,17.94
新北市,土城區,日和里,2372,1010,1362,21,2393,5788,0,41.34,17.45
新北市,土城區,貨饒里,1611,646,965,11,1622,3999,0,40.56,16.15
新北市,土城區,柑林里,1326,621,705,11,1337,3209,0,41.66,19.35
新北市,土城區,埤林里,3168,1514,1654,25,3193,7337,0,43.52,20.64
新北市,土城區,瑞興里,1075,405,670,10,1085,2741,0,39.58,14.78
新北市,土城區,清水里,2809,1269,1540,19,2828,7167,0,39.46,17.71
新北市,土城區,清和里,1971,830,1141,30,2001,5572,0,35.91,14.9
新北市,土城區,永豐里,1492,749,743,13,1505,3780,0,39.81,19.81
新北市,土城區,清化里,576,233,343,7,583,1455,0,40.07,16.01
新北市,土城區,清溪里,2426,1172,1254,29,2455,6034,0,40.69,19.42
新北市,土城區,峯廷里,2368,1027,1341,27,2395,6492,0,36.89,15.82
新北市,土城區,平和里,2482,1053,1429,16,2498,6188,0,40.37,17.02
新北市,土城區,廷寮里,1742,725,1017,11,1753,4348,0,40.32,16.67
新北市,土城區,大安里,1852,862,990,20,1872,4345,0,43.08,19.84
新北市,土城區,永寧里,2674,1260,1414,34,2708,7273,0,37.23,17.32
新北市,土城區,沛陂里,1725,749,976,30,1755,4244,0,41.35,17.65
新北市,土城區,頂埔里,1719,808,911,24,1743,4447,0,39.19,18.17
新北市,土城區,頂福里,1798,851,947,18,1816,4672,0,38.87,18.21
新北市,土城區,頂新里,1152,713,439,10,1162,2561,0,45.37,27.84
新北市,土城區,祖田里,570,203,367,4,574,1476,0,38.89,13.75
新北市,土城區,樂利里,1836,841,995,21,1857,4491,0,41.35,18.73
新北市,土城區,廣福里,2212,1071,1141,13,2225,4980,0,44.68,21.51
新北市,土城區,學府里,1270,580,690,16,1286,3076,0,41.81,18.86
新北市,土城區,延壽里,1527,684,843,7,1534,3907,0,39.26,17.51
新北市,土城區,安和里,1817,769,1048,14,1831,4353,0,42.06,17.67
新北市,土城區,青雲里,1168,531,637,11,1179,2751,0,42.86,19.3
新北市,土城區,員福里,1939,883,1056,15,1954,4879,0,40.05,18.1
新北市,土城區,延吉里,1437,584,853,12,1449,3854,0,37.6,15.15
新北市,土城區,復興里,1631,742,889,14,1645,3997,0,41.16,18.56
新北市,土城區,裕生里,1980,825,1155,13,1993,4880,0,40.84,16.91
新北市,土城區,員信里,1444,691,753,8,1452,3873,0,37.49,17.84
新北市,土城區,永富里,1814,831,983,16,1830,4972,0,36.81,16.71
新北市,土城區,學成里,1294,523,771,8,1302,2895,0,44.97,18.07
新北市,土城區,延和里,2356,1154,1202,23,2379,5897,0,40.34,19.57
新北市,土城區,中正里,1210,572,638,14,1224,2851,0,42.93,20.06
新北市,土城區,學士里,1882,904,978,10,1892,4214,0,44.9,21.45
新北市,土城區,明德里,2200,1094,1106,21,2221,5145,0,43.17,21.26
新北市,土城區,廣興里,1242,592,650,12,1254,3049,0,41.13,19.42
新北市,土城區,青山里,1078,463,615,4,1082,2621,0,41.28,17.67
新北市,土城區,金城里,1993,1064,929,17,2010,5390,0,37.29,19.74
新北市,土城區,延祿里,1295,561,734,14,1309,3708,0,35.3,15.13
新北市,土城區,合計,80689,37192,43497,746,81435,203012,238020,40.11,18.32
新北市,蘆洲區,正義里,4814,2022,2792,47,4861,11581,0,41.97,17.46
新北市,蘆洲區,中原里,2047,833,1214,18,2065,5216,0,39.59,15.97
新北市,蘆洲區,中路里,1450,565,885,17,1467,3615,0,40.58,15.63
新北市,蘆洲區,光華里,1916,715,1201,17,1933,4716,0,40.99,15.16
新北市,蘆洲區,保佑里,1278,531,747,13,1291,3348,0,38.56,15.86
新北市,蘆洲區,水湳里,3648,1437,2211,33,3681,9167,0,40.15,15.68
新北市,蘆洲區,樓厝里,2460,1044,1416,19,2479,5872,0,42.22,17.78
新北市,蘆洲區,鷺江里,1938,754,1184,17,1955,4812,0,40.63,15.67
新北市,蘆洲區,恆德里,2235,968,1267,24,2259,5571,0,40.55,17.38
新北市,蘆洲區,溪墘里,1233,442,791,10,1243,2798,0,44.42,15.8
新北市,蘆洲區,樹德里,1296,502,794,15,1311,2888,0,45.39,17.38
新北市,蘆洲區,保和里,942,374,568,10,952,2322,0,41.0,16.11
新北市,蘆洲區,仁復里,734,283,451,5,739,1885,0,39.2,15.01
新北市,蘆洲區,得勝里,1180,458,722,9,1189,2972,0,40.01,15.41
新北市,蘆洲區,南港里,1916,709,1207,22,1938,5162,0,37.54,13.73
新北市,蘆洲區,永樂里,2142,852,1290,14,2156,5439,0,39.64,15.66
新北市,蘆洲區,永康里,2253,841,1412,19,2272,5948,0,38.2,14.14
新北市,蘆洲區,信義里,1398,501,897,13,1411,3564,0,39.59,14.06
新北市,蘆洲區,玉清里,2203,932,1271,13,2216,5243,0,42.27,17.78
新北市,蘆洲區,復興里,1353,455,898,17,1370,3166,0,43.27,14.37
新北市,蘆洲區,水河里,3221,1190,2031,33,3254,8441,0,38.55,14.1
新北市,蘆洲區,仁愛里,1883,702,1181,22,1905,4663,0,40.85,15.05
新北市,蘆洲區,忠義里,1018,377,641,15,1033,2855,0,36.18,13.2
新北市,蘆洲區,九芎里,1857,744,1113,15,1872,4834,0,38.73,15.39
新北市,蘆洲區,中華里,1259,458,801,7,1266,2975,0,42.55,15.39
新北市,蘆洲區,得仁里,1234,466,768,16,1250,2688,0,46.5,17.34
新北市,蘆洲區,仁德里,1962,720,1242,21,1983,4838,0,40.99,14.88
新北市,蘆洲區,仁義里,1589,628,961,17,1606,4916,0,32.67,12.77
新北市,蘆洲區,光明里,1705,633,1072,19,1724,4262,0,40.45,14.85
新北市,蘆洲區,保新里,1326,514,812,12,1338,3431,0,39.0,14.98
新北市,蘆洲區,長安里,1620,542,1078,15,1635,4622,0,35.37,11.73
新北市,蘆洲區,民和里,1009,403,606,11,1020,2400,0,42.5,16.79
新北市,蘆洲區,忠孝里,878,287,591,3,881,2171,0,40.58,13.22
新北市,蘆洲區,福安里,1209,460,749,15,1224,2886,0,42.41,15.94
新北市,蘆洲區,永安里,1829,652,1177,26,1855,4625,0,40.11,14.1
新北市,蘆洲區,延平里,1472,550,922,22,1494,3685,0,40.54,14.93
新北市,蘆洲區,成功里,2587,967,1620,26,2613,6695,0,39.03,14.44
新北市,蘆洲區,永德里,1409,528,881,17,1426,4010,0,35.56,13.17
新北市,蘆洲區,合計,67503,26039,41464,664,68167,170282,202131,40.03,15.29
新北市,五股區,興珍里,1736,548,1188,15,1751,4197,0,41.72,13.06
新北市,五股區,更寮里,489,119,370,3,492,1073,0,45.85,11.09
新北市,五股區,集福里,1488,573,915,8,1496,3475,0,43.05,16.49
新北市,五股區,觀音里,494,139,355,5,499,1260,0,39.6,11.03
新北市,五股區,成州里,1965,730,1235,26,1991,5457,0,36.49,13.38
新北市,五股區,成功里,2406,896,1510,23,2429,6462,0,37.59,13.87
新北市,五股區,五龍里,524,129,395,3,527,1245,0,42.33,10.36
新北市,五股區,五股里,1388,573,815,15,1403,3885,0,36.11,14.75
新北市,五股區,五福里,1240,509,731,9,1249,3097,0,40.33,16.44
新北市,五股區,德音里,1945,904,1041,23,1968,4718,0,41.71,19.16
新北市,五股區,陸一里,1050,830,220,9,1059,2315,0,45.75,35.85
新北市,五股區,貿商里,1243,864,379,17,1260,2648,0,47.58,32.63
新北市,五股區,德泰里,1554,728,826,14,1568,3948,0,39.72,18.44
新北市,五股區,成德里,1114,435,679,7,1121,3009,0,37.25,14.46
新北市,五股區,六福里,1357,639,718,17,1374,3460,0,39.71,18.47
新北市,五股區,集賢里,1490,529,961,12,1502,3661,0,41.03,14.45
新北市,五股區,民義里,1304,568,736,7,1311,3192,0,41.07,17.79
新北市,五股區,成泰里,3532,1480,2052,29,3561,9533,0,37.35,15.53
新北市,五股區,水碓里,2738,1075,1663,24,2762,7004,0,39.43,15.35
新北市,五股區,福德里,1023,432,591,8,1031,3018,0,34.16,14.31
新北市,五股區,合計,30080,12700,17380,274,30354,76657,90027,39.6,16.57
新北市,泰山區,大科里,325,124,201,3,328,822,0,39.9,15.09
新北市,泰山區,黎明里,1223,551,672,9,1232,3030,0,40.66,18.18
新北市,泰山區,山腳里,2243,1024,1219,14,2257,5956,0,37.89,17.19
新北市,泰山區,福泰里,985,428,557,18,1003,2521,0,39.79,16.98
新北市,泰山區,楓樹里,1542,698,844,14,1556,3870,0,40.21,18.04
新北市,泰山區,同榮里,1505,731,774,18,1523,3617,0,42.11,20.21
新北市,泰山區,義學里,1672,738,934,10,1682,4172,0,40.32,17.69
新北市,泰山區,明志里,1447,653,794,11,1458,3385,0,43.07,19.29
新北市,泰山區,貴子里,1572,754,818,7,1579,3571,0,44.22,21.11
新北市,泰山區,貴和里,1820,814,1006,12,1832,4404,0,41.6,18.48
新北市,泰山區,同興里,1374,560,814,14,1388,3234,0,42.92,17.32
新北市,泰山區,義仁里,2892,1277,1615,16,2908,7169,0,40.56,17.81
新北市,泰山區,泰友里,767,353,414,6,773,1857,0,41.63,19.01
新北市,泰山區,新明里,1146,498,648,11,1157,2868,0,40.34,17.36
新北市,泰山區,貴賢里,1534,733,801,10,1544,3300,0,46.79,22.21
新北市,泰山區,福興里,1255,605,650,14,1269,3114,0,40.75,19.43
新北市,泰山區,全興里,2923,1355,1568,30,2953,7587,0,38.92,17.86
新北市,泰山區,合計,26225,11896,14329,217,26442,64477,77862,41.01,18.45
新北市,林口區,東林里,1217,492,725,22,1239,3528,0,35.12,13.95
新北市,林口區,林口里,1731,827,904,16,1747,4811,0,36.31,17.19
新北市,林口區,西林里,3743,1771,1972,38,3781,9419,0,40.14,18.8
新北市,林口區,菁湖里,1647,683,964,21,1668,3771,0,44.23,18.11
新北市,林口區,中湖里,1553,681,872,11,1564,4170,0,37.51,16.33
新北市,林口區,湖北里,609,222,387,14,623,1384,0,45.01,16.04
新北市,林口區,湖南里,8362,4587,3775,65,8427,20700,0,40.71,22.16
新北市,林口區,南勢里,8650,4598,4052,74,8724,20299,0,42.98,22.65
新北市,林口區,東勢里,2729,1452,1277,21,2750,6489,0,42.38,22.38
新北市,林口區,頂福里,357,92,265,4,361,1010,0,35.74,9.11
新北市,林口區,下福里,451,178,273,6,457,1229,0,37.18,14.48
新北市,林口區,嘉寶里,397,138,259,4,401,911,0,44.02,15.15
新北市,林口區,瑞平里,262,90,172,1,263,763,0,34.47,11.8
新北市,林口區,太平里,459,139,320,7,466,1461,0,31.9,9.51
新北市,林口區,仁愛里,2515,1393,1122,20,2535,6006,0,42.21,23.19
新北市,林口區,麗林里,3147,1753,1394,31,3178,7589,0,41.88,23.1
新北市,林口區,麗園里,1551,772,779,23,1574,3627,0,43.4,21.28
新北市,林口區,合計,39380,19868,19512,378,39758,97167,123095,40.92,20.45
新北市,深坑區,深坑里,1331,637,694,6,1337,3097,0,43.17,20.57
新北市,深坑區,萬順里,957,461,496,6,963,2316,0,41.58,19.91
新北市,深坑區,土庫里,1143,567,576,10,1153,2749,0,41.94,20.63
新北市,深坑區,昇高里,902,494,408,8,910,1926,0,47.25,25.65
新北市,深坑區,阿柔里,236,108,128,2,238,558,0,42.65,19.35
新北市,深坑區,埔新里,2426,1281,1145,20,2446,5654,0,43.26,22.66
新北市,深坑區,萬福里,1046,517,529,5,1051,2486,0,42.28,20.8
新北市,深坑區,賴仲里,965,563,402,7,972,2115,0,45.96,26.62
新北市,深坑區,合計,9006,4628,4378,64,9070,20901,23730,43.4,22.14
新北市,石碇區,石碇里,143,59,84,0,143,365,0,39.18,16.16
新北市,石碇區,潭邊里,292,148,144,1,293,798,0,36.72,18.55
新北市,石碇區,隆盛里,237,98,139,3,240,668,0,35.93,14.67
新北市,石碇區,烏塗里,243,83,160,2,245,607,0,40.36,13.67
新北市,石碇區,彭山里,105,47,58,1,106,296,0,35.81,15.88
新北市,石碇區,豐田里,184,80,104,1,185,387,0,47.8,20.67
新北市,石碇區,永定里,202,76,126,3,205,589,0,34.8,12.9
新北市,石碇區,中民里,249,94,155,2,251,717,0,35.01,13.11
新北市,石碇區,光明里,106,33,73,1,107,261,0,41.0,12.64
新北市,石碇區,豐林里,123,51,72,1,124,302,0,41.06,16.89
新北市,石碇區,永安里,314,89,225,5,319,809,0,39.43,11.0
新北市,石碇區,格頭里,410,138,272,4,414,991,0,41.78,13.93
新北市,石碇區,合計,2608,996,1612,24,2632,6790,7487,38.76,14.67
新北市,坪林區,粗窟里,325,141,184,2,327,853,0,38.34,16.53
新北市,坪林區,坪林里,495,197,298,7,502,1290,0,38.91,15.27
新北市,坪林區,大林里,440,117,323,4,444,1167,0,38.05,10.03
新北市,坪林區,石𥕢里,136,43,93,3,139,420,0,33.1,10.24
新北市,坪林區,上德里,279,111,168,5,284,836,0,33.97,13.28
新北市,坪林區,水德里,209,84,125,3,212,631,0,33.6,13.31
新北市,坪林區,漁光里,312,88,224,4,316,860,0,36.74,10.23
新北市,坪林區,合計,2196,781,1415,28,2224,6057,6670,36.72,12.89
新北市,三芝區,八賢里,105,29,76,2,107,311,0,34.41,9.32
新北市,三芝區,埔頭里,1559,780,779,8,1567,4787,0,32.73,16.29
新北市,三芝區,古庄里,381,187,194,3,384,1113,0,34.5,16.8
新北市,三芝區,新庄里,276,137,139,0,276,776,0,35.57,17.65
新北市,三芝區,埔坪里,1890,998,892,30,1920,6124,0,31.35,16.3
新北市,三芝區,茂長里,276,138,138,3,279,604,0,46.19,22.85
新北市,三芝區,橫山里,161,94,67,1,162,477,0,33.96,19.71
新北市,三芝區,錫板里,281,121,160,4,285,661,0,43.12,18.31
新北市,三芝區,後厝里,775,436,339,5,780,2030,0,38.42,21.48
新北市,三芝區,福德里,300,139,161,4,304,762,0,39.9,18.24
新北市,三芝區,圓山里,156,61,95,2,158,532,0,29.7,11.47
新北市,三芝區,店子里,192,69,123,0,192,580,0,33.1,11.9
新北市,三芝區,興華里,434,163,271,7,441,1170,0,37.69,13.93
新北市,三芝區,合計,6786,3352,3434,69,6855,19927,22460,34.4,16.82
新北市,石門區,德茂里,336,144,192,6,342,1087,0,31.46,13.25
新北市,石門區,富基里,481,245,236,7,488,1316,0,37.08,18.62
新北市,石門區,老梅里,624,289,335,12,636,2052,0,30.99,14.08
新北市,石門區,山溪里,268,131,137,2,270,867,0,31.14,15.11
新北市,石門區,石門里,517,271,246,8,525,1496,0,35.09,18.11
新北市,石門區,尖鹿里,427,213,214,6,433,1452,0,29.82,14.67
新北市,石門區,乾華里,100,49,51,0,100,315,0,31.75,15.56
新北市,石門區,茂林里,192,90,102,2,194,589,0,32.94,15.28
新北市,石門區,草里里,257,136,121,4,261,915,0,28.52,14.86
新北市,石門區,合計,3202,1568,1634,47,3249,10089,11303,32.2,15.54
新北市,八里區,龍源里,2778,1328,1450,23,2801,6740,0,41.56,19.7
新北市,八里區,米倉里,1195,561,634,4,1199,3256,0,36.82,17.23
新北市,八里區,大崁里,1204,518,686,10,1214,3091,0,39.28,16.76
新北市,八里區,埤頭里,1419,606,813,7,1426,3745,0,38.08,16.18
新北市,八里區,頂罟里,780,355,425,7,787,2139,0,36.79,16.6
新北市,八里區,舊城里,2324,993,1331,17,2341,6501,0,36.01,15.27
新北市,八里區,訊塘里,1461,655,806,17,1478,4113,0,35.93,15.93
新北市,八里區,荖阡里,563,244,319,2,565,1639,0,34.47,14.89
新北市,八里區,長坑里,507,213,294,8,515,1521,0,33.86,14.0
新北市,八里區,下罟里,493,229,264,8,501,1476,0,33.94,15.51
新北市,八里區,合計,12724,5702,7022,103,12827,34221,39799,37.48,16.66
新北市,平溪區,薯榔里,132,46,86,2,134,361,0,37.12,12.74
新北市,平溪區,菁桐里,85,49,36,0,85,226,0,37.61,21.68
新北市,平溪區,白石里,96,35,61,1,97,229,0,42.36,15.28
新北市,平溪區,石底里,160,50,110,2,162,417,0,38.85,11.99
新北市,平溪區,平溪里,101,60,41,1,102,247,0,41.3,24.29
新北市,平溪區,嶺腳里,177,82,95,3,180,586,0,30.72,13.99
新北市,平溪區,東勢里,156,66,90,4,160,406,0,39.41,16.26
新北市,平溪區,望古里,58,24,34,0,58,154,0,37.66,15.58
新北市,平溪區,南山里,119,54,65,5,124,337,0,36.8,16.02
新北市,平溪區,平湖里,72,32,40,0,72,164,0,43.9,19.51
新北市,平溪區,十分里,254,121,133,6,260,798,0,32.58,15.16
新北市,平溪區,新寮里,39,18,21,1,40,151,0,26.49,11.92
新北市,平溪區,合計,1449,637,812,25,1474,4076,4354,36.16,15.63
新北市,雙溪區,雙溪里,175,87,88,4,179,444,0,40.32,19.59
新北市,雙溪區,共和里,134,57,77,0,134,363,0,36.91,15.7
新北市,雙溪區,新基里,296,145,151,8,304,713,0,42.64,20.34
新北市,雙溪區,魚行里,231,90,141,3,234,678,0,34.51,13.27
新北市,雙溪區,三港里,123,41,82,1,124,345,0,35.94,11.88
新北市,雙溪區,牡丹里,491,207,284,11,502,1416,0,35.45,14.62
新北市,雙溪區,三貂里,107,45,62,1,108,319,0,33.86,14.11
新北市,雙溪區,平林里,331,160,171,1,332,860,0,38.6,18.6
新北市,雙溪區,上林里,207,64,143,4,211,593,0,35.58,10.79
新北市,雙溪區,外柑里,162,77,85,1,163,394,0,41.37,19.54
新北市,雙溪區,長源里,109,28,81,0,109,351,0,31.05,7.98
新北市,雙溪區,泰平里,329,139,190,7,336,1129,0,29.76,12.31
新北市,雙溪區,合計,2695,1140,1555,41,2736,7605,8307,35.98,14.99
新北市,貢寮區,貢寮里,316,116,200,4,320,823,0,38.88,14.09
新北市,貢寮區,吉林里,158,49,109,4,162,462,0,35.06,10.61
新北市,貢寮區,雙玉里,242,59,183,4,246,631,0,38.99,9.35
新北市,貢寮區,龍崗里,145,39,106,3,148,398,0,37.19,9.8
新北市,貢寮區,龍門里,284,49,235,0,284,630,0,45.08,7.78
新北市,貢寮區,福隆里,584,167,417,10,594,1599,0,37.15,10.44
新北市,貢寮區,仁里里,733,190,543,8,741,1652,0,44.85,11.5
新北市,貢寮區,真理里,734,114,620,15,749,1987,0,37.7,5.74
新北市,貢寮區,福連里,320,80,240,1,321,886,0,36.23,9.03
新北市,貢寮區,美豐里,292,69,223,7,299,716,0,41.76,9.64
新北市,貢寮區,和美里,338,75,263,3,341,981,0,34.76,7.65
新北市,貢寮區,合計,4146,1007,3139,59,4205,10765,11658,39.06,9.35
新北市,金山區,和平里,188,98,90,3,191,456,0,41.89,21.49
新北市,金山區,大同里,244,117,127,2,246,712,0,34.55,16.43
新北市,金山區,豐漁里,193,76,117,2,195,502,0,38.84,15.14
新北市,金山區,磺港里,624,196,428,6,630,1719,0,36.65,11.4
新北市,金山區,美田里,1308,602,706,13,1321,3777,0,34.97,15.94
新北市,金山區,五湖里,597,280,317,8,605,1641,0,36.87,17.06
新北市,金山區,重和里,404,148,256,2,406,1182,0,34.35,12.52
新北市,金山區,兩湖里,122,52,70,1,123,377,0,32.63,13.79
新北市,金山區,六股里,239,84,155,5,244,643,0,37.95,13.06
新北市,金山區,三界里,235,83,152,2,237,619,0,38.29,13.41
新北市,金山區,清泉里,250,114,136,4,254,801,0,31.71,14.23
新北市,金山區,萬壽里,162,55,107,4,166,443,0,37.47,12.42
新北市,金山區,西湖里,71,31,40,2,73,177,0,41.24,17.51
新北市,金山區,永興里,179,63,116,3,182,570,0,31.93,11.05
新北市,金山區,金美里,1691,733,958,15,1706,4954,0,34.44,14.8
新北市,金山區,合計,6507,2732,3775,72,6579,18573,20926,35.42,14.71
新北市,萬里區,萬里里,1473,695,778,12,1485,4232,0,35.09,16.42
新北市,萬里區,龜吼里,767,370,397,2,769,2548,0,30.18,14.52
新北市,萬里區,野柳里,1022,461,561,10,1032,3153,0,32.73,14.62
新北市,萬里區,大鵬里,950,441,509,9,959,2681,0,35.77,16.45
新北市,萬里區,磺潭里,184,92,92,1,185,574,0,32.23,16.03
新北市,萬里區,雙興里,323,125,198,7,330,966,0,34.16,12.94
新北市,萬里區,溪底里,199,65,134,5,204,659,0,30.96,9.86
新北市,萬里區,崁脚里,146,45,101,2,148,403,0,36.72,11.17
新北市,萬里區,中幅里,356,172,184,3,359,1107,0,32.43,15.54
新北市,萬里區,北基里,924,494,430,8,932,2751,0,33.88,17.96
新北市,萬里區,合計,6344,2960,3384,59,6403,19074,21542,33.57,15.52
新北市,烏來區,烏來里,778,450,328,8,786,2348,0,33.48,19.17
新北市,烏來區,忠治里,531,314,217,7,538,1572,0,34.22,19.97
新北市,烏來區,福山里,152,114,38,6,158,606,0,26.07,18.81
新北市,烏來區,信賢里,156,70,86,1,157,504,0,31.15,13.89
新北市,烏來區,孝義里,67,29,38,1,68,231,0,29.44,12.55
新北市,烏來區,合計,1684,977,707,23,1707,5261,6343,32.45,18.57
新北市,合計,合計,1442763,692987,749776,13789,1456552,3427162,4021398,42.5,20.22
桃園市,桃園區,文化里,485,227,258,2,487,1024,0,47.56,22.17
桃園市,桃園區,文明里,689,338,351,6,695,1396,0,49.79,24.21
桃園市,桃園區,武陵里,622,299,323,5,627,1628,0,38.51,18.37
桃園市,桃園區,大林里,2534,1269,1265,26,2560,6940,0,36.89,18.29
桃園市,桃園區,忠義里,1366,738,628,11,1377,3581,0,38.45,20.61
桃園市,桃園區,會稽里,3775,2102,1673,20,3795,9791,0,38.76,21.47
桃園市,桃園區,長美里,469,168,301,2,471,1005,0,46.87,16.72
桃園市,桃園區,民生里,677,319,358,9,686,1649,0,41.6,19.35
桃園市,桃園區,永興里,745,309,436,7,752,1820,0,41.32,16.98
桃園市,桃園區,汴洲里,2591,1123,1468,24,2615,6542,0,39.97,17.17
桃園市,桃園區,永安里,2059,821,1238,26,2085,4520,0,46.13,18.16
桃園市,桃園區,東埔里,1872,806,1066,20,1892,4602,0,41.11,17.51
桃園市,桃園區,東門里,1357,691,666,10,1367,3019,0,45.28,22.89
桃園市,桃園區,東山里,810,362,448,7,817,1896,0,43.09,19.09
桃園市,桃園區,萬壽里,391,145,246,3,394,924,0,42.64,15.69
桃園市,桃園區,長安里,1483,625,858,8,1491,3527,0,42.27,17.72
桃園市,桃園區,中埔里,977,362,615,9,986,2382,0,41.39,15.2
桃園市,桃園區,西埔里,1332,511,821,13,1345,3082,0,43.64,16.58
桃園市,桃園區,西門里,639,293,346,5,644,1626,0,39.61,18.02
桃園市,桃園區,中和里,612,261,351,10,622,1307,0,47.59,19.97
桃園市,桃園區,文昌里,380,134,246,4,384,778,0,49.36,17.22
桃園市,桃園區,新埔里,4193,2289,1904,41,4234,9814,0,43.14,23.32
桃園市,桃園區,中山里,2874,1481,1393,23,2897,6789,0,42.67,21.81
桃園市,桃園區,慈文里,2447,1157,1290,18,2465,6329,0,38.95,18.28
桃園市,桃園區,西湖里,632,309,323,6,638,1430,0,44.62,21.61
桃園市,桃園區,南門里,2475,1183,1292,26,2501,5908,0,42.33,20.02
桃園市,桃園區,南華里,604,237,367,11,615,1365,0,45.05,17.36
桃園市,桃園區,玉山里,2060,911,1149,20,2080,4880,0,42.62,18.67
桃園市,桃園區,中成里,2263,1041,1222,12,2275,5722,0,39.76,18.19
桃園市,桃園區,中正里,2870,1481,1389,20,2890,6550,0,44.12,22.61
桃園市,桃園區,北門里,730,290,440,3,733,1710,0,42.87,16.96
桃園市,桃園區,雲林里,2628,1304,1324,22,2650,6053,0,43.78,21.54
桃園市,桃園區,福林里,2642,1253,1389,30,2672,5943,0,44.96,21.08
桃園市,桃園區,光興里,2134,921,1213,16,2150,4548,0,47.27,20.25
桃園市,桃園區,龍山里,1284,677,607,20,1304,3479,0,37.48,19.46
桃園市,桃園區,龍岡里,2316,1264,1052,29,2345,5803,0,40.41,21.78
桃園市,桃園區,成功里,1804,927,877,17,1821,3846,0,47.35,24.1
桃園市,桃園區,青溪里,1825,752,1073,22,1847,4213,0,43.84,17.85
桃園市,桃園區,朝陽里,894,379,515,10,904,1970,0,45.89,19.24
桃園市,桃園區,中興里,2461,1088,1373,15,2476,5681,0,43.58,19.15
桃園市,桃園區,豐林里,2835,1367,1468,18,2853,6243,0,45.7,21.9
桃園市,桃園區,建國里,2215,1106,1109,30,2245,5129,0,43.77,21.56
桃園市,桃園區,大豐里,2042,953,1089,15,2057,4911,0,41.89,19.41
桃園市,桃園區,福安里,1751,869,882,16,1767,4122,0,42.87,21.08
桃園市,桃園區,三民里,1968,1106,862,15,1983,4162,0,47.65,26.57
桃園市,桃園區,大興里,1989,901,1088,13,2002,5398,0,37.09,16.69
桃園市,桃園區,春日里,2236,1034,1202,28,2264,6093,0,37.16,16.97
桃園市,桃園區,信光里,2773,1235,1538,24,2797,6914,0,40.45,17.86
桃園市,桃園區,中寧里,2408,1297,1111,18,2426,6089,0,39.84,21.3
桃園市,桃園區,同安里,3882,1926,1956,25,3907,9540,0,40.95,20.19
桃園市,桃園區,莊敬里,3702,2094,1608,27,3729,8779,0,42.48,23.85
桃園市,桃園區,文中里,1764,878,886,13,1777,3991,0,44.53,22.0
桃園市,桃園區,泰山里,1630,831,799,22,1652,3653,0,45.22,22.75
桃園市,桃園區,中路里,1597,818,779,23,1620,3883,0,41.72,21.07
桃園市,桃園區,中德里,2675,1318,1357,22,2697,6452,0,41.8,20.43
桃園市,桃園區,龍祥里,1821,1043,778,16,1837,4939,0,37.19,21.12
桃園市,桃園區,大有里,2394,1316,1078,20,2414,6433,0,37.53,20.46
桃園市,桃園區,寶山里,3153,1666,1487,26,3179,8491,0,37.44,19.62
桃園市,桃園區,龍鳳里,2979,1583,1396,21,3000,9776,0,30.69,16.19
桃園市,桃園區,龍安里,2100,1089,1011,17,2117,5408,0,39.15,20.14
桃園市,桃園區,自強里,3216,1693,1523,40,3256,7355,0,44.27,23.02
桃園市,桃園區,中信里,2208,1131,1077,18,2226,5612,0,39.67,20.15
桃園市,桃園區,長德里,2201,1003,1198,9,2210,4931,0,44.82,20.34
桃園市,桃園區,中平里,1955,1008,947,17,1972,4612,0,42.76,21.86
桃園市,桃園區,中原里,2015,1090,925,18,2033,4570,0,44.49,23.85
桃園市,桃園區,中泰里,1826,1021,805,16,1842,4145,0,44.44,24.63
桃園市,桃園區,南埔里,2094,986,1108,24,2118,4872,0,43.47,20.24
桃園市,桃園區,寶慶里,2560,1360,1200,24,2584,6169,0,41.89,22.05
桃園市,桃園區,北埔里,1907,993,914,23,1930,4734,0,40.77,20.98
桃園市,桃園區,中聖里,2309,1352,957,21,2330,5481,0,42.51,24.67
桃園市,桃園區,龍壽里,2468,1217,1251,21,2489,6540,0,38.06,18.61
桃園市,桃園區,同德里,2582,1405,1177,22,2604,6061,0,42.96,23.18
桃園市,桃園區,明德里,1445,760,685,13,1458,3179,0,45.86,23.91
桃園市,桃園區,寶安里,3086,1637,1449,31,3117,8113,0,38.42,20.18
桃園市,桃園區,瑞慶里,2261,1175,1086,16,2277,5936,0,38.36,19.79
桃園市,桃園區,三元里,1531,780,751,12,1543,3791,0,40.7,20.58
桃園市,桃園區,大樹里,1496,688,808,7,1503,3881,0,38.73,17.73
桃園市,桃園區,大業里,1995,1022,973,22,2017,5006,0,40.29,20.42
桃園市,桃園區,福元里,1829,945,884,10,1839,4546,0,40.45,20.79
桃園市,桃園區,合計,153899,76543,77356,1361,155260,375012,458824,41.4,20.41
桃園市,中壢區,龍平里,1278,969,309,20,1298,2898,0,44.79,33.44
桃園市,中壢區,龍昌里,2249,1420,829,20,2269,5428,0,41.8,26.16
桃園市,中壢區,仁德里,1274,807,467,19,1293,3064,0,42.2,26.34
桃園市,中壢區,永興里,392,197,195,4,396,914,0,43.33,21.55
桃園市,中壢區,內壢里,912,550,362,12,924,2196,0,42.08,25.05
桃園市,中壢區,成功里,1744,1013,731,16,1760,4380,0,40.18,23.13
桃園市,中壢區,光明里,2377,1320,1057,29,2406,5320,0,45.23,24.81
桃園市,中壢區,自立里,2332,1909,423,26,2358,5087,0,46.35,37.53
桃園市,中壢區,自強里,1529,1002,527,11,1540,3497,0,44.04,28.65
桃園市,中壢區,中堅里,1509,977,532,9,1518,3778,0,40.18,25.86
桃園市,中壢區,龍興里,1784,977,807,19,1803,4305,0,41.88,22.69
桃園市,中壢區,仁美里,2208,1310,898,12,2220,5566,0,39.89,23.54
桃園市,中壢區,仁愛里,1295,718,577,7,1302,3006,0,43.31,23.89
桃園市,中壢區,新街里,981,509,472,6,987,2310,0,42.73,22.03
桃園市,中壢區,中央里,1637,852,785,10,1647,3407,0,48.34,25.01
桃園市,中壢區,普仁里,1618,914,704,11,1629,4240,0,38.42,21.56
桃園市,中壢區,普義里,1724,989,735,24,1748,5599,0,31.22,17.66
桃園市,中壢區,忠義里,1578,857,721,9,1587,3943,0,40.25,21.73
桃園市,中壢區,中正里,1985,1237,748,14,1999,5241,0,38.14,23.6
桃園市,中壢區,興仁里,1277,744,533,9,1286,3393,0,37.9,21.93
桃園市,中壢區,東興里,1474,761,713,21,1495,3315,0,45.1,22.96
桃園市,中壢區,洽溪里,2801,1359,1442,26,2827,6960,0,40.62,19.53
桃園市,中壢區,篤行里,1002,572,430,8,1010,2660,0,37.97,21.5
桃園市,中壢區,新明里,1580,725,855,12,1592,3765,0,42.28,19.26
桃園市,中壢區,新興里,1543,839,704,11,1554,3646,0,42.62,23.01
桃園市,中壢區,中原里,1561,845,716,7,1568,3654,0,42.91,23.13
桃園市,中壢區,內定里,2456,1091,1365,16,2472,6882,0,35.92,15.85
桃園市,中壢區,中壢里,293,146,147,2,295,674,0,43.77,21.66
桃園市,中壢區,龍岡里,1997,1314,683,24,2021,4607,0,43.87,28.52
桃園市,中壢區,仁祥里,1057,699,358,15,1072,2813,0,38.11,24.85
桃園市,中壢區,水尾里,1503,725,778,12,1515,3634,0,41.69,19.95
桃園市,中壢區,青埔里,2629,1314,1315,16,2645,6486,0,40.78,20.26
桃園市,中壢區,復興里,3482,1922,1560,28,3510,9665,0,36.32,19.89
桃園市,中壢區,文化里,3401,1750,1651,20,3421,8837,0,38.71,19.8
桃園市,中壢區,興國里,854,393,461,9,863,1888,0,45.71,20.82
桃園市,中壢區,忠福里,3161,1682,1479,27,3188,7822,0,40.76,21.5
桃園市,中壢區,信義里,1981,1117,864,10,1991,4334,0,45.94,25.77
桃園市,中壢區,石頭里,702,323,379,5,707,1585,0,44.61,20.38
桃園市,中壢區,龍東里,2062,1563,499,21,2083,4952,0,42.06,31.56
桃園市,中壢區,中建里,449,183,266,2,451,991,0,45.51,18.47
桃園市,中壢區,興南里,1273,726,547,19,1292,3012,0,42.9,24.1
桃園市,中壢區,後寮里,1831,1035,796,16,1847,4849,0,38.09,21.34
桃園市,中壢區,過嶺里,3004,1397,1607,33,3037,7935,0,38.27,17.61
桃園市,中壢區,五權里,2551,1244,1307,23,2574,6137,0,41.94,20.27
桃園市,中壢區,舊明里,702,311,391,11,713,1460,0,48.84,21.3
桃園市,中壢區,芝芭里,1710,708,1002,15,1725,4196,0,41.11,16.87
桃園市,中壢區,月眉里,2094,705,1389,26,2120,5631,0,37.65,12.52
桃園市,中壢區,三民里,1268,548,720,8,1276,3254,0,39.21,16.84
桃園市,中壢區,山東里,1473,470,1003,15,1488,3746,0,39.72,12.55
桃園市,中壢區,中榮里,381,175,206,5,386,827,0,46.67,21.16
桃園市,中壢區,內厝里,2045,852,1193,15,2060,4787,0,43.03,17.8
桃園市,中壢區,振興里,2097,1205,892,22,2119,4813,0,44.03,25.04
桃園市,中壢區,普慶里,1147,666,481,7,1154,2583,0,44.68,25.78
桃園市,中壢區,興和里,1226,542,684,9,1235,2700,0,45.74,20.07
桃園市,中壢區,永光里,2218,1114,1104,17,2235,5435,0,41.12,20.5
桃園市,中壢區,復華里,2226,1217,1009,19,2245,5563,0,40.36,21.88
桃園市,中壢區,忠孝里,1866,1056,810,21,1887,4591,0,41.1,23.0
桃園市,中壢區,福德里,1213,680,533,10,1223,2834,0,43.15,23.99
桃園市,中壢區,和平里,1007,548,459,2,1009,2525,0,39.96,21.7
桃園市,中壢區,普忠里,1452,813,639,7,1459,3252,0,44.86,25.0
桃園市,中壢區,普強里,1689,1012,677,10,1699,3683,0,46.13,27.48
桃園市,中壢區,明德里,2032,1112,920,13,2045,4693,0,43.58,23.69
桃園市,中壢區,至善里,1420,954,466,14,1434,3713,0,38.62,25.69
桃園市,中壢區,五福里,1486,700,786,15,1501,3620,0,41.46,19.34
桃園市,中壢區,龍德里,1771,1066,705,16,1787,4104,0,43.54,25.97
桃園市,中壢區,正義里,1913,1019,894,13,1926,4282,0,44.98,23.8
桃園市,中壢區,龍安里,1012,762,250,8,1020,2050,0,49.76,37.17
桃園市,中壢區,中山里,1833,1139,694,13,1846,4761,0,38.77,23.92
桃園市,中壢區,德義里,1126,611,515,14,1140,2501,0,45.58,24.43
桃園市,中壢區,仁義里,1596,832,764,13,1609,3783,0,42.53,21.99
桃園市,中壢區,華勛里,1479,1040,439,17,1496,3965,0,37.73,26.23
桃園市,中壢區,仁福里,1839,1193,646,19,1858,4804,0,38.68,24.83
桃園市,中壢區,幸福里,2441,1271,1170,24,2465,6095,0,40.44,20.85
桃園市,中壢區,永福里,2434,1220,1214,14,2448,5469,0,44.76,22.31
桃園市,中壢區,仁和里,1386,856,530,14,1400,3582,0,39.08,23.9
桃園市,中壢區,華愛里,1357,855,502,14,1371,3555,0,38.57,24.05
桃園市,中壢區,莊敬里,1621,1236,385,19,1640,3413,0,48.05,36.21
桃園市,中壢區,自治里,1653,1240,413,14,1667,3620,0,46.05,34.25
桃園市,中壢區,健行里,1906,1092,814,20,1926,4454,0,43.24,24.52
桃園市,中壢區,興平里,1154,521,633,2,1156,2395,0,48.27,21.75
桃園市,中壢區,中興里,1352,877,475,10,1362,3376,0,40.34,25.98
桃園市,中壢區,龍慈里,2009,1278,731,13,2022,4787,0,42.24,26.7
桃園市,中壢區,自信里,2297,1435,862,14,2311,5590,0,41.34,25.67
桃園市,中壢區,林森里,1702,988,714,11,1713,3821,0,44.83,25.86
桃園市,中壢區,金華里,2073,1260,813,19,2092,4035,0,51.85,31.23
桃園市,中壢區,合計,143036,80175,62861,1232,144268,347023,422582,41.57,23.1
桃園市,大溪區,興和里,669,234,435,7,676,1435,0,47.11,16.31
桃園市,大溪區,福仁里,453,146,307,4,457,963,0,47.46,15.16
桃園市,大溪區,一心里,1822,779,1043,12,1834,4760,0,38.53,16.37
桃園市,大溪區,一德里,1999,748,1251,24,2023,5582,0,36.24,13.4
桃園市,大溪區,月眉里,475,131,344,9,484,1237,0,39.13,10.59
桃園市,大溪區,永福里,431,113,318,5,436,964,0,45.23,11.72
桃園市,大溪區,美華里,1234,413,821,11,1245,3069,0,40.57,13.46
桃園市,大溪區,福安里,892,280,612,15,907,2222,0,40.82,12.6
桃園市,大溪區,復興里,346,121,225,7,353,859,0,41.09,14.09
桃園市,大溪區,新峰里,301,111,190,8,309,808,0,38.24,13.74
桃園市,大溪區,康安里,579,163,416,8,587,1300,0,45.15,12.54
桃園市,大溪區,義和里,720,245,475,11,731,1752,0,41.72,13.98
桃園市,大溪區,瑞興里,1003,376,627,10,1013,2714,0,37.32,13.85
桃園市,大溪區,中新里,672,234,438,8,680,1519,0,44.77,15.4
桃園市,大溪區,仁義里,1060,733,327,18,1078,2831,0,38.08,25.89
桃園市,大溪區,僑愛里,1091,898,193,8,1099,2488,0,44.17,36.09
桃園市,大溪區,仁善里,1780,855,925,13,1793,4490,0,39.93,19.04
桃園市,大溪區,仁愛里,1946,930,1016,22,1968,5178,0,38.01,17.96
桃園市,大溪區,仁武里,1264,676,588,13,1277,3244,0,39.36,20.84
桃園市,大溪區,員林里,601,289,312,2,603,1577,0,38.24,18.33
桃園市,大溪區,南興里,1777,789,988,30,1807,5101,0,35.42,15.47
桃園市,大溪區,瑞源里,1451,633,818,9,1460,3734,0,39.1,16.95
桃園市,大溪區,光明里,922,576,346,20,942,2437,0,38.65,23.64
桃園市,大溪區,三元里,1193,791,402,20,1213,3012,0,40.27,26.26
桃園市,大溪區,田心里,1848,681,1167,17,1865,4436,0,42.04,15.35
桃園市,大溪區,仁文里,1469,786,683,18,1487,3897,0,38.16,20.17
桃園市,大溪區,仁和里,1813,907,906,20,1833,4772,0,38.41,19.01
桃園市,大溪區,仁美里,1239,665,574,16,1255,3309,0,37.93,20.1
桃園市,大溪區,合計,31050,14303,16747,365,31415,79690,95240,39.42,17.95
桃園市,楊梅區,楊梅里,1576,914,662,8,1584,3845,0,41.2,23.77
桃園市,楊梅區,楊江里,469,275,194,5,474,1054,0,44.97,26.09
桃園市,楊梅區,紅梅里,1090,641,449,10,1100,2595,0,42.39,24.7
桃園市,楊梅區,永寧里,2462,1363,1099,20,2482,7481,0,33.18,18.22
桃園市,楊梅區,大平里,1134,684,450,10,1144,3148,0,36.34,21.73
桃園市,楊梅區,東流里,985,440,545,11,996,2934,0,33.95,15.0
桃園市,楊梅區,水美里,1609,845,764,11,1620,4097,0,39.54,20.62
桃園市,楊梅區,上田里,971,451,520,11,982,2632,0,37.31,17.14
桃園市,楊梅區,梅新里,796,470,326,6,802,1933,0,41.49,24.31
桃園市,楊梅區,大同里,1427,852,575,17,1444,3487,0,41.41,24.43
桃園市,楊梅區,埔心里,658,314,344,12,670,1355,0,49.45,23.17
桃園市,楊梅區,金龍里,561,390,171,12,573,1396,0,41.05,27.94
桃園市,楊梅區,瑞塘里,2152,1135,1017,19,2171,5757,0,37.71,19.72
桃園市,楊梅區,四維里,1900,1151,749,17,1917,4609,0,41.59,24.97
桃園市,楊梅區,梅溪里,1459,834,625,12,1471,4143,0,35.51,20.13
桃園市,楊梅區,高山里,1252,745,507,9,1261,3760,0,33.54,19.81
桃園市,楊梅區,高榮里,1373,638,735,14,1387,3518,0,39.43,18.14
桃園市,楊梅區,仁美里,1654,956,698,14,1668,3818,0,43.69,25.04
桃園市,楊梅區,光華里,1306,812,494,16,1322,3153,0,41.93,25.75
桃園市,楊梅區,富岡里,696,394,302,7,703,1787,0,39.34,22.05
桃園市,楊梅區,豐野里,1458,797,661,9,1467,3873,0,37.88,20.58
桃園市,楊梅區,員本里,1054,552,502,16,1070,2859,0,37.43,19.31
桃園市,楊梅區,瑞原里,1190,692,498,19,1209,3757,0,32.18,18.42
桃園市,楊梅區,三湖里,969,476,493,8,977,2794,0,34.97,17.04
桃園市,楊梅區,上湖里,1954,1090,864,14,1968,5853,0,33.62,18.62
桃園市,楊梅區,中山里,1209,694,515,6,1215,2986,0,40.69,23.24
桃園市,楊梅區,楊明里,2752,1556,1196,13,2765,7742,0,35.71,20.1
桃園市,楊梅區,金溪里,1650,1009,641,16,1666,4048,0,41.16,24.93
桃園市,楊梅區,裕成里,1478,912,566,12,1490,3286,0,45.34,27.75
桃園市,楊梅區,秀才里,1331,663,668,13,1344,3311,0,40.59,20.02
桃園市,楊梅區,青山里,1431,854,577,10,1441,4482,0,32.15,19.05
桃園市,楊梅區,新榮里,1418,731,687,14,1432,3453,0,41.47,21.17
桃園市,楊梅區,雙榮里,1420,728,692,9,1429,3233,0,44.2,22.52
桃園市,楊梅區,瑞坪里,2088,1250,838,16,2104,5934,0,35.46,21.07
桃園市,楊梅區,永平里,742,439,303,7,749,1966,0,38.1,22.33
桃園市,楊梅區,瑞溪里,1185,702,483,8,1193,3639,0,32.78,19.29
桃園市,楊梅區,高上里,972,481,491,7,979,2766,0,35.39,17.39
桃園市,楊梅區,富豐里,1023,522,501,10,1033,3030,0,34.09,17.23
桃園市,楊梅區,裕新里,853,536,317,2,855,2486,0,34.39,21.56
桃園市,楊梅區,三民里,1194,708,486,7,1201,3449,0,34.82,20.53
桃園市,楊梅區,頭湖里,1016,568,448,14,1030,2900,0,35.52,19.59
桃園市,楊梅區,合計,53917,30264,23653,471,54388,144349,176189,37.68,20.97
桃園市,蘆竹區,新興里,1243,413,830,15,1258,2950,0,42.64,14.0
桃園市,蘆竹區,中福里,1651,567,1084,17,1668,4062,0,41.06,13.96
桃園市,蘆竹區,新莊里,1992,807,1185,18,2010,5043,0,39.86,16.0
桃園市,蘆竹區,大竹里,1933,903,1030,17,1950,4969,0,39.24,18.17
桃園市,蘆竹區,蘆竹里,1571,523,1048,16,1587,4036,0,39.32,12.96
桃園市,蘆竹區,南崁里,1536,721,815,13,1549,3675,0,42.15,19.62
桃園市,蘆竹區,錦興里,1608,780,828,12,1620,3906,0,41.47,19.97
桃園市,蘆竹區,五福里,1021,502,519,5,1026,2425,0,42.31,20.7
桃園市,蘆竹區,內厝里,919,321,598,6,925,2595,0,35.65,12.37
桃園市,蘆竹區,山鼻里,594,240,354,9,603,1778,0,33.91,13.5
桃園市,蘆竹區,山腳里,1309,412,897,18,1327,3579,0,37.08,11.51
桃園市,蘆竹區,外社里,619,150,469,11,630,1486,0,42.4,10.09
桃園市,蘆竹區,坑子里,617,160,457,7,624,1673,0,37.3,9.56
桃園市,蘆竹區,坑口里,981,320,661,4,985,2501,0,39.38,12.79
桃園市,蘆竹區,海湖里,926,430,496,13,939,2969,0,31.63,14.48
桃園市,蘆竹區,南榮里,1520,722,798,21,1541,3532,0,43.63,20.44
桃園市,蘆竹區,南興里,2191,1126,1065,12,2203,5162,0,42.68,21.81
桃園市,蘆竹區,長興里,857,383,474,12,869,2582,0,33.66,14.83
桃園市,蘆竹區,錦中里,1321,592,729,13,1334,3128,0,42.65,18.93
桃園市,蘆竹區,富竹里,574,146,428,7,581,1327,0,43.78,11.0
桃園市,蘆竹區,上竹里,1429,635,794,11,1440,3516,0,40.96,18.06
桃園市,蘆竹區,宏竹里,1164,449,715,15,1179,2982,0,39.54,15.06
桃園市,蘆竹區,瓦窯里,1276,706,570,14,1290,3360,0,38.39,21.01
桃園市,蘆竹區,營盤里,1939,1000,939,16,1955,4886,0,40.01,20.47
桃園市,蘆竹區,羊稠里,1917,932,985,11,1928,4459,0,43.24,20.9
桃園市,蘆竹區,順興里,1516,739,777,9,1525,3985,0,38.27,18.54
桃園市,蘆竹區,福昌里,1960,1055,905,13,1973,5062,0,38.98,20.84
桃園市,蘆竹區,福興里,1352,660,692,7,1359,3442,0,39.48,19.17
桃園市,蘆竹區,蘆興里,594,265,329,6,600,1633,0,36.74,16.23
桃園市,蘆竹區,長壽里,2344,1228,1116,15,2359,5584,0,42.25,21.99
桃園市,蘆竹區,吉祥里,1748,967,781,23,1771,3690,0,47.99,26.21
桃園市,蘆竹區,中山里,1227,639,588,9,1236,3243,0,38.11,19.7
桃園市,蘆竹區,福祿里,1177,524,653,7,1184,3227,0,36.69,16.24
桃園市,蘆竹區,興榮里,1232,629,603,8,1240,2793,0,44.4,22.52
桃園市,蘆竹區,中興里,1812,892,920,13,1825,5074,0,35.97,17.58
桃園市,蘆竹區,上興里,1373,653,720,6,1379,3380,0,40.8,19.32
桃園市,蘆竹區,營福里,1279,636,643,10,1289,3296,0,39.11,19.3
桃園市,蘆竹區,正興里,1512,701,811,8,1520,4443,0,34.21,15.78
桃園市,蘆竹區,濱海里,764,315,449,8,772,2532,0,30.49,12.44
桃園市,蘆竹區,合計,52598,23843,28755,455,53053,133965,166690,39.6,17.8
桃園市,大園區,大園里,2333,1013,1320,23,2356,6107,0,38.58,16.59
桃園市,大園區,田心里,2514,1065,1449,24,2538,6972,0,36.4,15.28
桃園市,大園區,溪海里,1479,624,855,12,1491,4705,0,31.69,13.26
桃園市,大園區,和平里,640,212,428,6,646,1612,0,40.07,13.15
桃園市,大園區,橫峰里,4561,2109,2452,43,4604,11610,0,39.66,18.17
桃園市,大園區,五權里,1985,676,1309,13,1998,5222,0,38.26,12.95
桃園市,大園區,埔心里,2156,874,1282,12,2168,5896,0,36.77,14.82
桃園市,大園區,大海里,652,347,305,10,662,1650,0,40.12,21.03
桃園市,大園區,三石里,1203,469,734,12,1215,2851,0,42.62,16.45
桃園市,大園區,菓林里,2483,1084,1399,32,2515,7202,0,34.92,15.05
桃園市,大園區,竹圍里,1192,542,650,8,1200,3212,0,37.36,16.87
桃園市,大園區,海口里,597,285,312,10,607,1863,0,32.58,15.3
桃園市,大園區,沙崙里,879,390,489,10,889,2595,0,34.26,15.03
桃園市,大園區,後厝里,816,366,450,6,822,2523,0,32.58,14.51
桃園市,大園區,圳頭里,945,364,581,9,954,2566,0,37.18,14.19
桃園市,大園區,內海里,754,289,465,8,762,2154,0,35.38,13.42
桃園市,大園區,北港里,958,360,598,13,971,2912,0,33.34,12.36
桃園市,大園區,南港里,1733,802,931,12,1745,5701,0,30.61,14.07
桃園市,大園區,合計,27880,11871,16009,263,28143,77353,93663,36.38,15.35
桃園市,龜山區,楓樹里,1702,733,969,9,1711,3984,0,42.95,18.4
桃園市,龜山區,龜山里,2585,1243,1342,20,2605,6579,0,39.6,18.89
桃園市,龜山區,兔坑里,1564,703,861,8,1572,4492,0,35.0,15.65
桃園市,龜山區,大同里,2214,1050,1164,24,2238,5834,0,38.36,18.0
桃園市,龜山區,山福里,1265,587,678,16,1281,3262,0,39.27,18.0
桃園市,龜山區,山頂里,1962,965,997,14,1976,5439,0,36.33,17.74
桃園市,龜山區,陸光里,1775,1523,252,26,1801,3606,0,49.94,42.24
桃園市,龜山區,精忠里,2147,1426,721,36,2183,5179,0,42.15,27.53
桃園市,龜山區,公西里,627,271,356,6,633,1298,0,48.77,20.88
桃園市,龜山區,樂善里,1921,836,1085,14,1935,5523,0,35.04,15.14
桃園市,龜山區,南上里,794,327,467,6,800,1874,0,42.69,17.45
桃園市,龜山區,大坑里,725,290,435,7,732,1975,0,37.06,14.68
桃園市,龜山區,中興里,1793,891,902,16,1809,4708,0,38.42,18.93
桃園市,龜山區,山德里,1975,879,1096,25,2000,4790,0,41.75,18.35
桃園市,龜山區,新路里,2288,1078,1210,27,2315,5265,0,43.97,20.47
桃園市,龜山區,嶺頂里,1510,654,856,17,1527,4034,0,37.85,16.21
桃園市,龜山區,龍壽里,691,226,465,5,696,1760,0,39.55,12.84
桃園市,龜山區,舊路里,1147,558,589,14,1161,2636,0,44.04,21.17
桃園市,龜山區,大崗里,1403,662,741,13,1416,4111,0,34.44,16.1
桃園市,龜山區,文化里,2727,1375,1352,24,2751,6959,0,39.53,19.76
桃園市,龜山區,南美里,911,408,503,7,918,2303,0,39.86,17.72
桃園市,龜山區,幸福里,1683,839,844,23,1706,5268,0,32.38,15.93
桃園市,龜山區,福源里,783,392,391,8,791,1960,0,40.36,20.0
桃園市,龜山區,龍華里,1335,586,749,14,1349,3423,0,39.41,17.12
桃園市,龜山區,迴龍里,2355,1110,1245,18,2373,6098,0,38.91,18.2
桃園市,龜山區,新嶺里,1407,646,761,10,1417,3965,0,35.74,16.29
桃園市,龜山區,大湖里,2036,1015,1021,20,2056,5410,0,38.0,18.76
桃園市,龜山區,大華里,3524,1665,1859,29,3553,8945,0,39.72,18.61
桃園市,龜山區,長庚里,1768,755,1013,11,1779,4161,0,42.75,18.14
桃園市,龜山區,新興里,931,582,349,11,942,3071,0,30.67,18.95
桃園市,龜山區,文青里,3128,1674,1454,24,3152,7571,0,41.63,22.11
桃園市,龜山區,楓福里,1372,698,674,10,1382,3109,0,44.45,22.45
桃園市,龜山區,合計,54048,26647,27401,512,54560,138592,165716,39.37,19.23
桃園市,八德區,興仁里,2936,1496,1440,24,2960,9275,0,31.91,16.13
桃園市,八德區,福興里,3370,1667,1703,22,3392,9960,0,34.06,16.74
桃園市,八德區,瑞豐里,1670,904,766,8,1678,4926,0,34.06,18.35
桃園市,八德區,瑞發里,1319,759,560,34,1353,3178,0,42.57,23.88
桃園市,八德區,瑞德里,1341,833,508,27,1368,3521,0,38.85,23.66
桃園市,八德區,瑞祥里,1299,869,430,22,1321,3201,0,41.27,27.15
桃園市,八德區,廣興里,1267,581,686,9,1276,3233,0,39.47,17.97
桃園市,八德區,廣隆里,1946,1020,926,19,1965,4536,0,43.32,22.49
桃園市,八德區,竹園里,1251,606,645,17,1268,3596,0,35.26,16.85
桃園市,八德區,霄裡里,823,373,450,13,836,2214,0,37.76,16.85
桃園市,八德區,茄苳里,927,396,531,4,931,2537,0,36.7,15.61
桃園市,八德區,高明里,1490,682,808,14,1504,3852,0,39.04,17.71
桃園市,八德區,白鷺里,1265,570,695,14,1279,3101,0,41.24,18.38
桃園市,八德區,大湳里,1471,633,838,12,1483,3930,0,37.74,16.11
桃園市,八德區,大安里,1370,579,791,17,1387,3486,0,39.79,16.61
桃園市,八德區,大興里,1514,744,770,9,1523,3792,0,40.16,19.62
桃園市,八德區,大和里,3003,1778,1225,35,3038,7352,0,41.32,24.18
桃園市,八德區,大同里,664,290,374,1,665,1505,0,44.19,19.27
桃園市,八德區,大成里,1425,669,756,12,1437,3312,0,43.39,20.2
桃園市,八德區,大義里,1451,813,638,15,1466,3738,0,39.22,21.75
桃園市,八德區,大忠里,714,369,345,6,720,1789,0,40.25,20.63
桃園市,八德區,大福里,2319,1187,1132,17,2336,5181,0,45.09,22.91
桃園市,八德區,大勇里,1688,819,869,14,1702,4113,0,41.38,19.91
桃園市,八德區,大信里,1269,695,574,30,1299,3515,0,36.96,19.77
桃園市,八德區,大華里,1063,561,502,7,1070,2531,0,42.28,22.17
桃園市,八德區,大仁里,1749,772,977,15,1764,4188,0,42.12,18.43
桃園市,八德區,大智里,1789,1098,691,16,1805,4256,0,42.41,25.8
桃園市,八德區,瑞泰里,1578,769,809,11,1589,4161,0,38.19,18.48
桃園市,八德區,大昌里,1184,622,562,21,1205,2848,0,42.31,21.84
桃園市,八德區,大正里,1631,837,794,15,1646,4290,0,38.37,19.51
桃園市,八德區,大強里,1332,567,765,18,1350,3074,0,43.92,18.45
桃園市,八德區,大發里,808,361,447,8,816,2030,0,40.2,17.78
桃園市,八德區,大明里,1462,651,811,13,1475,3632,0,40.61,17.92
桃園市,八德區,大竹里,607,230,377,3,610,1474,0,41.38,15.6
桃園市,八德區,大慶里,554,267,287,8,562,1414,0,39.75,18.88
桃園市,八德區,大千里,845,482,363,8,853,2222,0,38.39,21.69
桃園市,八德區,大榮里,762,369,393,13,775,1947,0,39.8,18.95
桃園市,八德區,茄明里,1776,929,847,13,1789,4778,0,37.44,19.44
桃園市,八德區,高城里,1235,622,613,7,1242,3114,0,39.88,19.97
桃園市,八德區,瑞興里,1121,491,630,12,1133,2788,0,40.64,17.61
桃園市,八德區,大愛里,1065,585,480,15,1080,2512,0,42.99,23.29
桃園市,八德區,大宏里,1786,977,809,12,1798,4144,0,43.39,23.58
桃園市,八德區,大漢里,1536,860,676,9,1545,3923,0,39.38,21.92
桃園市,八德區,廣德里,1201,567,634,12,1213,2667,0,45.48,21.26
桃園市,八德區,龍友里,951,728,223,13,964,2166,0,44.51,33.61
桃園市,八德區,陸光里,1728,1350,378,31,1759,4338,0,40.55,31.12
桃園市,八德區,永豐里,1062,496,566,14,1076,2762,0,38.96,17.96
桃園市,八德區,大順里,1016,521,495,4,1020,2525,0,40.4,20.63
桃園市,八德區,合計,67633,35044,32589,693,68326,172627,209448,39.58,20.3
桃園市,龍潭區,黃唐里,1691,850,841,13,1704,4655,0,36.61,18.26
桃園市,龍潭區,中山里,2295,1287,1008,20,2315,5884,0,39.34,21.87
桃園市,龍潭區,烏林里,1491,830,661,11,1502,4416,0,34.01,18.8
桃園市,龍潭區,高平里,1196,578,618,8,1204,3205,0,37.57,18.03
桃園市,龍潭區,凌雲里,1323,735,588,11,1334,3744,0,35.63,19.63
桃園市,龍潭區,八德里,1577,845,732,12,1589,4226,0,37.6,20.0
桃園市,龍潭區,三水里,281,88,193,2,283,652,0,43.4,13.5
桃園市,龍潭區,上林里,1718,907,811,9,1727,4406,0,39.2,20.59
桃園市,龍潭區,中正里,2147,1371,776,16,2163,5430,0,39.83,25.25
桃園市,龍潭區,龍潭里,836,415,421,5,841,1835,0,45.83,22.62
桃園市,龍潭區,高原里,1620,821,799,23,1643,4539,0,36.2,18.09
桃園市,龍潭區,九龍里,1441,851,590,12,1453,3741,0,38.84,22.75
桃園市,龍潭區,中興里,1573,960,613,11,1584,4232,0,37.43,22.68
桃園市,龍潭區,佳安里,1567,1041,526,16,1583,3420,0,46.29,30.44
桃園市,龍潭區,三和里,1187,719,468,7,1194,2574,0,46.39,27.93
桃園市,龍潭區,三坑里,606,268,338,8,614,1466,0,41.88,18.28
桃園市,龍潭區,大平里,1033,562,471,6,1039,2332,0,44.55,24.1
桃園市,龍潭區,三林里,1449,925,524,11,1460,3072,0,47.53,30.11
桃園市,龍潭區,永興里,1079,575,504,12,1091,2825,0,38.62,20.35
桃園市,龍潭區,烏樹林里,1011,498,513,8,1019,2613,0,39.0,19.06
桃園市,龍潭區,百年里,1964,1373,591,16,1980,4262,0,46.46,32.21
桃園市,龍潭區,龍祥里,1285,765,520,7,1292,3487,0,37.05,21.94
桃園市,龍潭區,聖德里,1137,558,579,8,1145,2995,0,38.23,18.63
桃園市,龍潭區,龍星里,1832,1081,751,19,1851,4094,0,45.21,26.4
桃園市,龍潭區,上華里,1383,888,495,16,1399,3238,0,43.21,27.42
桃園市,龍潭區,武漢里,556,343,213,6,562,1491,0,37.69,23.0
桃園市,龍潭區,東興里,1464,987,477,21,1485,3992,0,37.2,24.72
桃園市,龍潭區,北興里,771,483,288,10,781,2314,0,33.75,20.87
桃園市,龍潭區,建林里,1784,1257,527,9,1793,3664,0,48.94,34.31
桃園市,龍潭區,富林里,1436,960,476,17,1453,3448,0,42.14,27.84
桃園市,龍潭區,祥和里,480,236,244,8,488,1583,0,30.83,14.91
桃園市,龍潭區,合計,41213,24057,17156,358,41571,103835,124481,40.04,23.17
桃園市,平鎮區,雙連里,1804,947,857,20,1824,4741,0,38.47,19.97
桃園市,平鎮區,高雙里,1909,879,1030,10,1919,4288,0,44.75,20.5
桃園市,平鎮區,復旦里,2289,1287,1002,12,2301,5412,0,42.52,23.78
桃園市,平鎮區,廣興里,2508,1303,1205,21,2529,5467,0,46.26,23.83
桃園市,平鎮區,義民里,2049,1156,893,18,2067,5228,0,39.54,22.11
桃園市,平鎮區,宋屋里,1664,868,796,21,1685,4332,0,38.9,20.04
桃園市,平鎮區,新勢里,1579,800,779,16,1595,3659,0,43.59,21.86
桃園市,平鎮區,新富里,2363,1311,1052,28,2391,6520,0,36.67,20.11
桃園市,平鎮區,北勢里,1163,564,599,7,1170,2424,0,48.27,23.27
桃園市,平鎮區,北興里,1574,774,800,13,1587,3911,0,40.58,19.79
桃園市,平鎮區,北貴里,1701,854,847,12,1713,3974,0,43.11,21.49
桃園市,平鎮區,平鎮里,1670,845,825,18,1688,4457,0,37.87,18.96
桃園市,平鎮區,南勢里,2264,1215,1049,15,2279,5771,0,39.49,21.05
桃園市,平鎮區,莊敬里,1890,1156,734,34,1924,4674,0,41.16,24.73
桃園市,平鎮區,山峰里,908,547,361,7,915,2330,0,39.27,23.48
桃園市,平鎮區,湧光里,2114,1193,921,22,2136,5189,0,41.16,22.99
桃園市,平鎮區,龍恩里,1115,735,380,14,1129,2791,0,40.45,26.33
桃園市,平鎮區,東社里,1305,857,448,11,1316,3322,0,39.61,25.8
桃園市,平鎮區,龍興里,1067,761,306,15,1082,2548,0,42.46,29.87
桃園市,平鎮區,貿易里,918,615,303,10,928,1945,0,47.71,31.62
桃園市,平鎮區,忠貞里,601,430,171,4,605,1318,0,45.9,32.63
桃園市,平鎮區,中正里,699,518,181,15,714,1650,0,43.27,31.39
桃園市,平鎮區,建安里,1719,863,856,18,1737,4292,0,40.47,20.11
桃園市,平鎮區,東勢里,2053,972,1081,22,2075,5410,0,38.35,17.97
桃園市,平鎮區,東安里,1017,659,358,6,1023,2812,0,36.38,23.44
桃園市,平鎮區,新安里,1594,941,653,23,1617,4358,0,37.1,21.59
桃園市,平鎮區,鎮興里,1196,559,637,19,1215,3084,0,39.4,18.13
桃園市,平鎮區,義興里,2956,1516,1440,19,2975,6850,0,43.43,22.13
桃園市,平鎮區,湧豐里,711,390,321,9,720,1755,0,41.03,22.22
桃園市,平鎮區,湧安里,1546,900,646,10,1556,4511,0,34.49,19.95
桃園市,平鎮區,廣達里,1698,805,893,21,1719,3871,0,44.41,20.8
桃園市,平鎮區,福林里,1435,764,671,14,1449,3429,0,42.26,22.28
桃園市,平鎮區,金星里,2436,1367,1069,24,2460,6586,0,37.35,20.76
桃園市,平鎮區,廣仁里,1529,792,737,12,1541,4222,0,36.5,18.76
桃園市,平鎮區,新貴里,1359,660,699,21,1380,3064,0,45.04,21.54
桃園市,平鎮區,北富里,1667,817,850,15,1682,3878,0,43.37,21.07
桃園市,平鎮區,新榮里,2249,1196,1053,19,2268,5110,0,44.38,23.41
桃園市,平鎮區,華安里,1520,985,535,16,1536,4282,0,35.87,23.0
桃園市,平鎮區,金陵里,1264,702,562,11,1275,2823,0,45.16,24.87
桃園市,平鎮區,北安里,733,336,397,3,736,1551,0,47.45,21.66
桃園市,平鎮區,北華里,1725,989,736,11,1736,3758,0,46.19,26.32
桃園市,平鎮區,復興里,2197,1140,1057,20,2217,4904,0,45.21,23.25
桃園市,平鎮區,平興里,2181,1219,962,16,2197,5498,0,39.96,22.17
桃園市,平鎮區,新英里,1599,971,628,15,1614,3806,0,42.41,25.51
桃園市,平鎮區,平安里,2021,1069,952,26,2047,5085,0,40.26,21.02
桃園市,平鎮區,平南里,2620,1415,1205,21,2641,6707,0,39.38,21.1
桃園市,平鎮區,合計,76179,41642,34537,734,76913,187597,228672,41.0,22.2
桃園市,新屋區,新屋里,1136,574,562,12,1148,2883,0,39.82,19.91
桃園市,新屋區,新生里,1564,816,748,7,1571,3991,0,39.36,20.45
桃園市,新屋區,後湖里,540,254,286,3,543,1517,0,35.79,16.74
桃園市,新屋區,清華里,1453,732,721,7,1460,4096,0,35.64,17.87
桃園市,新屋區,頭洲里,1722,809,913,14,1736,4467,0,38.86,18.11
桃園市,新屋區,埔頂里,886,426,460,5,891,2563,0,34.76,16.62
桃園市,新屋區,九斗里,882,351,531,17,899,2292,0,39.22,15.31
桃園市,新屋區,社子里,534,233,301,6,540,1356,0,39.82,17.18
桃園市,新屋區,東明里,570,273,297,7,577,1466,0,39.36,18.62
桃園市,新屋區,石磊里,807,340,467,18,825,2076,0,39.74,16.38
桃園市,新屋區,下埔里,308,132,176,2,310,730,0,42.47,18.08
桃園市,新屋區,下田里,630,298,332,7,637,1727,0,36.88,17.26
桃園市,新屋區,石牌里,385,191,194,3,388,926,0,41.9,20.63
桃園市,新屋區,赤欄里,493,232,261,7,500,1310,0,38.17,17.71
桃園市,新屋區,永興里,418,186,232,4,422,1021,0,41.33,18.22
桃園市,新屋區,永安里,901,415,486,9,910,2201,0,41.34,18.86
桃園市,新屋區,笨港里,409,207,202,8,417,1020,0,40.88,20.29
桃園市,新屋區,深圳里,245,120,125,0,245,639,0,38.34,18.78
桃園市,新屋區,蚵間里,338,118,220,0,338,900,0,37.56,13.11
桃園市,新屋區,槺榔里,412,176,236,7,419,1072,0,39.09,16.42
桃園市,新屋區,後庄里,453,227,226,2,455,1098,0,41.44,20.67
桃園市,新屋區,大坡里,480,183,297,1,481,1294,0,37.17,14.14
桃園市,新屋區,望間里,515,207,308,3,518,1391,0,37.24,14.88
桃園市,新屋區,合計,16081,7500,8581,149,16230,42036,49237,38.61,17.84
桃園市,觀音區,觀音里,992,446,546,11,1003,2767,0,36.25,16.12
桃園市,觀音區,白玉里,370,170,200,5,375,875,0,42.86,19.43
桃園市,觀音區,廣興里,480,225,255,11,491,1310,0,37.48,17.18
桃園市,觀音區,大潭里,804,314,490,8,812,1899,0,42.76,16.54
桃園市,觀音區,武威里,377,156,221,3,380,912,0,41.67,17.11
桃園市,觀音區,保生里,813,330,483,9,822,2180,0,37.71,15.14
桃園市,觀音區,三和里,370,165,205,5,375,854,0,43.91,19.32
桃園市,觀音區,新興里,298,129,169,2,300,705,0,42.55,18.3
桃園市,觀音區,坑尾里,606,251,355,5,611,1831,0,33.37,13.71
桃園市,觀音區,金湖里,926,375,551,9,935,2633,0,35.51,14.24
桃園市,觀音區,藍埔里,1043,418,625,9,1052,2621,0,40.14,15.95
桃園市,觀音區,大同里,1195,418,777,14,1209,3116,0,38.8,13.41
桃園市,觀音區,大堀里,544,184,360,4,548,1484,0,36.93,12.4
桃園市,觀音區,崙坪里,1916,694,1222,11,1927,4757,0,40.51,14.59
桃園市,觀音區,富源里,1483,714,769,8,1491,3918,0,38.06,18.22
桃園市,觀音區,上大里,972,408,564,10,982,2458,0,39.95,16.6
桃園市,觀音區,新坡里,1132,419,713,6,1138,2971,0,38.3,14.1
桃園市,觀音區,廣福里,918,348,570,13,931,2482,0,37.51,14.02
桃園市,觀音區,塔腳里,338,140,198,7,345,1021,0,33.79,13.71
桃園市,觀音區,保障里,777,237,540,8,785,1950,0,40.26,12.15
桃園市,觀音區,草漯里,984,377,607,9,993,2935,0,33.83,12.84
桃園市,觀音區,樹林里,1234,557,677,20,1254,4468,0,28.07,12.47
桃園市,觀音區,富林里,650,245,405,8,658,1926,0,34.16,12.72
桃園市,觀音區,草新里,1889,859,1030,11,1900,5720,0,33.22,15.02
桃園市,觀音區,合計,21111,8579,12532,206,21317,57793,69326,36.89,14.84
桃園市,復興區,三民里,665,345,320,16,681,2041,0,33.37,16.9
桃園市,復興區,澤仁里,437,309,128,2,439,1426,0,30.79,21.67
桃園市,復興區,義盛里,220,186,34,3,223,745,0,29.93,24.97
桃園市,復興區,霞雲里,164,134,30,1,165,631,0,26.15,21.24
桃園市,復興區,長興里,157,114,43,3,160,660,0,24.24,17.27
桃園市,復興區,三光里,128,106,22,2,130,683,0,19.03,15.52
桃園市,復興區,奎輝里,205,164,41,1,206,764,0,26.96,21.47
桃園市,復興區,華陵里,286,162,124,4,290,1265,0,22.92,12.81
桃園市,復興區,羅浮里,333,238,95,4,337,1067,0,31.58,22.31
桃園市,復興區,高義里,123,88,35,0,123,754,0,16.31,11.67
桃園市,復興區,合計,2718,1846,872,36,2754,10036,12391,27.44,18.39
桃園市,合計,合計,741363,382314,359049,6835,748198,1869908,2272459,40.01,20.45
臺中市,中區,繼光里,641,267,374,5,646,1436,0,44.99,18.59
臺中市,中區,大墩里,825,377,448,3,828,1946,0,42.55,19.37
臺中市,中區,綠川里,680,292,388,7,687,1572,0,43.7,18.58
臺中市,中區,公園里,578,265,313,5,583,1353,0,43.09,19.59
臺中市,中區,光復里,848,411,437,4,852,1913,0,44.54,21.48
臺中市,中區,柳川里,704,329,375,10,714,1884,0,37.9,17.46
臺中市,中區,大誠里,990,451,539,13,1003,2244,0,44.7,20.1
臺中市,中區,中華里,763,373,390,5,768,1847,0,41.58,20.19
臺中市,中區,合計,6029,2765,3264,52,6081,14195,17930,42.84,19.48
臺中市,東區,新庄里,1167,510,657,9,1176,2974,0,39.54,17.15
臺中市,東區,振興里,1424,569,855,19,1443,3053,0,47.26,18.64
臺中市,東區,東橋里,1696,620,1076,20,1716,3732,0,45.98,16.61
臺中市,東區,東興里,1240,517,723,19,1259,2791,0,45.11,18.52
臺中市,東區,干城里,910,409,501,11,921,1889,0,48.76,21.65
臺中市,東區,泉源里,924,403,521,12,936,2030,0,46.11,19.85
臺中市,東區,旱溪里,1179,534,645,11,1190,2499,0,47.62,21.37
臺中市,東區,樂成里,964,395,569,10,974,2244,0,43.4,17.6
臺中市,東區,東門里,3026,1213,1813,37,3063,6693,0,45.76,18.12
臺中市,東區,十甲里,2088,969,1119,15,2103,4732,0,44.44,20.48
臺中市,東區,東南里,1651,849,802,9,1660,3682,0,45.08,23.06
臺中市,東區,東勢里,1077,560,517,12,1089,2651,0,41.08,21.12
臺中市,東區,合作里,1673,1049,624,17,1690,3985,0,42.41,26.32
臺中市,東區,富台里,762,495,267,5,767,1703,0,45.04,29.07
臺中市,東區,富仁里,1844,1242,602,14,1858,4044,0,45.94,30.71
臺中市,東區,東信里,3990,1656,2334,45,4035,8763,0,46.05,18.9
臺中市,東區,東英里,3200,1443,1757,27,3227,7152,0,45.12,20.18
臺中市,東區,合計,28815,13433,15382,292,29107,64617,75468,45.05,20.79
臺中市,南區,城隍里,1605,736,869,15,1620,3502,0,46.26,21.02
臺中市,南區,國光里,1678,731,947,18,1696,3745,0,45.29,19.52
臺中市,南區,南門里,1626,763,863,14,1640,3412,0,48.07,22.36
臺中市,南區,德義里,1346,681,665,15,1361,2840,0,47.92,23.98
臺中市,南區,積善里,1151,518,633,7,1158,2506,0,46.21,20.67
臺中市,南區,江川里,1331,660,671,11,1342,2714,0,49.45,24.32
臺中市,南區,新榮里,1902,1005,897,13,1915,4415,0,43.37,22.76
臺中市,南區,福興里,1816,891,925,15,1831,3817,0,47.97,23.34
臺中市,南區,福平里,2316,1096,1220,17,2333,5297,0,44.04,20.69
臺中市,南區,和平里,1553,756,797,15,1568,4091,0,38.33,18.48
臺中市,南區,永興里,3513,1791,1722,25,3538,7871,0,44.95,22.75
臺中市,南區,樹義里,5055,2449,2606,32,5087,11718,0,43.41,20.9
臺中市,南區,樹德里,3749,1954,1795,40,3789,8372,0,45.26,23.34
臺中市,南區,西川里,1902,992,910,21,1923,4215,0,45.62,23.53
臺中市,南區,長春里,893,407,486,12,905,1865,0,48.53,21.82
臺中市,南區,長榮里,1156,549,607,18,1174,2394,0,49.04,22.93
臺中市,南區,福順里,2414,1208,1206,23,2437,5566,0,43.78,21.7
臺中市,南區,平和里,1504,675,829,18,1522,3459,0,44.0,19.51
臺中市,南區,南和里,2980,1565,1415,24,3004,7374,0,40.74,21.22
臺中市,南區,永和里,1947,976,971,16,1963,4610,0,42.58,21.17
臺中市,南區,工學里,2848,1463,1385,19,2867,6608,0,43.39,22.14
臺中市,南區,崇倫里,2442,1167,1275,23,2465,5361,0,45.98,21.77
臺中市,南區,合計,46727,23033,23694,411,47138,105752,126574,44.57,21.78
臺中市,西區,民生里,799,390,409,7,806,1694,0,47.58,23.02
臺中市,西區,利民里,622,349,273,8,630,1340,0,47.01,26.04
臺中市,西區,三民里,803,415,388,3,806,2306,0,34.95,18.0
臺中市,西區,東昇里,1097,534,563,11,1108,2250,0,49.24,23.73
臺中市,西區,廣民里,609,299,310,4,613,1370,0,44.74,21.82
臺中市,西區,平和里,807,415,392,5,812,1840,0,44.13,22.55
臺中市,西區,公民里,2248,1094,1154,21,2269,4767,0,47.6,22.95
臺中市,西區,藍興里,1835,906,929,32,1867,3884,0,48.07,23.33
臺中市,西區,公舘里,2515,1158,1357,18,2533,5582,0,45.38,20.75
臺中市,西區,和龍里,986,425,561,11,997,2244,0,44.43,18.94
臺中市,西區,民龍里,1511,782,729,14,1525,3397,0,44.89,23.02
臺中市,西區,後龍里,1487,708,779,13,1500,3447,0,43.52,20.54
臺中市,西區,安龍里,1371,640,731,12,1383,2776,0,49.82,23.05
臺中市,西區,吉龍里,2963,1516,1447,18,2981,6405,0,46.54,23.67
臺中市,西區,昇平里,2513,1172,1341,14,2527,5634,0,44.85,20.8
臺中市,西區,忠明里,2681,1288,1393,18,2699,5653,0,47.74,22.78
臺中市,西區,公正里,2911,1428,1483,31,2942,6172,0,47.67,23.14
臺中市,西區,土庫里,2569,1163,1406,21,2590,5619,0,46.09,20.7
臺中市,西區,忠誠里,2478,1178,1300,19,2497,5548,0,45.01,21.23
臺中市,西區,公益里,1262,551,711,13,1275,2725,0,46.79,20.22
臺中市,西區,中興里,1714,718,996,13,1727,3518,0,49.09,20.41
臺中市,西區,公平里,2118,1114,1004,15,2133,4905,0,43.49,22.71
臺中市,西區,公德里,1869,929,940,15,1884,4170,0,45.18,22.28
臺中市,西區,双龍里,1239,631,608,12,1251,2712,0,46.13,23.27
臺中市,西區,大忠里,2129,1077,1052,14,2143,4315,0,49.66,24.96
臺中市,西區,合計,43136,20880,22256,362,43498,94273,113744,46.14,22.15
臺中市,北區,光大里,838,373,465,12,850,2049,0,41.48,18.2
臺中市,北區,文莊里,1619,1010,609,19,1638,3331,0,49.17,30.32
臺中市,北區,五常里,560,233,327,9,569,1343,0,42.37,17.35
臺中市,北區,新興里,615,351,264,6,621,1453,0,42.74,24.16
臺中市,北區,新北里,775,373,402,6,781,1655,0,47.19,22.54
臺中市,北區,樂英里,1152,887,265,10,1162,2490,0,46.67,35.62
臺中市,北區,錦村里,1508,786,722,7,1515,3071,0,49.33,25.59
臺中市,北區,建成里,2301,1124,1177,14,2315,5570,0,41.56,20.18
臺中市,北區,錦洲里,1451,807,644,17,1468,3236,0,45.36,24.94
臺中市,北區,金華里,1176,640,536,7,1183,2501,0,47.3,25.59
臺中市,北區,金龍里,1840,977,863,19,1859,4247,0,43.77,23.0
臺中市,北區,邱厝里,995,510,485,5,1000,2256,0,44.33,22.61
臺中市,北區,建興里,2452,1182,1270,21,2473,5454,0,45.34,21.67
臺中市,北區,頂厝里,1869,990,879,15,1884,4109,0,45.85,24.09
臺中市,北區,賴厝里,1716,972,744,9,1725,5017,0,34.38,19.37
臺中市,北區,賴村里,1929,889,1040,12,1941,4300,0,45.14,20.67
臺中市,北區,育德里,1658,849,809,13,1671,3585,0,46.61,23.68
臺中市,北區,淡溝里,2258,1102,1156,22,2280,5018,0,45.44,21.96
臺中市,北區,中達里,1137,557,580,12,1149,2573,0,44.66,21.65
臺中市,北區,錦祥里,1966,1078,888,12,1978,4459,0,44.36,24.18
臺中市,北區,健行里,3047,1398,1649,36,3083,6438,0,47.89,21.71
臺中市,北區,明德里,2322,1136,1186,14,2336,5217,0,44.78,21.77
臺中市,北區,長青里,2568,1271,1297,21,2589,5993,0,43.2,21.21
臺中市,北區,賴明里,1578,867,711,9,1587,3763,0,42.17,23.04
臺中市,北區,賴興里,1645,940,705,10,1655,3730,0,44.37,25.2
臺中市,北區,中正里,574,218,356,4,578,1309,0,44.16,16.65
臺中市,北區,六合里,674,260,414,6,680,1727,0,39.37,15.06
臺中市,北區,大湖里,817,323,494,9,826,2153,0,38.37,15.0
臺中市,北區,錦平里,781,377,404,3,784,1840,0,42.61,20.49
臺中市,北區,建德里,1555,801,754,18,1573,3229,0,48.71,24.81
臺中市,北區,崇德里,1438,713,725,17,1455,3417,0,42.58,20.87
臺中市,北區,賴旺里,1650,858,792,17,1667,4259,0,39.14,20.15
臺中市,北區,明新里,1161,603,558,17,1178,2661,0,44.27,22.66
臺中市,北區,立人里,1549,847,702,15,1564,3755,0,41.65,22.56
臺中市,北區,梅川里,1398,714,684,8,1406,3190,0,44.08,22.38
臺中市,北區,賴福里,1832,953,879,17,1849,3762,0,49.15,25.33
臺中市,北區,合計,54404,27969,26435,468,54872,124160,145438,44.19,22.53
臺中市,西屯區,西安里,2262,1108,1154,15,2277,5165,0,44.09,21.45
臺中市,西屯區,西墩里,2433,1140,1293,15,2448,5884,0,41.6,19.37
臺中市,西屯區,潮洋里,2275,1139,1136,21,2296,6268,0,36.63,18.17
臺中市,西屯區,龍潭里,410,156,254,6,416,833,0,49.94,18.73
臺中市,西屯區,惠來里,6200,3286,2914,63,6263,14638,0,42.79,22.45
臺中市,西屯區,上石里,1972,1013,959,22,1994,5016,0,39.75,20.2
臺中市,西屯區,逢甲里,1751,897,854,11,1762,4314,0,40.84,20.79
臺中市,西屯區,鵬程里,1243,1055,188,14,1257,2619,0,48.0,40.28
臺中市,西屯區,何安里,2196,1051,1145,22,2218,5075,0,43.7,20.71
臺中市,西屯區,何厝里,1352,628,724,9,1361,3200,0,42.53,19.63
臺中市,西屯區,大河里,1797,767,1030,15,1812,3726,0,48.63,20.59
臺中市,西屯區,大石里,1022,866,156,19,1041,2082,0,50.0,41.59
臺中市,西屯區,大福里,1358,764,594,15,1373,3255,0,42.18,23.47
臺中市,西屯區,大鵬里,1994,1106,888,13,2007,4745,0,42.3,23.31
臺中市,西屯區,港尾里,2121,1023,1098,22,2143,4944,0,43.35,20.69
臺中市,西屯區,廣福里,1048,420,628,6,1054,2324,0,45.35,18.07
臺中市,西屯區,林厝里,1428,762,666,14,1442,3398,0,42.44,22.42
臺中市,西屯區,永安里,4987,2554,2433,45,5032,12696,0,39.63,20.12
臺中市,西屯區,福安里,1348,695,653,14,1362,2940,0,46.33,23.64
臺中市,西屯區,協和里,1932,890,1042,17,1949,4642,0,41.99,19.17
臺中市,西屯區,何仁里,2649,1286,1363,27,2676,6083,0,43.99,21.14
臺中市,西屯區,何德里,1568,766,802,18,1586,3633,0,43.66,21.08
臺中市,西屯區,何源里,2870,1509,1361,24,2894,6639,0,43.59,22.73
臺中市,西屯區,西平里,1959,1181,778,20,1979,4807,0,41.17,24.57
臺中市,西屯區,何南里,1965,1027,938,15,1980,4097,0,48.33,25.07
臺中市,西屯區,至善里,1907,1012,895,19,1926,4381,0,43.96,23.1
臺中市,西屯區,上安里,2299,1185,1114,27,2326,5223,0,44.53,22.69
臺中市,西屯區,上德里,1870,1025,845,16,1886,4120,0,45.78,24.88
臺中市,西屯區,逢福里,2433,1312,1121,17,2450,5257,0,46.6,24.96
臺中市,西屯區,何明里,1686,815,871,13,1699,3558,0,47.75,22.91
臺中市,西屯區,何成里,3067,1520,1547,23,3090,7080,0,43.64,21.47
臺中市,西屯區,何福里,1951,916,1035,23,1974,4322,0,45.67,21.19
臺中市,西屯區,福和里,1757,698,1059,21,1778,4278,0,41.56,16.32
臺中市,西屯區,福中里,1373,680,693,16,1389,3203,0,43.37,21.23
臺中市,西屯區,福恩里,2246,1209,1037,23,2269,4778,0,47.49,25.3
臺中市,西屯區,福聯里,1114,597,517,16,1130,3166,0,35.69,18.86
臺中市,西屯區,福瑞里,1120,641,479,9,1129,2980,0,37.89,21.51
臺中市,西屯區,福林里,3351,1869,1482,44,3395,7655,0,44.35,24.42
臺中市,西屯區,福雅里,2460,1298,1162,20,2480,5769,0,42.99,22.5
臺中市,西屯區,合計,80774,41866,38908,769,81543,188793,231415,43.19,22.18
臺中市,南屯區,南屯里,3784,1830,1954,37,3821,8528,0,44.81,21.46
臺中市,南屯區,豐樂里,5218,2570,2648,47,5265,11358,0,46.35,22.63
臺中市,南屯區,楓樹里,2805,1306,1499,28,2833,5891,0,48.09,22.17
臺中市,南屯區,中和里,1861,767,1094,15,1876,4324,0,43.39,17.74
臺中市,南屯區,春社里,2463,1286,1177,22,2485,6534,0,38.03,19.68
臺中市,南屯區,春安里,492,261,231,5,497,1366,0,36.38,19.11
臺中市,南屯區,文山里,4276,2035,2241,29,4305,11272,0,38.19,18.05
臺中市,南屯區,新生里,909,420,489,10,919,2301,0,39.94,18.25
臺中市,南屯區,永定里,2135,936,1199,20,2155,5105,0,42.21,18.33
臺中市,南屯區,三厝里,2977,1534,1443,34,3011,7137,0,42.19,21.49
臺中市,南屯區,溝墘里,2627,1353,1274,22,2649,5220,0,50.75,25.92
臺中市,南屯區,田心里,2750,1281,1469,33,2783,6268,0,44.4,20.44
臺中市,南屯區,黎明里,1951,1147,804,19,1970,4151,0,47.46,27.63
臺中市,南屯區,鎮平里,578,217,361,11,589,1357,0,43.4,15.99
臺中市,南屯區,大同里,2268,1069,1199,16,2284,4877,0,46.83,21.92
臺中市,南屯區,文心里,1721,896,825,26,1747,3803,0,45.94,23.56
臺中市,南屯區,同心里,2238,1150,1088,28,2266,5223,0,43.39,22.02
臺中市,南屯區,向心里,2162,1095,1067,19,2181,5433,0,40.14,20.15
臺中市,南屯區,大誠里,1637,805,832,17,1654,3609,0,45.83,22.31
臺中市,南屯區,大興里,1995,939,1056,16,2011,4436,0,45.33,21.17
臺中市,南屯區,大業里,3021,1557,1464,16,3037,6517,0,46.6,23.89
臺中市,南屯區,惠中里,3381,1718,1663,27,3408,7565,0,45.05,22.71
臺中市,南屯區,寶山里,2057,1029,1028,17,2074,5266,0,39.38,19.54
臺中市,南屯區,三和里,3776,2101,1675,45,3821,8478,0,45.07,24.78
臺中市,南屯區,三義里,2906,1597,1309,22,2928,6493,0,45.09,24.6
臺中市,南屯區,合計,61988,30899,31089,581,62569,142512,176754,43.9,21.68
臺中市,北屯區,北興里,1422,721,701,18,1440,3133,0,45.96,23.01
臺中市,北屯區,北屯里,1469,820,649,14,1483,3392,0,43.72,24.17
臺中市,北屯區,三光里,3033,1629,1404,34,3067,6954,0,44.1,23.43
臺中市,北屯區,平田里,2397,1272,1125,21,2418,5705,0,42.38,22.3
臺中市,北屯區,平和里,2093,1146,947,13,2106,5097,0,41.32,22.48
臺中市,北屯區,東光里,1945,996,949,15,1960,4595,0,42.66,21.68
臺中市,北屯區,舊社里,2932,1467,1465,22,2954,7211,0,40.97,20.34
臺中市,北屯區,水景里,5904,2867,3037,44,5948,13462,0,44.18,21.3
臺中市,北屯區,軍功里,5431,2518,2913,61,5492,12347,0,44.48,20.39
臺中市,北屯區,和平里,4750,2329,2421,32,4782,11410,0,41.91,20.41
臺中市,北屯區,東山里,919,366,553,11,930,2030,0,45.81,18.03
臺中市,北屯區,民政里,374,174,200,3,377,1008,0,37.4,17.26
臺中市,北屯區,廍子里,5452,2833,2619,37,5489,14177,0,38.72,19.98
臺中市,北屯區,大坑里,907,420,487,11,918,2160,0,42.5,19.44
臺中市,北屯區,民德里,356,163,193,3,359,905,0,39.67,18.01
臺中市,北屯區,松竹里,3871,2140,1731,30,3901,8784,0,44.41,24.36
臺中市,北屯區,仁和里,3504,1812,1692,29,3533,9231,0,38.27,19.63
臺中市,北屯區,仁美里,3996,1995,2001,24,4020,9374,0,42.88,21.28
臺中市,北屯區,四民里,689,324,365,8,697,1525,0,45.7,21.25
臺中市,北屯區,后庄里,4322,2537,1785,34,4356,9850,0,44.22,25.76
臺中市,北屯區,同榮里,2400,1247,1153,29,2429,5327,0,45.6,23.41
臺中市,北屯區,仁愛里,477,286,191,5,482,1046,0,46.08,27.34
臺中市,北屯區,水湳里,2970,1523,1447,32,3002,6614,0,45.39,23.03
臺中市,北屯區,陳平里,1924,1085,839,20,1944,4564,0,42.59,23.77
臺中市,北屯區,新平里,1746,999,747,12,1758,4248,0,41.38,23.52
臺中市,北屯區,平安里,2351,1174,1177,26,2377,5130,0,46.34,22.88
臺中市,北屯區,平順里,1394,700,694,10,1404,3146,0,44.63,22.25
臺中市,北屯區,平德里,2615,1355,1260,12,2627,6176,0,42.54,21.94
臺中市,北屯區,松安里,2054,1025,1029,23,2077,4780,0,43.45,21.44
臺中市,北屯區,松茂里,2248,1254,994,22,2270,5241,0,43.31,23.93
臺中市,北屯區,大德里,2257,1307,950,20,2277,4863,0,46.82,26.88
臺中市,北屯區,松強里,2726,1385,1341,15,2741,6705,0,40.88,20.66
臺中市,北屯區,松勇里,2245,1181,1064,27,2272,5153,0,44.09,22.92
臺中市,北屯區,北京里,1453,687,766,14,1467,3180,0,46.13,21.6
臺中市,北屯區,平心里,2019,1063,956,8,2027,4765,0,42.54,22.31
臺中市,北屯區,平福里,1603,894,709,12,1615,3560,0,45.37,25.11
臺中市,北屯區,松和里,2478,1299,1179,16,2494,6410,0,38.91,20.27
臺中市,北屯區,平陽里,2064,1087,977,19,2083,4887,0,42.62,22.24
臺中市,北屯區,平興里,2731,1433,1298,15,2746,6741,0,40.74,21.26
臺中市,北屯區,平昌里,1868,974,894,18,1886,4376,0,43.1,22.26
臺中市,北屯區,三和里,2479,1369,1110,24,2503,5662,0,44.21,24.18
臺中市,北屯區,忠平里,1703,1008,695,15,1718,3906,0,43.98,25.81
臺中市,北屯區,合計,101571,52864,48707,858,102429,238830,289830,42.89,22.13
臺中市,豐原區,豐原里,984,517,467,15,999,2243,0,44.54,23.05
臺中市,豐原區,頂街里,422,169,253,1,423,919,0,46.03,18.39
臺中市,豐原區,中山里,402,171,231,4,406,795,0,51.07,21.51
臺中市,豐原區,豐榮里,514,204,310,7,521,1106,0,47.11,18.44
臺中市,豐原區,下街里,298,127,171,3,301,744,0,40.46,17.07
臺中市,豐原區,富春里,384,150,234,3,387,720,0,53.75,20.83
臺中市,豐原區,葫蘆里,301,121,180,3,304,607,0,50.08,19.93
臺中市,豐原區,豐西里,756,355,401,4,760,1595,0,47.65,22.26
臺中市,豐原區,西安里,2176,996,1180,19,2195,4781,0,45.91,20.83
臺中市,豐原區,西勢里,1048,473,575,8,1056,2152,0,49.07,21.98
臺中市,豐原區,東勢里,663,286,377,7,670,1433,0,46.76,19.96
臺中市,豐原區,民生里,469,184,285,3,472,1119,0,42.18,16.44
臺中市,豐原區,大湳里,1100,474,626,6,1106,2494,0,44.35,19.01
臺中市,豐原區,北湳里,1281,644,637,17,1298,2882,0,45.04,22.35
臺中市,豐原區,東湳里,1664,616,1048,12,1676,3976,0,42.15,15.49
臺中市,豐原區,西湳里,3831,1581,2250,44,3875,9125,0,42.47,17.33
臺中市,豐原區,圳寮里,591,246,345,9,600,1231,0,48.74,19.98
臺中市,豐原區,豐圳里,1497,734,763,11,1508,3367,0,44.79,21.8
臺中市,豐原區,社皮里,3897,1812,2085,32,3929,9864,0,39.83,18.37
臺中市,豐原區,三村里,2792,1254,1538,25,2817,6283,0,44.84,19.96
臺中市,豐原區,中興里,1231,676,555,19,1250,2877,0,43.45,23.5
臺中市,豐原區,田心里,2488,1141,1347,22,2510,6296,0,39.87,18.12
臺中市,豐原區,豐田里,4262,1866,2396,31,4293,10193,0,42.12,18.31
臺中市,豐原區,鎌村里,2000,902,1098,22,2022,4633,0,43.64,19.47
臺中市,豐原區,南陽里,4397,2072,2325,31,4428,10538,0,42.02,19.66
臺中市,豐原區,陽明里,1160,548,612,15,1175,2631,0,44.66,20.83
臺中市,豐原區,北陽里,5443,2545,2898,37,5480,12989,0,42.19,19.59
臺中市,豐原區,中陽里,2261,1079,1182,15,2276,5045,0,45.11,21.39
臺中市,豐原區,東陽里,727,287,440,10,737,1574,0,46.82,18.23
臺中市,豐原區,南村里,2321,997,1324,21,2342,5234,0,44.75,19.05
臺中市,豐原區,南田里,1392,576,816,16,1408,3175,0,44.35,18.14
臺中市,豐原區,南嵩里,1442,592,850,15,1457,3377,0,43.14,17.53
臺中市,豐原區,翁明里,976,490,486,10,986,2265,0,43.53,21.63
臺中市,豐原區,翁子里,1331,619,712,11,1342,3221,0,41.66,19.22
臺中市,豐原區,翁社里,956,418,538,10,966,2049,0,47.14,20.4
臺中市,豐原區,朴子里,1357,530,827,12,1369,3287,0,41.65,16.12
臺中市,豐原區,合計,58814,26452,32362,530,59344,136820,165529,43.37,19.33
臺中市,東勢區,北興里,492,298,194,8,500,1297,0,38.55,22.98
臺中市,東勢區,中寧里,364,235,129,7,371,833,0,44.54,28.21
臺中市,東勢區,東安里,430,257,173,3,433,996,0,43.47,25.8
臺中市,東勢區,南平里,804,517,287,8,812,1754,0,46.29,29.48
臺中市,東勢區,延平里,910,501,409,7,917,2138,0,42.89,23.43
臺中市,東勢區,上新里,424,262,162,1,425,951,0,44.69,27.55
臺中市,東勢區,廣興里,570,332,238,9,579,1403,0,41.27,23.66
臺中市,東勢區,泰昌里,1444,917,527,17,1461,3402,0,42.95,26.95
臺中市,東勢區,中嵙里,667,384,283,11,678,1835,0,36.95,20.93
臺中市,東勢區,福隆里,1463,841,622,18,1481,3709,0,39.93,22.67
臺中市,東勢區,隆興里,487,271,216,4,491,1418,0,34.63,19.11
臺中市,東勢區,新盛里,1888,986,902,20,1908,4812,0,39.65,20.49
臺中市,東勢區,詒福里,665,333,332,13,678,1616,0,41.96,20.61
臺中市,東勢區,上城里,427,228,199,10,437,963,0,45.38,23.68
臺中市,東勢區,下城里,367,178,189,5,372,832,0,44.71,21.39
臺中市,東勢區,慶東里,695,315,380,16,711,1825,0,38.96,17.26
臺中市,東勢區,慶福里,375,195,180,5,380,1233,0,30.82,15.82
臺中市,東勢區,東新里,854,521,333,12,866,1954,0,44.32,26.66
臺中市,東勢區,粵寧里,839,461,378,12,851,2023,0,42.07,22.79
臺中市,東勢區,下新里,656,329,327,12,668,1651,0,40.46,19.93
臺中市,東勢區,興隆里,457,215,242,3,460,1172,0,39.25,18.34
臺中市,東勢區,茂興里,618,339,279,9,627,1817,0,34.51,18.66
臺中市,東勢區,泰興里,226,121,105,2,228,701,0,32.52,17.26
臺中市,東勢區,埤頭里,285,107,178,6,291,657,0,44.29,16.29
臺中市,東勢區,明正里,462,206,256,8,470,1365,0,34.43,15.09
臺中市,東勢區,合計,16869,9349,7520,226,17095,42357,48747,40.36,22.07
臺中市,大甲區,朝陽里,577,260,317,5,582,1331,0,43.73,19.53
臺中市,大甲區,大甲里,435,183,252,3,438,991,0,44.2,18.47
臺中市,大甲區,順天里,683,302,381,4,687,1532,0,44.84,19.71
臺中市,大甲區,孔門里,289,147,142,1,290,748,0,38.77,19.65
臺中市,大甲區,平安里,786,349,437,10,796,2008,0,39.64,17.38
臺中市,大甲區,庄美里,883,387,496,11,894,2055,0,43.5,18.83
臺中市,大甲區,新美里,1330,651,679,15,1345,3394,0,39.63,19.18
臺中市,大甲區,岷山里,768,382,386,11,779,2042,0,38.15,18.71
臺中市,大甲區,中山里,1705,888,817,31,1736,4515,0,38.45,19.67
臺中市,大甲區,南陽里,326,154,172,5,331,813,0,40.71,18.94
臺中市,大甲區,薰風里,397,168,229,5,402,860,0,46.74,19.53
臺中市,大甲區,義和里,1141,562,579,9,1150,3232,0,35.58,17.39
臺中市,大甲區,武陵里,452,227,225,4,456,1160,0,39.31,19.57
臺中市,大甲區,文曲里,354,132,222,2,356,1073,0,33.18,12.3
臺中市,大甲區,武曲里,702,333,369,3,705,1810,0,38.95,18.4
臺中市,大甲區,文武里,2062,1003,1059,25,2087,5206,0,40.09,19.27
臺中市,大甲區,奉化里,795,404,391,5,800,1996,0,40.08,20.24
臺中市,大甲區,德化里,635,255,380,3,638,1755,0,36.35,14.53
臺中市,大甲區,江南里,467,216,251,1,468,1356,0,34.51,15.93
臺中市,大甲區,頂店里,1670,776,894,18,1688,4450,0,37.93,17.44
臺中市,大甲區,太白里,427,176,251,10,437,1233,0,35.44,14.27
臺中市,大甲區,孟春里,1373,594,779,14,1387,3909,0,35.48,15.2
臺中市,大甲區,幸福里,850,347,503,14,864,2515,0,34.35,13.8
臺中市,大甲區,日南里,1810,836,974,19,1829,5476,0,33.4,15.27
臺中市,大甲區,龍泉里,577,258,319,6,583,1475,0,39.53,17.49
臺中市,大甲區,西岐里,594,282,312,7,601,1649,0,36.45,17.1
臺中市,大甲區,銅安里,432,187,245,9,441,1340,0,32.91,13.96
臺中市,大甲區,福德里,375,182,193,1,376,1111,0,33.84,16.38
臺中市,大甲區,建興里,439,174,265,6,445,1446,0,30.77,12.03
臺中市,大甲區,合計,23334,10815,12519,257,23591,62481,75819,37.76,17.31
臺中市,清水區,鰲峰里,463,209,254,6,469,1063,0,44.12,19.66
臺中市,清水區,靈泉里,462,208,254,4,466,930,0,50.11,22.37
臺中市,清水區,清水里,912,412,500,9,921,2049,0,44.95,20.11
臺中市,清水區,文昌里,308,130,178,6,314,661,0,47.5,19.67
臺中市,清水區,南寧里,765,351,414,2,767,1743,0,44.0,20.14
臺中市,清水區,西寧里,660,277,383,3,663,1553,0,42.69,17.84
臺中市,清水區,北寧里,324,141,183,7,331,673,0,49.18,20.95
臺中市,清水區,中興里,210,91,119,1,211,391,0,53.96,23.27
臺中市,清水區,西社里,954,413,541,12,966,2191,0,44.09,18.85
臺中市,清水區,南社里,4108,1889,2219,35,4143,9925,0,41.74,19.03
臺中市,清水區,裕嘉里,540,230,310,4,544,1448,0,37.57,15.88
臺中市,清水區,臨江里,593,271,322,6,599,1505,0,39.8,18.01
臺中市,清水區,秀水里,1736,823,913,27,1763,4370,0,40.34,18.83
臺中市,清水區,武鹿里,1240,515,725,12,1252,3341,0,37.47,15.41
臺中市,清水區,海濱里,793,323,470,12,805,2104,0,38.26,15.35
臺中市,清水區,槺榔里,2298,965,1333,16,2314,6655,0,34.77,14.5
臺中市,清水區,中社里,1182,822,360,10,1192,2801,0,42.56,29.35
臺中市,清水區,高西里,396,225,171,6,402,1278,0,31.46,17.61
臺中市,清水區,高南里,447,202,245,4,451,1330,0,33.91,15.19
臺中市,清水區,高東里,412,168,244,7,419,1234,0,33.95,13.61
臺中市,清水區,高北里,334,151,183,3,337,1155,0,29.18,13.07
臺中市,清水區,高美里,445,216,229,7,452,1309,0,34.53,16.5
臺中市,清水區,國姓里,662,224,438,6,668,2039,0,32.76,10.99
臺中市,清水區,菁埔里,898,345,553,6,904,2252,0,40.14,15.32
臺中市,清水區,頂湳里,598,263,335,6,604,1765,0,34.22,14.9
臺中市,清水區,田寮里,799,284,515,19,818,2488,0,32.88,11.41
臺中市,清水區,橋頭里,2948,1201,1747,27,2975,7404,0,40.18,16.22
臺中市,清水區,下湳里,1067,460,607,10,1077,2764,0,38.97,16.64
臺中市,清水區,東山里,424,202,222,7,431,1197,0,36.01,16.88
臺中市,清水區,楊厝里,435,171,264,5,440,1156,0,38.06,14.79
臺中市,清水區,海風里,496,239,257,7,503,1390,0,36.19,17.19
臺中市,清水區,吳厝里,567,244,323,7,574,1465,0,39.18,16.66
臺中市,清水區,合計,28476,12665,15811,299,28775,73629,88227,39.08,17.2
臺中市,沙鹿區,居仁里,609,276,333,2,611,1364,0,44.79,20.23
臺中市,沙鹿區,洛泉里,1029,495,534,6,1035,1976,0,52.38,25.05
臺中市,沙鹿區,沙鹿里,467,175,292,2,469,893,0,52.52,19.6
臺中市,沙鹿區,美仁里,234,116,118,4,238,489,0,48.67,23.72
臺中市,沙鹿區,興仁里,1081,503,578,5,1086,2409,0,45.08,20.88
臺中市,沙鹿區,斗抵里,1979,918,1061,22,2001,4364,0,45.85,21.04
臺中市,沙鹿區,鹿峰里,2334,1024,1310,21,2355,5345,0,44.06,19.16
臺中市,沙鹿區,鹿寮里,3130,1236,1894,22,3152,6799,0,46.36,18.18
臺中市,沙鹿區,竹林里,3079,1531,1548,35,3114,7344,0,42.4,20.85
臺中市,沙鹿區,犁分里,473,205,268,4,477,1089,0,43.8,18.82
臺中市,沙鹿區,北勢里,1870,937,933,17,1887,4904,0,38.48,19.11
臺中市,沙鹿區,福興里,1608,798,810,14,1622,3843,0,42.21,20.77
臺中市,沙鹿區,晉江里,772,367,405,11,783,1748,0,44.79,21.0
臺中市,沙鹿區,六路里,2214,1019,1195,14,2228,5388,0,41.35,18.91
臺中市,沙鹿區,南勢里,1407,715,692,12,1419,3381,0,41.97,21.15
臺中市,沙鹿區,埔子里,2515,1330,1185,18,2533,5682,0,44.58,23.41
臺中市,沙鹿區,公明里,1788,1028,760,35,1823,4396,0,41.47,23.38
臺中市,沙鹿區,清泉里,1018,550,468,12,1030,2331,0,44.19,23.6
臺中市,沙鹿區,西勢里,852,456,396,12,864,2130,0,40.56,21.41
臺中市,沙鹿區,興安里,1448,627,821,16,1464,3365,0,43.51,18.63
臺中市,沙鹿區,三鹿里,3029,1544,1485,20,3049,7321,0,41.65,21.09
臺中市,沙鹿區,合計,32936,15850,17086,304,33240,76561,95562,43.42,20.7
臺中市,梧棲區,頂寮里,1426,668,758,14,1440,3632,0,39.65,18.39
臺中市,梧棲區,下寮里,838,376,462,5,843,1967,0,42.86,19.12
臺中市,梧棲區,中正里,1492,740,752,15,1507,3879,0,38.85,19.08
臺中市,梧棲區,中和里,224,97,127,2,226,484,0,46.69,20.04
臺中市,梧棲區,文化里,487,234,253,7,494,1161,0,42.55,20.16
臺中市,梧棲區,安仁里,330,158,172,2,332,780,0,42.56,20.26
臺中市,梧棲區,草湳里,2410,1129,1281,25,2435,6132,0,39.71,18.41
臺中市,梧棲區,南簡里,1975,840,1135,20,1995,5294,0,37.68,15.87
臺中市,梧棲區,福德里,1749,748,1001,20,1769,4953,0,35.72,15.1
臺中市,梧棲區,大庄里,2881,1383,1498,33,2914,7509,0,38.81,18.42
臺中市,梧棲區,大村里,2190,989,1201,24,2214,5687,0,38.93,17.39
臺中市,梧棲區,興農里,828,359,469,9,837,2322,0,36.05,15.46
臺中市,梧棲區,永寧里,857,353,504,14,871,2298,0,37.9,15.36
臺中市,梧棲區,永安里,924,472,452,12,936,2493,0,37.55,18.93
臺中市,梧棲區,合計,18611,8546,10065,202,18813,48591,59487,38.72,17.59
臺中市,后里區,廣福里,776,496,280,19,795,2076,0,38.29,23.89
臺中市,后里區,仁里里,385,191,194,8,393,1031,0,38.12,18.53
臺中市,后里區,義里里,1191,695,496,13,1204,3086,0,39.01,22.52
臺中市,后里區,后里里,1562,780,782,16,1578,3652,0,43.21,21.36
臺中市,后里區,厚里里,827,405,422,12,839,2136,0,39.28,18.96
臺中市,后里區,墩東里,1914,982,932,24,1938,4739,0,40.89,20.72
臺中市,后里區,墩西里,763,323,440,4,767,1917,0,40.01,16.85
臺中市,后里區,墩南里,1329,592,737,13,1342,3347,0,40.1,17.69
臺中市,后里區,墩北里,1427,625,802,18,1445,3538,0,40.84,17.67
臺中市,后里區,中和里,943,396,547,8,951,2376,0,40.03,16.67
臺中市,后里區,舊社里,815,390,425,15,830,2187,0,37.95,17.83
臺中市,后里區,聯合里,616,265,351,6,622,1559,0,39.9,17.0
臺中市,后里區,太平里,707,337,370,5,712,2131,0,33.41,15.81
臺中市,后里區,眉山里,1144,581,563,12,1156,3198,0,36.15,18.17
臺中市,后里區,泰安里,521,214,307,5,526,1393,0,37.76,15.36
臺中市,后里區,公館里,734,323,411,16,750,2139,0,35.06,15.1
臺中市,后里區,月眉里,775,304,471,6,781,1956,0,39.93,15.54
臺中市,后里區,義德里,968,531,437,12,980,2591,0,37.82,20.49
臺中市,后里區,合計,17397,8430,8967,212,17609,45052,54126,39.09,18.71
臺中市,神岡區,神岡里,1236,597,639,12,1248,3173,0,39.33,18.82
臺中市,神岡區,庄前里,955,432,523,10,965,2296,0,42.03,18.82
臺中市,神岡區,北庄里,1055,445,610,9,1064,2611,0,40.75,17.04
臺中市,神岡區,庄後里,938,337,601,7,945,2220,0,42.57,15.18
臺中市,神岡區,社口里,2833,1186,1647,25,2858,7481,0,38.2,15.85
臺中市,神岡區,社南里,2092,785,1307,20,2112,5257,0,40.18,14.93
臺中市,神岡區,三角里,1079,401,678,9,1088,2555,0,42.58,15.69
臺中市,神岡區,岸裡里,1181,422,759,15,1196,2845,0,42.04,14.83
臺中市,神岡區,大社里,1686,757,929,12,1698,4465,0,38.03,16.95
臺中市,神岡區,豐洲里,2781,1155,1626,34,2815,7152,0,39.36,16.15
臺中市,神岡區,神洲里,1075,400,675,19,1094,2539,0,43.09,15.75
臺中市,神岡區,溪洲里,1111,439,672,16,1127,2800,0,40.25,15.68
臺中市,神岡區,圳前里,886,418,468,19,905,2268,0,39.9,18.43
臺中市,神岡區,新庄里,1456,560,896,15,1471,4135,0,35.57,13.54
臺中市,神岡區,圳堵里,797,362,435,11,808,2090,0,38.66,17.32
臺中市,神岡區,山皮里,413,144,269,3,416,1016,0,40.94,14.17
臺中市,神岡區,合計,21574,8840,12734,236,21810,54903,65143,39.72,16.1
臺中市,潭子區,潭陽里,4316,1993,2323,36,4352,10990,0,39.6,18.13
臺中市,潭子區,潭秀里,596,221,375,6,602,1262,0,47.7,17.51
臺中市,潭子區,潭北里,1017,531,486,8,1025,2378,0,43.1,22.33
臺中市,潭子區,福仁里,4198,2170,2028,24,4222,10488,0,40.26,20.69
臺中市,潭子區,頭家里,2275,1151,1124,21,2296,5345,0,42.96,21.53
臺中市,潭子區,甘蔗里,3864,1931,1933,30,3894,9332,0,41.73,20.69
臺中市,潭子區,東寶里,5003,2260,2743,53,5056,12018,0,42.07,18.81
臺中市,潭子區,大富里,1214,523,691,13,1227,2801,0,43.81,18.67
臺中市,潭子區,大豐里,2556,1124,1432,20,2576,6066,0,42.47,18.53
臺中市,潭子區,栗林里,2118,884,1234,18,2136,4733,0,45.13,18.68
臺中市,潭子區,嘉仁里,1607,642,965,21,1628,3997,0,40.73,16.06
臺中市,潭子區,新田里,661,260,401,5,666,1536,0,43.36,16.93
臺中市,潭子區,聚興里,1569,726,843,27,1596,4262,0,37.45,17.03
臺中市,潭子區,頭家東里,1764,876,888,10,1774,4319,0,41.07,20.28
臺中市,潭子區,家興里,2897,1518,1379,18,2915,6933,0,42.05,21.9
臺中市,潭子區,家福里,1989,1003,986,21,2010,4575,0,43.93,21.92
臺中市,潭子區,合計,37644,17813,19831,331,37975,91035,109158,41.71,19.57
臺中市,大雅區,大雅里,1784,875,909,19,1803,4325,0,41.69,20.23
臺中市,大雅區,員林里,3615,1648,1967,37,3652,9201,0,39.69,17.91
臺中市,大雅區,六寶里,2395,1279,1116,29,2424,6208,0,39.05,20.6
臺中市,大雅區,秀山里,1345,615,730,11,1356,3353,0,40.44,18.34
臺中市,大雅區,忠義里,1293,959,334,19,1312,3594,0,36.51,26.68
臺中市,大雅區,橫山里,1704,816,888,14,1718,4313,0,39.83,18.92
臺中市,大雅區,三和里,2040,981,1059,24,2064,5252,0,39.3,18.68
臺中市,大雅區,西寶里,1748,785,963,21,1769,4779,0,37.02,16.43
臺中市,大雅區,上楓里,2292,1037,1255,24,2316,6244,0,37.09,16.61
臺中市,大雅區,二和里,2316,1134,1182,14,2330,5915,0,39.39,19.17
臺中市,大雅區,四德里,1903,979,924,16,1919,4622,0,41.52,21.18
臺中市,大雅區,上雅里,2275,1047,1228,19,2294,6037,0,38.0,17.34
臺中市,大雅區,文雅里,2346,1217,1129,20,2366,6021,0,39.3,20.21
臺中市,大雅區,大楓里,1954,928,1026,18,1972,5029,0,39.21,18.45
臺中市,大雅區,雅楓里,1328,663,665,11,1339,3545,0,37.77,18.7
臺中市,大雅區,合計,30338,14963,15375,296,30634,78438,95800,39.06,19.08
臺中市,新社區,新社里,1369,731,638,18,1387,3261,0,42.53,22.42
臺中市,新社區,復盛里,602,330,272,11,613,1835,0,33.41,17.98
臺中市,新社區,中正里,538,271,267,5,543,1342,0,40.46,20.19
臺中市,新社區,月湖里,380,162,218,9,389,986,0,39.45,16.43
臺中市,新社區,崑山里,468,160,308,4,472,1156,0,40.83,13.84
臺中市,新社區,大南里,725,366,359,12,737,1879,0,39.22,19.48
臺中市,新社區,永源里,1159,448,711,18,1177,2983,0,39.46,15.02
臺中市,新社區,中興里,265,198,67,2,267,582,0,45.88,34.02
臺中市,新社區,協成里,1101,506,595,14,1115,2927,0,38.09,17.29
臺中市,新社區,東興里,486,288,198,12,498,1187,0,41.95,24.26
臺中市,新社區,慶西里,316,123,193,10,326,885,0,36.84,13.9
臺中市,新社區,中和里,221,169,52,11,232,575,0,40.35,29.39
臺中市,新社區,福興里,416,229,187,6,422,1112,0,37.95,20.59
臺中市,新社區,合計,8046,3981,4065,132,8178,20710,23859,39.49,19.22
臺中市,石岡區,石岡里,440,222,218,6,446,1210,0,36.86,18.35
臺中市,石岡區,萬安里,648,324,324,8,656,1518,0,43.21,21.34
臺中市,石岡區,九房里,521,263,258,5,526,1204,0,43.69,21.84
臺中市,石岡區,金星里,461,220,241,8,469,1232,0,38.07,17.86
臺中市,石岡區,龍興里,261,127,134,2,263,638,0,41.22,19.91
臺中市,石岡區,萬興里,621,318,303,9,630,1443,0,43.66,22.04
臺中市,石岡區,梅子里,754,393,361,10,764,1794,0,42.59,21.91
臺中市,石岡區,土牛里,414,232,182,6,420,1002,0,41.92,23.15
臺中市,石岡區,德興里,573,329,244,8,581,1408,0,41.26,23.37
臺中市,石岡區,和盛里,530,316,214,3,533,1230,0,43.33,25.69
臺中市,石岡區,合計,5223,2744,2479,65,5288,12679,14532,41.71,21.64
臺中市,外埔區,永豐里,386,204,182,4,390,1099,0,35.49,18.56
臺中市,外埔區,六分里,774,417,357,6,780,2193,0,35.57,19.02
臺中市,外埔區,三崁里,621,314,307,6,627,1887,0,33.23,16.64
臺中市,外埔區,大同里,1767,967,800,14,1781,4680,0,38.06,20.66
臺中市,外埔區,水美里,1251,632,619,18,1269,3392,0,37.41,18.63
臺中市,外埔區,大東里,2338,1211,1127,24,2362,6342,0,37.24,19.09
臺中市,外埔區,馬鳴里,473,227,246,8,481,1384,0,34.75,16.4
臺中市,外埔區,中山里,518,279,239,7,525,1210,0,43.39,23.06
臺中市,外埔區,鐵山里,702,382,320,9,711,2115,0,33.62,18.06
臺中市,外埔區,土城里,594,251,343,5,599,1581,0,37.89,15.88
臺中市,外埔區,廍子里,347,167,180,8,355,1158,0,30.66,14.42
臺中市,外埔區,合計,9771,5051,4720,109,9880,27041,31790,36.54,18.68
臺中市,大安區,南埔里,355,130,225,7,362,1055,0,34.31,12.32
臺中市,大安區,南庄里,355,160,195,2,357,1023,0,34.9,15.64
臺中市,大安區,中庄里,860,361,499,8,868,2624,0,33.08,13.76
臺中市,大安區,龜壳里,522,243,279,6,528,1502,0,35.15,16.18
臺中市,大安區,福興里,396,171,225,4,400,1149,0,34.81,14.88
臺中市,大安區,東安里,449,183,266,1,450,1199,0,37.53,15.26
臺中市,大安區,頂安里,336,163,173,10,346,889,0,38.92,18.34
臺中市,大安區,永安里,559,255,304,11,570,1753,0,32.52,14.55
臺中市,大安區,福住里,335,147,188,3,338,1037,0,32.59,14.18
臺中市,大安區,海墘里,452,225,227,2,454,1385,0,32.78,16.25
臺中市,大安區,西安里,607,286,321,14,621,1738,0,35.73,16.46
臺中市,大安區,松雅里,437,180,257,6,443,966,0,45.86,18.63
臺中市,大安區,合計,5663,2504,3159,74,5737,16320,18688,35.15,15.34
臺中市,烏日區,烏日里,4111,1877,2234,48,4159,8638,0,48.15,21.73
臺中市,烏日區,湖日里,1157,504,653,8,1165,2486,0,46.86,20.27
臺中市,烏日區,三和里,2497,1228,1269,24,2521,5768,0,43.71,21.29
臺中市,烏日區,榮泉里,2461,1263,1198,16,2477,5795,0,42.74,21.79
臺中市,烏日區,學田里,1139,593,546,11,1150,2612,0,44.03,22.7
臺中市,烏日區,九德里,5794,2623,3171,38,5832,12829,0,45.46,20.45
臺中市,烏日區,仁德里,3568,1698,1870,26,3594,7556,0,47.56,22.47
臺中市,烏日區,前竹里,798,312,486,9,807,1621,0,49.78,19.25
臺中市,烏日區,五光里,746,329,417,14,760,1676,0,45.35,19.63
臺中市,烏日區,光明里,941,403,538,8,949,2095,0,45.3,19.24
臺中市,烏日區,東園里,971,424,547,11,982,2196,0,44.72,19.31
臺中市,烏日區,溪埧里,1924,852,1072,20,1944,4327,0,44.93,19.69
臺中市,烏日區,螺潭里,1075,484,591,8,1083,2158,0,50.19,22.43
臺中市,烏日區,北里里,752,309,443,9,761,1651,0,46.09,18.72
臺中市,烏日區,南里里,652,348,304,7,659,1350,0,48.81,25.78
臺中市,烏日區,溪尾里,366,218,148,5,371,829,0,44.75,26.3
臺中市,烏日區,合計,28952,13465,15487,262,29214,63587,76907,45.94,21.18
臺中市,大肚區,王田里,1739,762,977,18,1757,4325,0,40.62,17.62
臺中市,大肚區,中和里,410,179,231,5,415,865,0,47.98,20.69
臺中市,大肚區,福山里,1490,687,803,12,1502,3486,0,43.09,19.71
臺中市,大肚區,營埔里,642,316,326,6,648,1505,0,43.06,21.0
臺中市,大肚區,社腳里,1094,568,526,12,1106,2438,0,45.37,23.3
臺中市,大肚區,新興里,1126,542,584,8,1134,2601,0,43.6,20.84
臺中市,大肚區,大東里,1368,715,653,12,1380,3003,0,45.95,23.81
臺中市,大肚區,大肚里,1095,562,533,9,1104,2165,0,50.99,25.96
臺中市,大肚區,永和里,397,208,189,6,403,819,0,49.21,25.4
臺中市,大肚區,磺溪里,726,338,388,8,734,1699,0,43.2,19.89
臺中市,大肚區,永順里,767,334,433,9,776,1688,0,45.97,19.79
臺中市,大肚區,成功里,369,195,174,5,374,943,0,39.66,20.68
臺中市,大肚區,山陽里,578,279,299,6,584,1310,0,44.58,21.3
臺中市,大肚區,頂街里,3201,1627,1574,28,3229,7418,0,43.53,21.93
臺中市,大肚區,瑞井里,2052,926,1126,21,2073,5061,0,40.96,18.3
臺中市,大肚區,蔗廍里,1940,788,1152,13,1953,4958,0,39.39,15.89
臺中市,大肚區,自強里,1501,800,701,15,1516,3471,0,43.68,23.05
臺中市,大肚區,合計,20495,9826,10669,193,20688,47755,56669,43.32,20.58
臺中市,龍井區,竹坑里,1237,624,613,7,1244,3019,0,41.21,20.67
臺中市,龍井區,龍東里,1161,562,599,4,1165,2849,0,40.89,19.73
臺中市,龍井區,龍西里,772,416,356,12,784,1822,0,43.03,22.83
臺中市,龍井區,田中里,1578,732,846,16,1594,3624,0,43.98,20.2
臺中市,龍井區,福田里,377,195,182,6,383,1043,0,36.72,18.7
臺中市,龍井區,麗水里,926,509,417,8,934,2271,0,41.13,22.41
臺中市,龍井區,龍津里,1980,825,1155,28,2008,5015,0,40.04,16.45
臺中市,龍井區,三德里,1041,415,626,7,1048,2952,0,35.5,14.06
臺中市,龍井區,忠和里,1971,812,1159,16,1987,4892,0,40.62,16.6
臺中市,龍井區,山腳里,2186,970,1216,26,2212,5745,0,38.5,16.88
臺中市,龍井區,龍泉里,3086,1527,1559,35,3121,7612,0,41.0,20.06
臺中市,龍井區,龍崗里,1080,506,574,6,1086,2640,0,41.14,19.17
臺中市,龍井區,新庄里,2528,1207,1321,22,2550,6354,0,40.13,19.0
臺中市,龍井區,南寮里,704,294,410,7,711,1558,0,45.64,18.87
臺中市,龍井區,新東里,2079,1069,1010,17,2096,4747,0,44.15,22.52
臺中市,龍井區,東海里,3834,2098,1736,24,3858,8616,0,44.78,24.35
臺中市,龍井區,合計,26540,12761,13779,241,26781,64759,78039,41.35,19.71
臺中市,霧峰區,桐林里,540,225,315,6,546,1194,0,45.73,18.84
臺中市,霧峰區,吉峰里,4000,1959,2041,24,4024,9381,0,42.9,20.88
臺中市,霧峰區,甲寅里,1965,996,969,21,1986,4671,0,42.52,21.32
臺中市,霧峰區,本鄉里,1093,528,565,6,1099,2320,0,47.37,22.76
臺中市,霧峰區,中正里,1002,495,507,1,1003,2025,0,49.53,24.44
臺中市,霧峰區,錦榮里,563,283,280,5,568,1224,0,46.41,23.12
臺中市,霧峰區,萊園里,486,215,271,10,496,1045,0,47.46,20.57
臺中市,霧峰區,本堂里,2663,1409,1254,15,2678,5783,0,46.31,24.36
臺中市,霧峰區,坑口里,1331,701,630,14,1345,2918,0,46.09,24.02
臺中市,霧峰區,北柳里,1760,769,991,9,1769,3965,0,44.62,19.39
臺中市,霧峰區,南柳里,912,419,493,10,922,1860,0,49.57,22.53
臺中市,霧峰區,四德里,1030,463,567,6,1036,2470,0,41.94,18.74
臺中市,霧峰區,五福里,1197,547,650,16,1213,2651,0,45.76,20.63
臺中市,霧峰區,萬豐里,1103,460,643,9,1112,2577,0,43.15,17.85
臺中市,霧峰區,舊正里,883,406,477,7,890,2046,0,43.5,19.84
臺中市,霧峰區,峰谷里,430,165,265,6,436,1104,0,39.49,14.95
臺中市,霧峰區,六股里,1115,441,674,12,1127,2352,0,47.92,18.75
臺中市,霧峰區,丁台里,1074,406,668,14,1088,2284,0,47.64,17.78
臺中市,霧峰區,北勢里,952,534,418,2,954,2071,0,46.06,25.78
臺中市,霧峰區,南勢里,556,265,291,4,560,1307,0,42.85,20.28
臺中市,霧峰區,合計,24655,11686,12969,197,24852,55248,64801,44.98,21.15
臺中市,太平區,太平里,2170,937,1233,31,2201,5378,0,40.93,17.42
臺中市,太平區,長億里,2404,1174,1230,31,2435,6193,0,39.32,18.96
臺中市,太平區,中平里,1592,714,878,10,1602,4030,0,39.75,17.72
臺中市,太平區,中興里,1325,560,765,17,1342,3192,0,42.04,17.54
臺中市,太平區,建國里,1123,533,590,15,1138,2873,0,39.61,18.55
臺中市,太平區,東平里,1532,684,848,15,1547,4108,0,37.66,16.65
臺中市,太平區,宜欣里,2311,1035,1276,26,2337,6203,0,37.68,16.69
臺中市,太平區,中山里,1271,715,556,12,1283,3727,0,34.42,19.18
臺中市,太平區,坪林里,1440,815,625,19,1459,3294,0,44.29,24.74
臺中市,太平區,光華里,2079,1135,944,24,2103,5188,0,40.54,21.88
臺中市,太平區,新坪里,2768,1457,1311,22,2790,7707,0,36.2,18.9
臺中市,太平區,新光里,3081,1470,1611,33,3114,7600,0,40.97,19.34
臺中市,太平區,新福里,2734,1364,1370,26,2760,6669,0,41.39,20.45
臺中市,太平區,頭汴里,657,318,339,8,665,1767,0,37.63,18.0
臺中市,太平區,東汴里,401,166,235,6,407,1199,0,33.94,13.84
臺中市,太平區,興隆里,1183,586,597,13,1196,3227,0,37.06,18.16
臺中市,太平區,光隆里,1185,424,761,10,1195,3052,0,39.15,13.89
臺中市,太平區,德隆里,1774,751,1023,18,1792,4742,0,37.79,15.84
臺中市,太平區,黃竹里,248,102,146,5,253,649,0,38.98,15.72
臺中市,太平區,永成里,2528,1156,1372,26,2554,6807,0,37.52,16.98
臺中市,太平區,永平里,1534,682,852,9,1543,4018,0,38.4,16.97
臺中市,太平區,成功里,1453,590,863,14,1467,3985,0,36.81,14.81
臺中市,太平區,東和里,1021,475,546,11,1032,2818,0,36.62,16.86
臺中市,太平區,中政里,1389,606,783,15,1404,3701,0,37.94,16.37
臺中市,太平區,平安里,868,367,501,12,880,2204,0,39.93,16.65
臺中市,太平區,建興里,1002,465,537,8,1010,2894,0,34.9,16.07
臺中市,太平區,新興里,2250,1078,1172,15,2265,5508,0,41.12,19.57
臺中市,太平區,新高里,3239,1642,1597,26,3265,8031,0,40.65,20.45
臺中市,太平區,新吉里,2203,1154,1049,17,2220,5692,0,39.0,20.27
臺中市,太平區,新城里,1936,1008,928,27,1963,5664,0,34.66,17.8
臺中市,太平區,宜佳里,2301,1177,1124,23,2324,6055,0,38.38,19.44
臺中市,太平區,宜昌里,1394,616,778,20,1414,3821,0,37.01,16.12
臺中市,太平區,光明里,1496,862,634,18,1514,3832,0,39.51,22.49
臺中市,太平區,豐年里,1905,1025,880,20,1925,4323,0,44.53,23.71
臺中市,太平區,大興里,930,451,479,9,939,2539,0,36.98,17.76
臺中市,太平區,勤益里,897,531,366,13,910,2139,0,42.54,24.82
臺中市,太平區,聖和里,584,261,323,10,594,1536,0,38.67,16.99
臺中市,太平區,福隆里,1451,672,779,14,1465,3631,0,40.35,18.51
臺中市,太平區,永隆里,894,397,497,13,907,2486,0,36.48,15.97
臺中市,太平區,合計,62553,30155,32398,661,63214,162482,195494,38.91,18.56
臺中市,大里區,大里里,1533,697,836,20,1553,3731,0,41.62,18.68
臺中市,大里區,新里里,4235,1971,2264,34,4269,10438,0,40.9,18.88
臺中市,大里區,樹王里,1557,599,958,14,1571,3621,0,43.39,16.54
臺中市,大里區,東興里,2906,1320,1586,23,2929,6901,0,42.44,19.13
臺中市,大里區,祥興里,3091,1360,1731,30,3121,7279,0,42.88,18.68
臺中市,大里區,日新里,1820,889,931,16,1836,4162,0,44.11,21.36
臺中市,大里區,西榮里,2198,1000,1198,26,2224,5520,0,40.29,18.12
臺中市,大里區,內新里,3379,1700,1679,28,3407,8350,0,40.8,20.36
臺中市,大里區,東昇里,1409,660,749,22,1431,3400,0,42.09,19.41
臺中市,大里區,立仁里,1970,858,1112,25,1995,5356,0,37.25,16.02
臺中市,大里區,新仁里,3227,1424,1803,36,3263,7841,0,41.61,18.16
臺中市,大里區,大元里,1876,812,1064,17,1893,4167,0,45.43,19.49
臺中市,大里區,夏田里,465,167,298,4,469,982,0,47.76,17.01
臺中市,大里區,仁化里,3121,1346,1775,35,3156,8402,0,37.56,16.02
臺中市,大里區,健民里,1701,748,953,16,1717,4704,0,36.5,15.9
臺中市,大里區,塗城里,3197,1374,1823,30,3227,8359,0,38.61,16.44
臺中市,大里區,瑞城里,4492,2117,2375,27,4519,11593,0,38.98,18.26
臺中市,大里區,金城里,3745,1742,2003,29,3774,9507,0,39.7,18.32
臺中市,大里區,東湖里,4018,1829,2189,36,4054,10403,0,38.97,17.58
臺中市,大里區,西湖里,1168,498,670,12,1180,2803,0,42.1,17.77
臺中市,大里區,國光里,2452,1276,1176,15,2467,5719,0,43.14,22.31
臺中市,大里區,大明里,1675,779,896,12,1687,4144,0,40.71,18.8
臺中市,大里區,永隆里,4411,2241,2170,40,4451,9667,0,46.04,23.18
臺中市,大里區,長榮里,3800,1889,1911,42,3842,8636,0,44.49,21.87
臺中市,大里區,中新里,2119,1049,1070,24,2143,5389,0,39.77,19.47
臺中市,大里區,立德里,3020,1382,1638,26,3046,7712,0,39.5,17.92
臺中市,大里區,仁德里,2309,1037,1272,17,2326,5865,0,39.66,17.68
臺中市,大里區,合計,70894,32764,38130,656,71550,174651,212710,40.97,18.76
臺中市,和平區,南勢里,646,420,226,14,660,1883,0,35.05,22.3
臺中市,和平區,天輪里,141,77,64,4,145,456,0,31.8,16.89
臺中市,和平區,博愛里,529,382,147,6,535,1641,0,32.6,23.28
臺中市,和平區,中坑里,193,134,59,2,195,461,0,42.3,29.07
臺中市,和平區,自由里,415,317,98,10,425,1081,0,39.32,29.32
臺中市,和平區,達觀里,420,300,120,2,422,1107,0,38.12,27.1
臺中市,和平區,梨山里,427,268,159,6,433,1939,0,22.33,13.82
臺中市,和平區,平等里,209,156,53,3,212,868,0,24.42,17.97
臺中市,和平區,合計,2980,2054,926,47,3027,9436,10841,32.08,21.77
臺中市,合計,合計,975209,474423,500786,9323,984532,2337667,2819081,42.12,20.29
臺南市,新營區,忠政里,1943,998,945,12,1955,4561,0,42.86,21.88
臺南市,新營區,民權里,912,394,518,5,917,2212,0,41.46,17.81
臺南市,新營區,三仙里,1146,469,677,10,1156,2807,0,41.18,16.71
臺南市,新營區,大宏里,1165,469,696,14,1179,2795,0,42.18,16.78
臺南市,新營區,王公里,1573,697,876,16,1589,4010,0,39.63,17.38
臺南市,新營區,中營里,468,188,280,9,477,1131,0,42.18,16.62
臺南市,新營區,土庫里,571,172,399,6,577,1430,0,40.35,12.03
臺南市,新營區,南興里,887,390,497,4,891,2371,0,37.58,16.45
臺南市,新營區,興業里,736,336,400,6,742,1734,0,42.79,19.38
臺南市,新營區,民生里,1202,459,743,10,1212,3194,0,37.95,14.37
臺南市,新營區,民榮里,1640,639,1001,21,1661,4405,0,37.71,14.51
臺南市,新營區,埤寮里,642,228,414,12,654,1632,0,40.07,13.97
臺南市,新營區,護鎮里,512,169,343,4,516,1333,0,38.71,12.68
臺南市,新營區,太南里,599,151,448,6,605,1724,0,35.09,8.76
臺南市,新營區,太北里,657,195,462,5,662,1696,0,39.03,11.5
臺南市,新營區,南紙里,1322,544,778,13,1335,3665,0,36.43,14.84
臺南市,新營區,嘉芳里,660,214,446,5,665,1880,0,35.37,11.38
臺南市,新營區,五興里,610,151,459,5,615,1555,0,39.55,9.71
臺南市,新營區,姑爺里,341,100,241,6,347,897,0,38.68,11.15
臺南市,新營區,新北里,1885,840,1045,11,1896,4874,0,38.9,17.23
臺南市,新營區,新南里,2045,854,1191,11,2056,5086,0,40.42,16.79
臺南市,新營區,新東里,2500,1187,1313,19,2519,6401,0,39.35,18.54
臺南市,新營區,永平里,1131,446,685,10,1141,2599,0,43.9,17.16
臺南市,新營區,合計,25147,10290,14857,220,25367,63992,76027,39.64,16.08
臺南市,鹽水區,水秀里,592,193,399,2,594,1549,0,38.35,12.46
臺南市,鹽水區,橋南里,1294,448,846,15,1309,3724,0,35.15,12.03
臺南市,鹽水區,汫水里,313,41,272,11,324,875,0,37.03,4.69
臺南市,鹽水區,岸內里,1445,510,935,18,1463,3815,0,38.35,13.37
臺南市,鹽水區,歡雅里,607,173,434,7,614,1621,0,37.88,10.67
臺南市,鹽水區,津城里,608,200,408,7,615,1413,0,43.52,14.15
臺南市,鹽水區,月港里,653,279,374,0,653,1575,0,41.46,17.71
臺南市,鹽水區,三明里,623,138,485,4,627,1519,0,41.28,9.08
臺南市,鹽水區,義中里,562,141,421,8,570,1545,0,36.89,9.13
臺南市,鹽水區,文昌里,367,93,274,2,369,981,0,37.61,9.48
臺南市,鹽水區,竹林里,438,113,325,6,444,1073,0,41.38,10.53
臺南市,鹽水區,三和里,370,107,263,6,376,900,0,41.78,11.89
臺南市,鹽水區,坔頭港里,469,133,336,6,475,1360,0,34.93,9.78
臺南市,鹽水區,合計,8341,2569,5772,92,8433,21950,24892,38.42,11.7
臺南市,白河區,白河里,672,210,462,2,674,1688,0,39.93,12.44
臺南市,白河區,永安里,1275,411,864,3,1278,2937,0,43.51,13.99
臺南市,白河區,外角里,546,187,359,4,550,1364,0,40.32,13.71
臺南市,白河區,庄內里,640,201,439,12,652,1596,0,40.85,12.59
臺南市,白河區,秀祐里,338,107,231,4,342,874,0,39.13,12.24
臺南市,白河區,河東里,544,179,365,10,554,1334,0,41.53,13.42
臺南市,白河區,虎山里,173,58,115,5,178,440,0,40.45,13.18
臺南市,白河區,大林里,181,43,138,2,183,560,0,32.68,7.68
臺南市,白河區,崁頭里,121,39,82,2,123,369,0,33.33,10.57
臺南市,白河區,六溪里,159,35,124,3,162,487,0,33.26,7.19
臺南市,白河區,仙草里,381,138,243,7,388,1178,0,32.94,11.71
臺南市,白河區,關嶺里,333,81,252,4,337,1001,0,33.67,8.09
臺南市,白河區,大竹里,489,150,339,9,498,1380,0,36.09,10.87
臺南市,白河區,竹門里,318,107,211,7,325,836,0,38.88,12.8
臺南市,白河區,崎內里,191,87,104,3,194,705,0,27.52,12.34
臺南市,白河區,昇安里,477,134,343,6,483,1303,0,37.07,10.28
臺南市,白河區,汴頭里,283,69,214,2,285,707,0,40.31,9.76
臺南市,白河區,內角里,253,72,181,4,257,657,0,39.12,10.96
臺南市,白河區,詔豐里,743,198,545,11,754,1930,0,39.07,10.26
臺南市,白河區,廣蓮里,581,155,426,9,590,1458,0,40.47,10.63
臺南市,白河區,馬稠後里,444,122,322,8,452,1318,0,34.29,9.26
臺南市,白河區,合計,9142,2783,6359,117,9259,24122,26978,38.38,11.54
臺南市,柳營區,士林里,712,263,449,9,721,1825,0,39.51,14.41
臺南市,柳營區,光福里,704,262,442,4,708,1608,0,44.03,16.29
臺南市,柳營區,中埕里,451,163,288,2,453,1107,0,40.92,14.72
臺南市,柳營區,東昇里,1092,388,704,10,1102,2722,0,40.48,14.25
臺南市,柳營區,八翁里,508,168,340,3,511,1368,0,37.35,12.28
臺南市,柳營區,人和里,296,107,189,2,298,727,0,40.99,14.72
臺南市,柳營區,太康里,604,201,403,12,616,1454,0,42.37,13.82
臺南市,柳營區,重溪里,647,173,474,5,652,1738,0,37.51,9.95
臺南市,柳營區,篤農里,469,136,333,6,475,1275,0,37.25,10.67
臺南市,柳營區,大農里,254,54,200,4,258,652,0,39.57,8.28
臺南市,柳營區,神農里,478,127,351,12,490,1337,0,36.65,9.5
臺南市,柳營區,果毅里,436,121,315,5,441,1192,0,37.0,10.15
臺南市,柳營區,旭山里,506,158,348,1,507,1517,0,33.42,10.42
臺南市,柳營區,合計,7157,2321,4836,75,7232,18522,20733,39.05,12.53
臺南市,後壁區,後壁里,690,258,432,7,697,1620,0,43.02,15.93
臺南市,後壁區,侯伯里,504,143,361,7,511,1264,0,40.43,11.31
臺南市,後壁區,嘉苳里,479,147,332,6,485,1275,0,38.04,11.53
臺南市,後壁區,土溝里,526,128,398,6,532,1304,0,40.8,9.82
臺南市,後壁區,竹新里,575,113,462,6,581,1336,0,43.49,8.46
臺南市,後壁區,新東里,604,188,416,9,613,1610,0,38.07,11.68
臺南市,後壁區,頂安里,483,179,304,8,491,1223,0,40.15,14.64
臺南市,後壁區,長安里,507,188,319,6,513,1216,0,42.19,15.46
臺南市,後壁區,福安里,683,226,457,7,690,1753,0,39.36,12.89
臺南市,後壁區,菁寮里,564,169,395,7,571,1379,0,41.41,12.26
臺南市,後壁區,新嘉里,302,80,222,5,307,966,0,31.78,8.28
臺南市,後壁區,長短樹里,815,250,565,19,834,1961,0,42.53,12.75
臺南市,後壁區,上茄苳里,861,227,634,12,873,2164,0,40.34,10.49
臺南市,後壁區,菁豐里,450,150,300,6,456,1194,0,38.19,12.56
臺南市,後壁區,合計,8043,2446,5597,111,8154,20265,22532,40.24,12.07
臺南市,東山區,東山里,476,195,281,6,482,1400,0,34.43,13.93
臺南市,東山區,東中里,870,326,544,5,875,2475,0,35.35,13.17
臺南市,東山區,東正里,470,130,340,2,472,1405,0,33.59,9.25
臺南市,東山區,三榮里,285,84,201,3,288,920,0,31.3,9.13
臺南市,東山區,大客里,295,98,197,3,298,1058,0,28.17,9.26
臺南市,東山區,科里里,419,130,289,5,424,1193,0,35.54,10.9
臺南市,東山區,東河里,292,75,217,8,300,826,0,36.32,9.08
臺南市,東山區,南溪里,117,31,86,1,118,420,0,28.1,7.38
臺南市,東山區,水雲里,106,30,76,0,106,376,0,28.19,7.98
臺南市,東山區,林安里,136,42,94,4,140,370,0,37.84,11.35
臺南市,東山區,東原里,619,230,389,9,628,2040,0,30.78,11.27
臺南市,東山區,嶺南里,147,53,94,1,148,647,0,22.87,8.19
臺南市,東山區,南勢里,278,83,195,2,280,1054,0,26.57,7.87
臺南市,東山區,青山里,299,109,190,5,304,1052,0,28.9,10.36
臺南市,東山區,高原里,219,108,111,2,221,877,0,25.2,12.31
臺南市,東山區,聖賢里,722,211,511,11,733,1847,0,39.69,11.42
臺南市,東山區,合計,5750,1935,3815,67,5817,17960,19922,32.39,10.77
臺南市,麻豆區,東角里,1121,372,749,11,1132,2562,0,44.18,14.52
臺南市,麻豆區,晋江里,1101,297,804,18,1119,2463,0,45.43,12.06
臺南市,麻豆區,巷口里,970,321,649,5,975,2086,0,46.74,15.39
臺南市,麻豆區,中興里,851,263,588,7,858,1936,0,44.32,13.58
臺南市,麻豆區,興農里,647,171,476,6,653,1433,0,45.57,11.93
臺南市,麻豆區,油車里,1593,400,1193,10,1603,3474,0,46.14,11.51
臺南市,麻豆區,北勢里,458,78,380,3,461,1093,0,42.18,7.14
臺南市,麻豆區,大埕里,1250,336,914,9,1259,2846,0,44.24,11.81
臺南市,麻豆區,南勢里,989,332,657,11,1000,2315,0,43.2,14.34
臺南市,麻豆區,寮廍里,747,152,595,4,751,1645,0,45.65,9.24
臺南市,麻豆區,埤頭里,947,180,767,16,963,2284,0,42.16,7.88
臺南市,麻豆區,海埔里,832,188,644,16,848,2089,0,40.59,9.0
臺南市,麻豆區,港尾里,515,125,390,9,524,1232,0,42.53,10.15
臺南市,麻豆區,麻口里,446,88,358,3,449,1171,0,38.34,7.51
臺南市,麻豆區,安業里,627,128,499,6,633,1297,0,48.8,9.87
臺南市,麻豆區,安正里,376,88,288,3,379,925,0,40.97,9.51
臺南市,麻豆區,新興里,795,191,604,10,805,1871,0,43.03,10.21
臺南市,麻豆區,謝厝寮里,773,149,624,15,788,1633,0,48.25,9.12
臺南市,麻豆區,井東里,756,162,594,4,760,1704,0,44.6,9.51
臺南市,麻豆區,清水里,621,170,451,4,625,1449,0,43.13,11.73
臺南市,麻豆區,合計,16415,4191,12224,170,16585,37508,43610,44.22,11.17
臺南市,下營區,下營里,617,240,377,4,621,1503,0,41.32,15.97
臺南市,下營區,仁里里,701,219,482,6,707,1925,0,36.73,11.38
臺南市,下營區,宅內里,606,224,382,8,614,1601,0,38.35,13.99
臺南市,下營區,後街里,609,228,381,6,615,1555,0,39.55,14.66
臺南市,下營區,新興里,681,237,444,5,686,1945,0,35.27,12.19
臺南市,下營區,營前里,807,266,541,11,818,2079,0,39.35,12.79
臺南市,下營區,開化里,729,197,532,6,735,1817,0,40.45,10.84
臺南市,下營區,西連里,392,90,302,5,397,866,0,45.84,10.39
臺南市,下營區,賀建里,424,129,295,3,427,1269,0,33.65,10.17
臺南市,下營區,茅營里,851,224,627,8,859,2146,0,40.03,10.44
臺南市,下營區,大吉里,566,205,361,8,574,1539,0,37.3,13.32
臺南市,下營區,紅甲里,855,197,658,12,867,2173,0,39.9,9.07
臺南市,下營區,合計,7838,2456,5382,82,7920,20418,23214,38.79,12.03
臺南市,六甲區,六甲里,1059,324,735,11,1070,2866,0,37.33,11.3
臺南市,六甲區,甲東里,959,279,680,12,971,2601,0,37.33,10.73
臺南市,六甲區,甲南里,542,182,360,10,552,1327,0,41.6,13.72
臺南市,六甲區,七甲里,692,194,498,12,704,1910,0,36.86,10.16
臺南市,六甲區,二甲里,1257,390,867,17,1274,3299,0,38.62,11.82
臺南市,六甲區,水林里,771,211,560,5,776,2062,0,37.63,10.23
臺南市,六甲區,中社里,613,209,404,11,624,1583,0,39.42,13.2
臺南市,六甲區,龜港里,477,158,319,3,480,1229,0,39.06,12.86
臺南市,六甲區,菁埔里,265,95,170,3,268,583,0,45.97,16.3
臺南市,六甲區,王爺里,196,53,143,0,196,719,0,27.26,7.37
臺南市,六甲區,大丘里,184,55,129,1,185,580,0,31.9,9.48
臺南市,六甲區,合計,7015,2150,4865,85,7100,18759,21572,37.85,11.46
臺南市,官田區,官田里,809,255,554,8,817,2045,0,39.95,12.47
臺南市,官田區,二鎮里,1312,292,1020,18,1330,3141,0,42.34,9.3
臺南市,官田區,大崎里,144,48,96,2,146,402,0,36.32,11.94
臺南市,官田區,隆田里,783,290,493,10,793,1948,0,40.71,14.89
臺南市,官田區,隆本里,1410,544,866,15,1425,3476,0,41.0,15.65
臺南市,官田區,南廍里,457,125,332,4,461,1243,0,37.09,10.06
臺南市,官田區,社子里,313,67,246,3,316,855,0,36.96,7.84
臺南市,官田區,烏山頭里,521,125,396,4,525,1197,0,43.86,10.44
臺南市,官田區,渡拔里,1074,311,763,26,1100,2498,0,44.04,12.45
臺南市,官田區,東西庄里,803,91,712,11,814,1798,0,45.27,5.06
臺南市,官田區,合計,7626,2148,5478,101,7727,18603,21123,41.54,11.55
臺南市,大內區,石湖里,385,121,264,4,389,992,0,39.21,12.2
臺南市,大內區,石林里,233,54,179,2,235,619,0,37.96,8.72
臺南市,大內區,石城里,522,124,398,6,528,1411,0,37.42,8.79
臺南市,大內區,內江里,326,124,202,4,330,885,0,37.29,14.01
臺南市,大內區,大內里,349,113,236,7,356,744,0,47.85,15.19
臺南市,大內區,內郭里,249,70,179,3,252,598,0,42.14,11.71
臺南市,大內區,頭社里,337,100,237,3,340,969,0,35.09,10.32
臺南市,大內區,環湖里,235,69,166,6,241,722,0,33.38,9.56
臺南市,大內區,二溪里,329,118,211,2,331,822,0,40.27,14.36
臺南市,大內區,曲溪里,220,47,173,6,226,550,0,41.09,8.55
臺南市,大內區,合計,3185,940,2245,43,3228,8312,9096,38.84,11.31
臺南市,佳里區,東寧里,1001,337,664,6,1007,2192,0,45.94,15.37
臺南市,佳里區,忠仁里,1080,309,771,9,1089,2827,0,38.52,10.93
臺南市,佳里區,鎮山里,2156,668,1488,13,2169,5534,0,39.19,12.07
臺南市,佳里區,建南里,1602,535,1067,13,1615,4239,0,38.1,12.62
臺南市,佳里區,安西里,2274,745,1529,22,2296,5723,0,40.12,13.02
臺南市,佳里區,六安里,1574,582,992,16,1590,3989,0,39.86,14.59
臺南市,佳里區,佳化里,815,239,576,4,819,2115,0,38.72,11.3
臺南市,佳里區,海澄里,769,238,531,12,781,2153,0,36.27,11.05
臺南市,佳里區,民安里,663,154,509,4,667,1660,0,40.18,9.28
臺南市,佳里區,子龍里,989,248,741,9,998,2328,0,42.87,10.65
臺南市,佳里區,營溪里,401,127,274,7,408,1045,0,39.04,12.15
臺南市,佳里區,文新里,2025,751,1274,4,2029,5063,0,40.08,14.83
臺南市,佳里區,佳興里,897,239,658,11,908,2103,0,43.18,11.36
臺南市,佳里區,下營里,723,211,512,2,725,1786,0,40.59,11.81
臺南市,佳里區,塭內里,1059,241,818,11,1070,2729,0,39.21,8.83
臺南市,佳里區,南勢里,1693,528,1165,8,1701,4415,0,38.53,11.96
臺南市,佳里區,合計,19721,6152,13569,151,19872,49901,58600,39.82,12.33
臺南市,學甲區,仁得里,1581,466,1115,17,1598,3771,0,42.38,12.36
臺南市,學甲區,新榮里,886,240,646,4,890,2308,0,38.56,10.4
臺南市,學甲區,光華里,456,105,351,2,458,1207,0,37.95,8.7
臺南市,學甲區,宅港里,286,89,197,1,287,771,0,37.22,11.54
臺南市,學甲區,慈福里,776,258,518,6,782,1967,0,39.76,13.12
臺南市,學甲區,秀昌里,955,272,683,11,966,2463,0,39.22,11.04
臺南市,學甲區,明宜里,778,184,594,6,784,1887,0,41.55,9.75
臺南市,學甲區,豐和里,447,98,349,4,451,1175,0,38.38,8.34
臺南市,學甲區,平和里,373,61,312,4,377,1001,0,37.66,6.09
臺南市,學甲區,新達里,784,258,526,13,797,2054,0,38.8,12.56
臺南市,學甲區,大灣里,378,104,274,7,385,939,0,41.0,11.08
臺南市,學甲區,三慶里,476,141,335,7,483,1310,0,36.87,10.76
臺南市,學甲區,中洲里,467,147,320,6,473,1367,0,34.6,10.75
臺南市,學甲區,合計,8643,2423,6220,88,8731,22220,25121,39.29,10.9
臺南市,西港區,西港里,1236,350,886,19,1255,3112,0,40.33,11.25
臺南市,西港區,南海里,983,241,742,8,991,2413,0,41.07,9.99
臺南市,西港區,港東里,601,144,457,2,603,1625,0,37.11,8.86
臺南市,西港區,檨林里,542,143,399,8,550,1640,0,33.54,8.72
臺南市,西港區,後營里,498,108,390,9,507,1436,0,35.31,7.52
臺南市,西港區,營西里,473,120,353,3,476,1456,0,32.69,8.24
臺南市,西港區,金砂里,315,78,237,4,319,758,0,42.08,10.29
臺南市,西港區,劉厝里,494,131,363,7,501,1338,0,37.44,9.79
臺南市,西港區,竹林里,556,124,432,5,561,1342,0,41.8,9.24
臺南市,西港區,永樂里,539,134,405,4,543,1352,0,40.16,9.91
臺南市,西港區,新復里,279,101,178,7,286,805,0,35.53,12.55
臺南市,西港區,慶安里,1568,478,1090,17,1585,4193,0,37.8,11.4
臺南市,西港區,合計,8084,2152,5932,93,8177,21470,24521,38.09,10.02
臺南市,七股區,後港里,390,93,297,3,393,998,0,39.38,9.32
臺南市,七股區,大潭里,232,48,184,4,236,648,0,36.42,7.41
臺南市,七股區,篤加里,307,98,209,1,308,820,0,37.56,11.95
臺南市,七股區,頂山里,305,95,210,6,311,809,0,38.44,11.74
臺南市,七股區,西寮里,161,41,120,4,165,444,0,37.16,9.23
臺南市,七股區,塩埕里,154,31,123,1,155,410,0,37.8,7.56
臺南市,七股區,龍山里,608,111,497,8,616,1608,0,38.31,6.9
臺南市,七股區,溪南里,128,45,83,1,129,343,0,37.61,13.12
臺南市,七股區,七股里,346,77,269,1,347,861,0,40.3,8.94
臺南市,七股區,玉成里,276,76,200,5,281,775,0,36.26,9.81
臺南市,七股區,大埕里,881,216,665,11,892,2548,0,35.01,8.48
臺南市,七股區,樹林里,626,138,488,9,635,1894,0,33.53,7.29
臺南市,七股區,中寮里,236,60,176,3,239,683,0,34.99,8.78
臺南市,七股區,竹橋里,482,129,353,8,490,1214,0,40.36,10.63
臺南市,七股區,義合里,709,196,513,8,717,1858,0,38.59,10.55
臺南市,七股區,永吉里,347,124,223,1,348,992,0,35.08,12.5
臺南市,七股區,三股里,443,116,327,3,446,1329,0,33.56,8.73
臺南市,七股區,十份里,429,140,289,6,435,1361,0,31.96,10.29
臺南市,七股區,合計,7060,1834,5226,83,7143,19595,21996,36.45,9.36
臺南市,將軍區,長榮里,436,119,317,3,439,1136,0,38.64,10.48
臺南市,將軍區,玉山里,259,48,211,4,263,821,0,32.03,5.85
臺南市,將軍區,廣山里,182,62,120,5,187,636,0,29.4,9.75
臺南市,將軍區,長沙里,447,100,347,7,454,1312,0,34.6,7.62
臺南市,將軍區,平沙里,424,81,343,11,435,1171,0,37.15,6.92
臺南市,將軍區,鯤鯓里,654,128,526,8,662,1862,0,35.55,6.87
臺南市,將軍區,鯤溟里,275,57,218,3,278,946,0,29.39,6.03
臺南市,將軍區,巷埔里,469,90,379,4,473,1166,0,40.57,7.72
臺南市,將軍區,西甲里,914,256,658,6,920,2358,0,39.02,10.86
臺南市,將軍區,忠嘉里,848,245,603,13,861,2413,0,35.68,10.15
臺南市,將軍區,苓仔寮里,759,196,563,9,768,1964,0,39.1,9.98
臺南市,將軍區,將軍里,547,151,396,3,550,1528,0,35.99,9.88
臺南市,將軍區,合計,6214,1533,4681,76,6290,17313,18966,36.33,8.85
臺南市,北門區,保吉里,383,137,246,6,389,1309,0,29.72,10.47
臺南市,北門區,雙春里,146,46,100,3,149,451,0,33.04,10.2
臺南市,北門區,北門里,270,105,165,2,272,820,0,33.17,12.8
臺南市,北門區,錦湖里,248,87,161,3,251,909,0,27.61,9.57
臺南市,北門區,三光里,397,142,255,3,400,1152,0,34.72,12.33
臺南市,北門區,玉港里,243,62,181,4,247,702,0,35.19,8.83
臺南市,北門區,慈安里,200,63,137,1,201,726,0,27.69,8.68
臺南市,北門區,永隆里,280,104,176,5,285,843,0,33.81,12.34
臺南市,北門區,蚵寮里,429,132,297,3,432,1415,0,30.53,9.33
臺南市,北門區,文山里,433,112,321,7,440,1222,0,36.01,9.17
臺南市,北門區,合計,3029,990,2039,37,3066,9549,10460,32.11,10.37
臺南市,新化區,武安里,1350,553,797,13,1363,3038,0,44.87,18.2
臺南市,新化區,東榮里,1576,609,967,18,1594,3973,0,40.12,15.33
臺南市,新化區,護國里,1080,419,661,9,1089,2724,0,39.98,15.38
臺南市,新化區,太平里,1833,662,1171,16,1849,4411,0,41.92,15.01
臺南市,新化區,協興里,1284,492,792,16,1300,3203,0,40.59,15.36
臺南市,新化區,唪口里,851,282,569,10,861,2153,0,39.99,13.1
臺南市,新化區,北勢里,559,189,370,7,566,1482,0,38.19,12.75
臺南市,新化區,豐榮里,1203,478,725,17,1220,3226,0,37.82,14.82
臺南市,新化區,全興里,1090,468,622,15,1105,2804,0,39.41,16.69
臺南市,新化區,崙頂里,845,250,595,13,858,2123,0,40.41,11.78
臺南市,新化區,知義里,833,295,538,9,842,2155,0,39.07,13.69
臺南市,新化區,山脚里,567,181,386,5,572,1679,0,34.07,10.78
臺南市,新化區,大坑里,160,36,124,2,162,425,0,38.12,8.47
臺南市,新化區,𦰡拔里,736,278,458,9,745,2087,0,35.7,13.32
臺南市,新化區,羊林里,354,133,221,3,357,899,0,39.71,14.79
臺南市,新化區,礁坑里,375,65,310,9,384,933,0,41.16,6.97
臺南市,新化區,合計,14696,5390,9306,171,14867,37315,43049,39.84,14.44
臺南市,善化區,東關里,436,171,265,8,444,1123,0,39.54,15.23
臺南市,善化區,坐駕里,1560,638,922,15,1575,3901,0,40.37,16.35
臺南市,善化區,光文里,2207,851,1356,23,2230,5414,0,41.19,15.72
臺南市,善化區,文昌里,1017,354,663,5,1022,2685,0,38.06,13.18
臺南市,善化區,南關里,733,225,508,7,740,1791,0,41.32,12.56
臺南市,善化區,文正里,629,200,429,4,633,1601,0,39.54,12.49
臺南市,善化區,胡家里,530,105,425,7,537,1235,0,43.48,8.5
臺南市,善化區,胡厝里,838,244,594,13,851,2010,0,42.34,12.14
臺南市,善化區,什乃里,493,145,348,5,498,1226,0,40.62,11.83
臺南市,善化區,溪美里,839,278,561,10,849,1944,0,43.67,14.3
臺南市,善化區,六分里,283,64,219,3,286,677,0,42.25,9.45
臺南市,善化區,六德里,392,90,302,5,397,1041,0,38.14,8.65
臺南市,善化區,田寮里,674,192,482,6,680,1684,0,40.38,11.4
臺南市,善化區,牛庄里,679,220,459,11,690,1608,0,42.91,13.68
臺南市,善化區,嘉北里,636,185,451,11,647,1587,0,40.77,11.66
臺南市,善化區,嘉南里,427,107,320,3,430,1068,0,40.26,10.02
臺南市,善化區,小新里,1682,590,1092,13,1695,4425,0,38.31,13.33
臺南市,善化區,頂街里,484,186,298,0,484,1117,0,43.33,16.65
臺南市,善化區,昌隆里,781,210,571,9,790,1945,0,40.62,10.8
臺南市,善化區,蓮潭里,1371,498,873,5,1376,3324,0,41.4,14.98
臺南市,善化區,合計,16691,5553,11138,163,16854,41406,51052,40.7,13.41
臺南市,新市區,新市里,1143,399,744,10,1153,2990,0,38.56,13.34
臺南市,新市區,新和里,2653,950,1703,24,2677,6488,0,41.26,14.64
臺南市,新市區,社內里,1115,322,793,5,1120,2768,0,40.46,11.63
臺南市,新市區,大洲里,312,87,225,6,318,714,0,44.54,12.18
臺南市,新市區,豐華里,316,90,226,4,320,870,0,36.78,10.34
臺南市,新市區,三舍里,608,178,430,5,613,1563,0,39.22,11.39
臺南市,新市區,大營里,1253,472,781,7,1260,3380,0,37.28,13.96
臺南市,新市區,大社里,1727,472,1255,13,1740,4530,0,38.41,10.42
臺南市,新市區,潭頂里,675,203,472,7,682,1790,0,38.1,11.34
臺南市,新市區,港墘里,1169,358,811,11,1180,3330,0,35.44,10.75
臺南市,新市區,永就里,1237,442,795,7,1244,2946,0,42.23,15.0
臺南市,新市區,合計,12208,3973,8235,99,12307,31369,37721,39.23,12.67
臺南市,安定區,蘇林里,904,245,659,20,924,2065,0,44.75,11.86
臺南市,安定區,蘇厝里,776,250,526,9,785,2038,0,38.52,12.27
臺南市,安定區,安定里,567,167,400,3,570,1381,0,41.27,12.09
臺南市,安定區,安加里,892,276,616,10,902,2194,0,41.11,12.58
臺南市,安定區,港尾里,588,168,420,4,592,1485,0,39.87,11.31
臺南市,安定區,中榮里,718,222,496,7,725,1715,0,42.27,12.94
臺南市,安定區,港口里,1190,382,808,11,1201,2901,0,41.4,13.17
臺南市,安定區,港南里,1092,318,774,11,1103,2658,0,41.5,11.96
臺南市,安定區,中沙里,315,101,214,2,317,715,0,44.34,14.13
臺南市,安定區,新吉里,975,278,697,9,984,2448,0,40.2,11.36
臺南市,安定區,海寮里,1036,318,718,10,1046,2574,0,40.64,12.35
臺南市,安定區,文科里,680,175,505,4,684,1609,0,42.51,10.88
臺南市,安定區,嘉同里,922,266,656,15,937,2380,0,39.37,11.18
臺南市,安定區,合計,10655,3166,7489,115,10770,26163,30286,41.17,12.1
臺南市,山上區,明和里,573,210,363,7,580,1662,0,34.9,12.64
臺南市,山上區,南洲里,642,214,428,9,651,1522,0,42.77,14.06
臺南市,山上區,山上里,340,128,212,7,347,961,0,36.11,13.32
臺南市,山上區,新莊里,302,81,221,5,307,930,0,33.01,8.71
臺南市,山上區,玉峯里,198,66,132,1,199,560,0,35.54,11.79
臺南市,山上區,平陽里,137,69,68,1,138,351,0,39.32,19.66
臺南市,山上區,豐德里,119,42,77,7,126,392,0,32.14,10.71
臺南市,山上區,合計,2311,810,1501,37,2348,6378,7053,36.81,12.7
臺南市,玉井區,玉井里,447,235,212,6,453,1202,0,37.69,19.55
臺南市,玉井區,玉田里,1266,661,605,14,1280,3556,0,36.0,18.59
臺南市,玉井區,中正里,485,207,278,6,491,1198,0,40.98,17.28
臺南市,玉井區,竹圍里,478,214,264,8,486,1398,0,34.76,15.31
臺南市,玉井區,沙田里,196,92,104,8,204,497,0,41.05,18.51
臺南市,玉井區,三埔里,176,60,116,1,177,490,0,36.12,12.24
臺南市,玉井區,三和里,290,115,175,5,295,731,0,40.36,15.73
臺南市,玉井區,望明里,497,222,275,4,501,1428,0,35.08,15.55
臺南市,玉井區,層林里,205,76,129,3,208,580,0,35.86,13.1
臺南市,玉井區,豐里里,314,141,173,11,325,945,0,34.39,14.92
臺南市,玉井區,合計,4354,2023,2331,66,4420,12025,13483,36.76,16.82
臺南市,楠西區,楠西里,583,324,259,11,594,1779,0,33.39,18.21
臺南市,楠西區,灣丘里,292,130,162,2,294,1071,0,27.45,12.14
臺南市,楠西區,密枝里,202,106,96,2,204,681,0,29.96,15.57
臺南市,楠西區,照興里,305,128,177,3,308,951,0,32.39,13.46
臺南市,楠西區,鹿田里,315,183,132,2,317,894,0,35.46,20.47
臺南市,楠西區,龜丹里,205,94,111,3,208,639,0,32.55,14.71
臺南市,楠西區,東勢里,727,358,369,13,740,2215,0,33.41,16.16
臺南市,楠西區,合計,2629,1323,1306,36,2665,8230,9115,32.38,16.08
臺南市,南化區,南化里,541,219,322,5,546,1343,0,40.66,16.31
臺南市,南化區,小崙里,216,91,125,3,219,764,0,28.66,11.91
臺南市,南化區,中坑里,117,57,60,2,119,404,0,29.46,14.11
臺南市,南化區,北平里,200,77,123,5,205,547,0,37.48,14.08
臺南市,南化區,東和里,177,77,100,0,177,620,0,28.55,12.42
臺南市,南化區,西埔里,210,101,109,1,211,725,0,29.1,13.93
臺南市,南化區,北寮里,347,171,176,0,347,1130,0,30.71,15.13
臺南市,南化區,玉山里,309,148,161,5,314,1027,0,30.57,14.41
臺南市,南化區,關山里,183,106,77,2,185,948,0,19.51,11.18
臺南市,南化區,合計,2300,1047,1253,23,2323,7508,8305,30.94,13.95
臺南市,左鎮區,光和里,125,51,74,1,126,359,0,35.1,14.21
臺南市,左鎮區,榮和里,228,72,156,3,231,612,0,37.75,11.76
臺南市,左鎮區,左鎮里,157,51,106,5,162,456,0,35.53,11.18
臺南市,左鎮區,中正里,234,111,123,2,236,717,0,32.91,15.48
臺南市,左鎮區,睦光里,120,52,68,1,121,333,0,36.34,15.62
臺南市,左鎮區,內庄里,147,62,85,4,151,355,0,42.54,17.46
臺南市,左鎮區,澄山里,168,37,131,2,170,488,0,34.84,7.58
臺南市,左鎮區,岡林里,137,40,97,0,137,407,0,33.66,9.83
臺南市,左鎮區,草山里,96,36,60,2,98,286,0,34.27,12.59
臺南市,左鎮區,二寮里,88,17,71,2,90,179,0,50.28,9.5
臺南市,左鎮區,合計,1500,529,971,22,1522,4192,4475,36.31,12.62
臺南市,仁德區,太子里,2401,694,1707,22,2423,5421,0,44.7,12.8
臺南市,仁德區,土庫里,1244,315,929,18,1262,2737,0,46.11,11.51
臺南市,仁德區,一甲里,1114,398,716,10,1124,2570,0,43.74,15.49
臺南市,仁德區,仁德里,3044,1181,1863,28,3072,7630,0,40.26,15.48
臺南市,仁德區,仁義里,3924,1468,2456,28,3952,9033,0,43.75,16.25
臺南市,仁德區,新田里,1469,472,997,10,1479,3381,0,43.74,13.96
臺南市,仁德區,後壁里,3789,1362,2427,38,3827,9317,0,41.08,14.62
臺南市,仁德區,上崙里,2354,776,1578,27,2381,6025,0,39.52,12.88
臺南市,仁德區,保安里,1082,370,712,6,1088,2705,0,40.22,13.68
臺南市,仁德區,成功里,2113,1065,1048,19,2132,4809,0,44.33,22.15
臺南市,仁德區,仁和里,685,546,139,14,699,1493,0,46.82,36.57
臺南市,仁德區,仁愛里,530,304,226,3,533,1211,0,44.01,25.1
臺南市,仁德區,二行里,820,288,532,5,825,2102,0,39.25,13.7
臺南市,仁德區,大甲里,882,269,613,13,895,2110,0,42.42,12.75
臺南市,仁德區,中洲里,1069,350,719,20,1089,2612,0,41.69,13.4
臺南市,仁德區,文賢里,913,314,599,22,935,2215,0,42.21,14.18
臺南市,仁德區,合計,27433,10172,17261,283,27716,65371,76229,42.4,15.56
臺南市,歸仁區,南保里,2424,799,1625,23,2447,5856,0,41.79,13.64
臺南市,歸仁區,六甲里,1378,407,971,10,1388,3838,0,36.16,10.6
臺南市,歸仁區,歸仁里,923,350,573,10,933,2285,0,40.83,15.32
臺南市,歸仁區,後市里,1339,429,910,15,1354,3225,0,41.98,13.3
臺南市,歸仁區,辜厝里,1338,490,848,10,1348,3248,0,41.5,15.09
臺南市,歸仁區,許厝里,1317,434,883,19,1336,3254,0,41.06,13.34
臺南市,歸仁區,看西里,933,276,657,6,939,2155,0,43.57,12.81
臺南市,歸仁區,看東里,757,266,491,15,772,1781,0,43.35,14.94
臺南市,歸仁區,崙頂里,1361,400,961,12,1373,3017,0,45.51,13.26
臺南市,歸仁區,沙崙里,277,92,185,2,279,692,0,40.32,13.29
臺南市,歸仁區,大潭里,745,197,548,7,752,1871,0,40.19,10.53
臺南市,歸仁區,武東里,645,228,417,6,651,1767,0,36.84,12.9
臺南市,歸仁區,八甲里,1182,377,805,5,1187,2678,0,44.32,14.08
臺南市,歸仁區,七甲里,1420,468,952,7,1427,3293,0,43.33,14.21
臺南市,歸仁區,媽廟里,842,234,608,11,853,1938,0,44.01,12.07
臺南市,歸仁區,西埔里,738,228,510,7,745,1652,0,45.1,13.8
臺南市,歸仁區,大廟里,1277,400,877,10,1287,3037,0,42.38,13.17
臺南市,歸仁區,南興里,1767,633,1134,20,1787,4221,0,42.34,15.0
臺南市,歸仁區,新厝里,970,291,679,4,974,2447,0,39.8,11.89
臺南市,歸仁區,歸南里,962,299,663,4,966,2218,0,43.55,13.48
臺南市,歸仁區,文化里,1222,426,796,11,1233,2952,0,41.77,14.43
臺南市,歸仁區,合計,23817,7724,16093,214,24031,57425,68074,41.85,13.45
臺南市,關廟區,關廟里,965,316,649,14,979,2249,0,43.53,14.05
臺南市,關廟區,山西里,856,264,592,4,860,2011,0,42.76,13.13
臺南市,關廟區,香洋里,1438,510,928,11,1449,3209,0,45.15,15.89
臺南市,關廟區,北勢里,1040,294,746,15,1055,2473,0,42.66,11.89
臺南市,關廟區,新埔里,369,108,261,6,375,1038,0,36.13,10.4
臺南市,關廟區,新光里,283,71,212,3,286,695,0,41.15,10.22
臺南市,關廟區,五甲里,1271,453,818,11,1282,3182,0,40.29,14.24
臺南市,關廟區,東勢里,1211,389,822,14,1225,3141,0,39.0,12.38
臺南市,關廟區,松腳里,754,226,528,10,764,1949,0,39.2,11.6
臺南市,關廟區,深坑里,590,215,375,8,598,1468,0,40.74,14.65
臺南市,關廟區,布袋里,474,124,350,7,481,1183,0,40.66,10.48
臺南市,關廟區,埤頭里,770,227,543,9,779,1936,0,40.24,11.73
臺南市,關廟區,下湖里,205,72,133,4,209,470,0,44.47,15.32
臺南市,關廟區,花園里,1384,403,981,14,1398,3442,0,40.62,11.71
臺南市,關廟區,南雄里,609,169,440,3,612,1494,0,40.96,11.31
臺南市,關廟區,合計,12219,3841,8378,133,12352,29940,33986,41.26,12.83
臺南市,龍崎區,崎頂里,374,118,256,6,380,990,0,38.38,11.92
臺南市,龍崎區,土崎里,213,69,144,0,213,601,0,35.44,11.48
臺南市,龍崎區,中坑里,52,20,32,1,53,152,0,34.87,13.16
臺南市,龍崎區,楠坑里,159,56,103,1,160,371,0,43.13,15.09
臺南市,龍崎區,牛埔里,129,51,78,1,130,300,0,43.33,17.0
臺南市,龍崎區,大坪里,124,63,61,2,126,286,0,44.06,22.03
臺南市,龍崎區,龍船里,118,64,54,4,122,416,0,29.33,15.38
臺南市,龍崎區,石𥕢里,135,50,85,3,138,429,0,32.17,11.66
臺南市,龍崎區,合計,1304,491,813,18,1322,3545,3720,37.29,13.85
臺南市,永康區,五王里,2206,889,1317,18,2224,5645,0,39.4,15.75
臺南市,永康區,網寮里,2740,1043,1697,25,2765,6942,0,39.83,15.02
臺南市,永康區,永康里,3077,1174,1903,19,3096,8806,0,35.16,13.33
臺南市,永康區,埔園里,2857,1004,1853,21,2878,7154,0,40.23,14.03
臺南市,永康區,大橋里,2330,998,1332,20,2350,5595,0,42.0,17.84
臺南市,永康區,王行里,1002,279,723,12,1014,2455,0,41.3,11.36
臺南市,永康區,烏竹里,1092,375,717,8,1100,2791,0,39.41,13.44
臺南市,永康區,蔦松里,709,210,499,4,713,1847,0,38.6,11.37
臺南市,永康區,三民里,653,240,413,8,661,1503,0,43.98,15.97
臺南市,永康區,塩行里,2062,645,1417,15,2077,4855,0,42.78,13.29
臺南市,永康區,甲頂里,982,308,674,7,989,2226,0,44.43,13.84
臺南市,永康區,大灣里,1412,382,1030,12,1424,3408,0,41.78,11.21
臺南市,永康區,東灣里,1425,386,1039,20,1445,3440,0,42.01,11.22
臺南市,永康區,西灣里,2999,1043,1956,26,3025,7237,0,41.8,14.41
臺南市,永康區,南灣里,1568,439,1129,3,1571,3833,0,40.99,11.45
臺南市,永康區,崑山里,2517,844,1673,27,2544,5820,0,43.71,14.5
臺南市,永康區,北灣里,1655,522,1133,11,1666,4081,0,40.82,12.79
臺南市,永康區,新樹里,823,255,568,9,832,2121,0,39.23,12.02
臺南市,永康區,復興里,708,468,240,10,718,1919,0,37.42,24.39
臺南市,永康區,復國里,3318,1731,1587,24,3342,8455,0,39.53,20.47
臺南市,永康區,建國里,769,442,327,14,783,1905,0,41.1,23.2
臺南市,永康區,神洲里,467,235,232,4,471,1264,0,37.26,18.59
臺南市,永康區,西勢里,2423,811,1612,26,2449,6123,0,40.0,13.25
臺南市,永康區,成功里,834,580,254,14,848,2032,0,41.73,28.54
臺南市,永康區,中興里,1389,694,695,9,1398,3317,0,42.15,20.92
臺南市,永康區,勝利里,2960,1452,1508,30,2990,7661,0,39.03,18.95
臺南市,永康區,龍潭里,2300,687,1613,19,2319,6139,0,37.77,11.19
臺南市,永康區,光復里,195,137,58,2,197,527,0,37.38,26.0
臺南市,永康區,塩洲里,2378,836,1542,21,2399,5686,0,42.19,14.7
臺南市,永康區,二王里,3153,1383,1770,24,3177,7749,0,41.0,17.85
臺南市,永康區,六合里,2252,967,1285,12,2264,5449,0,41.55,17.75
臺南市,永康區,三合里,1399,585,814,9,1408,3456,0,40.74,16.93
臺南市,永康區,東橋里,2801,1028,1773,17,2818,7184,0,39.23,14.31
臺南市,永康區,安康里,1862,740,1122,18,1880,4806,0,39.12,15.4
臺南市,永康區,西橋里,1242,464,778,11,1253,3018,0,41.52,15.37
臺南市,永康區,尚頂里,1645,547,1098,10,1655,3737,0,44.29,14.64
臺南市,永康區,復華里,3645,1790,1855,24,3669,9242,0,39.7,19.37
臺南市,永康區,正強里,3029,1098,1931,21,3050,7578,0,40.25,14.49
臺南市,永康區,中華里,1331,665,666,10,1341,2787,0,48.12,23.86
臺南市,永康區,北興里,2038,738,1300,15,2053,4977,0,41.25,14.83
臺南市,永康區,龍埔里,1451,520,931,13,1464,3732,0,39.23,13.93
臺南市,永康區,永明里,1858,795,1063,17,1875,4598,0,40.78,17.29
臺南市,永康區,塩興里,1351,521,830,11,1362,3794,0,35.9,13.73
臺南市,永康區,合計,78907,30950,47957,650,79557,196894,235327,40.41,15.72
臺南市,東區,富裕里,964,361,603,7,971,2144,0,45.29,16.84
臺南市,東區,裕農里,1297,537,760,13,1310,2857,0,45.85,18.8
臺南市,東區,大智里,2799,1372,1427,23,2822,6524,0,43.26,21.03
臺南市,東區,崇學里,1285,531,754,13,1298,2838,0,45.74,18.71
臺南市,東區,泉南里,2063,842,1221,21,2084,4536,0,45.94,18.56
臺南市,東區,仁和里,1878,810,1068,12,1890,4489,0,42.1,18.04
臺南市,東區,後甲里,1190,483,707,9,1199,2816,0,42.58,17.15
臺南市,東區,東光里,2196,1018,1178,14,2210,4731,0,46.71,21.52
臺南市,東區,新東里,1155,531,624,4,1159,2370,0,48.9,22.41
臺南市,東區,中西里,1340,603,737,12,1352,2931,0,46.13,20.57
臺南市,東區,東安里,537,202,335,4,541,1309,0,41.33,15.43
臺南市,東區,崇明里,1820,872,948,13,1833,3981,0,46.04,21.9
臺南市,東區,自強里,2177,948,1229,17,2194,5154,0,42.57,18.39
臺南市,東區,和平里,2112,874,1238,20,2132,5004,0,42.61,17.47
臺南市,東區,路東里,735,360,375,4,739,1574,0,46.95,22.87
臺南市,東區,大德里,656,265,391,2,658,1465,0,44.91,18.09
臺南市,東區,關聖里,2074,988,1086,14,2088,4496,0,46.44,21.98
臺南市,東區,衛國里,652,269,383,7,659,1504,0,43.82,17.89
臺南市,東區,崇善里,2197,856,1341,17,2214,4969,0,44.56,17.23
臺南市,東區,富強里,1934,762,1172,17,1951,4395,0,44.39,17.34
臺南市,東區,圍下里,862,351,511,6,868,1797,0,48.3,19.53
臺南市,東區,小東里,1834,885,949,9,1843,4122,0,44.71,21.47
臺南市,東區,大學里,520,236,284,1,521,1038,0,50.19,22.74
臺南市,東區,龍山里,2153,899,1254,11,2164,4589,0,47.16,19.59
臺南市,東區,虎尾里,2271,933,1338,21,2292,5079,0,45.13,18.37
臺南市,東區,德高里,1416,542,874,10,1426,3195,0,44.63,16.96
臺南市,東區,莊敬里,1551,703,848,11,1562,3480,0,44.89,20.2
臺南市,東區,大福里,731,301,430,4,735,1609,0,45.68,18.71
臺南市,東區,忠孝里,1936,915,1021,21,1957,4148,0,47.18,22.06
臺南市,東區,崇誨里,1104,571,533,10,1114,2346,0,47.49,24.34
臺南市,東區,東明里,1337,610,727,11,1348,2853,0,47.25,21.38
臺南市,東區,崇德里,2078,961,1117,9,2087,4400,0,47.43,21.84
臺南市,東區,東智里,1199,549,650,14,1213,2747,0,44.16,19.99
臺南市,東區,東聖里,936,388,548,3,939,2206,0,42.57,17.59
臺南市,東區,崇成里,1269,563,706,10,1279,2925,0,43.73,19.25
臺南市,東區,東門里,831,338,493,11,842,1800,0,46.78,18.78
臺南市,東區,成大里,833,392,441,7,840,1924,0,43.66,20.37
臺南市,東區,大同里,1245,534,711,9,1254,2848,0,44.03,18.75
臺南市,東區,德光里,1879,838,1041,12,1891,3861,0,48.98,21.7
臺南市,東區,崇信里,1560,594,966,8,1568,4399,0,35.64,13.5
臺南市,東區,崇文里,2592,1199,1393,14,2606,5808,0,44.87,20.64
臺南市,東區,復興里,1465,533,932,15,1480,3284,0,45.07,16.23
臺南市,東區,裕聖里,2110,1050,1060,14,2124,4654,0,45.64,22.56
臺南市,東區,南聖里,1131,534,597,9,1140,2522,0,45.2,21.17
臺南市,東區,文聖里,1953,892,1061,25,1978,4275,0,46.27,20.87
臺南市,東區,合計,67857,29795,38062,518,68375,151996,183689,44.98,19.6
臺南市,南區,竹溪里,825,387,438,4,829,1623,0,51.08,23.84
臺南市,南區,明德里,546,260,286,6,552,1383,0,39.91,18.8
臺南市,南區,大成里,798,335,463,3,801,1753,0,45.69,19.11
臺南市,南區,廣州里,1081,356,725,9,1090,2226,0,48.97,15.99
臺南市,南區,新昌里,955,358,597,7,962,2173,0,44.27,16.47
臺南市,南區,新興里,1243,450,793,14,1257,2697,0,46.61,16.69
臺南市,南區,田寮里,1378,547,831,6,1384,3096,0,44.7,17.67
臺南市,南區,國宅里,1236,412,824,9,1245,2875,0,43.3,14.33
臺南市,南區,光明里,1771,548,1223,18,1789,4140,0,43.21,13.24
臺南市,南區,明亮里,1593,512,1081,8,1601,3510,0,45.61,14.59
臺南市,南區,喜東里,906,217,689,3,909,2071,0,43.89,10.48
臺南市,南區,喜北里,955,216,739,7,962,2143,0,44.89,10.08
臺南市,南區,喜南里,541,111,430,5,546,1191,0,45.84,9.32
臺南市,南區,省躬里,1473,377,1096,14,1487,3849,0,38.63,9.79
臺南市,南區,興農里,1100,293,807,8,1108,2639,0,41.99,11.1
臺南市,南區,同安里,940,258,682,8,948,2169,0,43.71,11.89
臺南市,南區,佛壇里,1060,231,829,4,1064,2471,0,43.06,9.35
臺南市,南區,大林里,1038,511,527,9,1047,2187,0,47.87,23.37
臺南市,南區,大忠里,2019,881,1138,12,2031,4438,0,45.76,19.85
臺南市,南區,大恩里,1454,655,799,14,1468,3368,0,43.59,19.45
臺南市,南區,新生里,1502,1046,456,18,1520,3347,0,45.41,31.25
臺南市,南區,再興里,1052,371,681,7,1059,2222,0,47.66,16.7
臺南市,南區,明興里,1436,418,1018,9,1445,3277,0,44.1,12.76
臺南市,南區,文華里,1488,566,922,6,1494,3213,0,46.5,17.62
臺南市,南區,金華里,2115,776,1339,24,2139,4948,0,43.23,15.68
臺南市,南區,南都里,929,340,589,14,943,2683,0,35.15,12.67
臺南市,南區,開南里,2369,830,1539,14,2383,5627,0,42.35,14.75
臺南市,南區,彰南里,656,225,431,5,661,1531,0,43.17,14.7
臺南市,南區,建南里,2307,733,1574,19,2326,5014,0,46.39,14.62
臺南市,南區,郡南里,1556,536,1020,20,1576,3483,0,45.25,15.39
臺南市,南區,府南里,1927,699,1228,19,1946,4744,0,41.02,14.73
臺南市,南區,文南里,2280,827,1453,12,2292,4978,0,46.04,16.61
臺南市,南區,鯤鯓里,686,230,456,7,693,1717,0,40.36,13.4
臺南市,南區,松安里,814,205,609,9,823,1752,0,46.97,11.7
臺南市,南區,永寧里,768,195,573,11,779,1700,0,45.82,11.47
臺南市,南區,南華里,980,335,645,6,986,2425,0,40.66,13.81
臺南市,南區,鹽埕里,1669,505,1164,18,1687,3641,0,46.33,13.87
臺南市,南區,合計,47446,16752,30694,386,47832,108304,123057,44.16,15.47
臺南市,北區,開元里,1448,593,855,10,1458,3350,0,43.52,17.7
臺南市,北區,東興里,935,493,442,6,941,1911,0,49.24,25.8
臺南市,北區,力行里,1091,528,563,10,1101,2358,0,46.69,22.39
臺南市,北區,振興里,879,345,534,4,883,1929,0,45.78,17.88
臺南市,北區,仁愛里,1087,477,610,11,1098,2173,0,50.53,21.95
臺南市,北區,大豐里,1679,531,1148,13,1692,4183,0,40.45,12.69
臺南市,北區,重興里,879,425,454,8,887,1829,0,48.5,23.24
臺南市,北區,和順里,2206,971,1235,9,2215,4751,0,46.62,20.44
臺南市,北區,正覺里,1379,449,930,16,1395,3128,0,44.6,14.35
臺南市,北區,成功里,1933,675,1258,11,1944,4481,0,43.38,15.06
臺南市,北區,文元里,1439,523,916,15,1454,3391,0,42.88,15.42
臺南市,北區,大港里,2374,882,1492,13,2387,5281,0,45.2,16.7
臺南市,北區,中樓里,655,276,379,6,661,1388,0,47.62,19.88
臺南市,北區,公園里,812,385,427,13,825,1809,0,45.61,21.28
臺南市,北區,元寶里,1605,705,900,5,1610,4041,0,39.84,17.45
臺南市,北區,永祥里,1357,578,779,13,1370,3012,0,45.48,19.19
臺南市,北區,成德里,1899,769,1130,19,1918,4329,0,44.31,17.76
臺南市,北區,文成里,1326,489,837,8,1334,2933,0,45.48,16.67
臺南市,北區,大和里,1548,471,1077,13,1561,3603,0,43.33,13.07
臺南市,北區,賢北里,1647,578,1069,12,1659,3566,0,46.52,16.21
臺南市,北區,長勝里,1703,1048,655,24,1727,3781,0,45.68,27.72
臺南市,北區,合興里,1535,622,913,14,1549,3378,0,45.86,18.41
臺南市,北區,北門里,2190,969,1221,20,2210,5163,0,42.8,18.77
臺南市,北區,小北里,1589,601,988,20,1609,3826,0,42.05,15.71
臺南市,北區,大光里,2036,1203,833,18,2054,4747,0,43.27,25.34
臺南市,北區,大興里,1260,522,738,14,1274,2929,0,43.5,17.82
臺南市,北區,長興里,1128,415,713,7,1135,2655,0,42.75,15.63
臺南市,北區,北華里,1460,525,935,12,1472,3987,0,36.92,13.17
臺南市,北區,華德里,1566,565,1001,9,1575,3631,0,43.38,15.56
臺南市,北區,福德里,1959,798,1161,7,1966,4418,0,44.5,18.06
臺南市,北區,立人里,1116,372,744,4,1120,2467,0,45.4,15.08
臺南市,北區,雙安里,1016,416,600,8,1024,2258,0,45.35,18.42
臺南市,北區,元美里,1328,492,836,11,1339,2999,0,44.65,16.41
臺南市,北區,合計,48064,19691,28373,383,48447,109685,129057,44.17,17.95
臺南市,安南區,東和里,1136,385,751,8,1144,2798,0,40.89,13.76
臺南市,安南區,安順里,1901,665,1236,24,1925,4730,0,40.7,14.06
臺南市,安南區,󻕯南里,1798,583,1215,12,1810,4668,0,38.77,12.49
臺南市,安南區,州南里,1974,647,1327,17,1991,5017,0,39.69,12.9
臺南市,安南區,州北里,1812,582,1230,15,1827,4446,0,41.09,13.09
臺南市,安南區,安東里,1184,370,814,7,1191,2762,0,43.12,13.4
臺南市,安南區,安西里,1439,458,981,13,1452,3488,0,41.63,13.13
臺南市,安南區,頂安里,1871,545,1326,17,1888,4518,0,41.79,12.06
臺南市,安南區,安慶里,2500,765,1735,21,2521,6006,0,41.97,12.74
臺南市,安南區,新順里,2498,850,1648,15,2513,6119,0,41.07,13.89
臺南市,安南區,原佃里,863,295,568,9,872,2171,0,40.17,13.59
臺南市,安南區,總頭里,741,205,536,4,745,1811,0,41.14,11.32
臺南市,安南區,長安里,1839,534,1305,8,1847,4706,0,39.25,11.35
臺南市,安南區,公親里,459,127,332,3,462,1148,0,40.24,11.06
臺南市,安南區,海東里,2002,584,1418,10,2012,5528,0,36.4,10.56
臺南市,安南區,海西里,1092,375,717,5,1097,2803,0,39.14,13.38
臺南市,安南區,海南里,1002,311,691,8,1010,2365,0,42.71,13.15
臺南市,安南區,溪心里,2673,927,1746,26,2699,7823,0,34.5,11.85
臺南市,安南區,塩田里,649,274,375,10,659,1587,0,41.52,17.27
臺南市,安南區,淵東里,1711,520,1191,21,1732,4730,0,36.62,10.99
臺南市,安南區,淵西里,1149,361,788,9,1158,3591,0,32.25,10.05
臺南市,安南區,佃東里,1196,387,809,7,1203,3358,0,35.82,11.52
臺南市,安南區,佃西里,717,219,498,4,721,2107,0,34.22,10.39
臺南市,安南區,公󻕯里,446,137,309,4,450,1031,0,43.65,13.29
臺南市,安南區,南興里,645,158,487,8,653,1831,0,35.66,8.63
臺南市,安南區,學東里,796,232,564,7,803,2484,0,32.33,9.34
臺南市,安南區,城東里,524,186,338,5,529,1572,0,33.65,11.83
臺南市,安南區,城北里,589,161,428,7,596,1569,0,37.99,10.26
臺南市,安南區,城中里,403,144,259,2,405,1050,0,38.57,13.71
臺南市,安南區,城南里,1135,337,798,16,1151,3209,0,35.87,10.5
臺南市,安南區,城西里,504,131,373,7,511,1442,0,35.44,9.08
臺南市,安南區,青草里,452,126,326,4,456,1507,0,30.26,8.36
臺南市,安南區,砂崙里,508,142,366,4,512,1292,0,39.63,10.99
臺南市,安南區,鹿耳里,280,114,166,5,285,888,0,32.09,12.84
臺南市,安南區,四草里,740,248,492,3,743,1882,0,39.48,13.18
臺南市,安南區,安和里,892,254,638,6,898,2122,0,42.32,11.97
臺南市,安南區,溪北里,1217,407,810,7,1224,2749,0,44.53,14.81
臺南市,安南區,溪頂里,1879,648,1231,18,1897,4392,0,43.19,14.75
臺南市,安南區,溪墘里,1240,366,874,10,1250,3015,0,41.46,12.14
臺南市,安南區,海佃里,1802,501,1301,9,1811,4278,0,42.33,11.71
臺南市,安南區,幸福里,1555,425,1130,15,1570,3596,0,43.66,11.82
臺南市,安南區,鳳凰里,1656,575,1081,14,1670,4402,0,37.94,13.06
臺南市,安南區,梅花里,1616,546,1070,14,1630,4025,0,40.5,13.57
臺南市,安南區,理想里,1910,552,1358,10,1920,4467,0,42.98,12.36
臺南市,安南區,溪東里,1623,567,1056,10,1633,3943,0,41.42,14.38
臺南市,安南區,淵中里,1259,386,873,10,1269,3321,0,38.21,11.62
臺南市,安南區,布袋里,578,194,384,5,583,1480,0,39.39,13.11
臺南市,安南區,國安里,1142,363,779,14,1156,2718,0,42.53,13.36
臺南市,安南區,安富里,2068,617,1451,15,2083,5393,0,38.62,11.44
臺南市,安南區,大安里,1453,456,997,10,1463,3607,0,40.56,12.64
臺南市,安南區,媽祖宮里,480,184,296,6,486,1456,0,33.38,12.64
臺南市,安南區,合計,63598,20126,43472,518,64116,163001,196238,39.33,12.35
臺南市,安平區,金城里,821,344,477,8,829,2012,0,41.2,17.1
臺南市,安平區,漁光里,197,63,134,3,200,435,0,45.98,14.48
臺南市,安平區,建平里,2097,817,1280,12,2109,5116,0,41.22,15.97
臺南市,安平區,怡平里,1683,669,1014,6,1689,4196,0,40.25,15.94
臺南市,安平區,華平里,2014,810,1204,13,2027,4827,0,41.99,16.78
臺南市,安平區,平通里,2713,1082,1631,18,2731,7232,0,37.76,14.96
臺南市,安平區,文平里,2255,953,1302,15,2270,5000,0,45.4,19.06
臺南市,安平區,國平里,3062,1264,1798,17,3079,7593,0,40.55,16.65
臺南市,安平區,育平里,2959,1319,1640,24,2983,7951,0,37.52,16.59
臺南市,安平區,億載里,1308,501,807,8,1316,3031,0,43.42,16.53
臺南市,安平區,平安里,1447,497,950,11,1458,3301,0,44.17,15.06
臺南市,安平區,天妃里,1384,458,926,11,1395,3261,0,42.78,14.04
臺南市,安平區,王城里,1083,366,717,6,1089,2761,0,39.44,13.26
臺南市,安平區,合計,23023,9143,13880,152,23175,56716,67297,40.86,16.12
臺南市,中西區,赤嵌里,1659,580,1079,10,1669,3653,0,45.69,15.88
臺南市,中西區,郡王里,1325,537,788,12,1337,3036,0,44.04,17.69
臺南市,中西區,法華里,1238,527,711,9,1247,2678,0,46.56,19.68
臺南市,中西區,開山里,1001,321,680,9,1010,2406,0,41.98,13.34
臺南市,中西區,永華里,1132,430,702,12,1144,2516,0,45.47,17.09
臺南市,中西區,藥王里,1468,488,980,14,1482,3287,0,45.09,14.85
臺南市,中西區,光賢里,1624,537,1087,9,1633,3479,0,46.94,15.44
臺南市,中西區,大涼里,1122,430,692,11,1133,2515,0,45.05,17.1
臺南市,中西區,西湖里,2628,1104,1524,25,2653,5665,0,46.83,19.49
臺南市,中西區,西賢里,2326,935,1391,19,2345,4932,0,47.55,18.96
臺南市,中西區,城隍里,1652,564,1088,9,1661,3667,0,45.3,15.38
臺南市,中西區,南美里,1374,464,910,3,1377,3143,0,43.81,14.76
臺南市,中西區,南門里,1179,522,657,8,1187,2478,0,47.9,21.07
臺南市,中西區,小西門里,1347,569,778,8,1355,3070,0,44.14,18.53
臺南市,中西區,五條港里,874,306,568,6,880,1972,0,44.62,15.52
臺南市,中西區,兌悅里,1570,480,1090,16,1586,3846,0,41.24,12.48
臺南市,中西區,淺草里,1071,381,690,2,1073,2485,0,43.18,15.33
臺南市,中西區,府前里,831,273,558,4,835,1878,0,44.46,14.54
臺南市,中西區,南廠里,1701,564,1137,11,1712,3913,0,43.75,14.41
臺南市,中西區,西和里,1773,651,1122,16,1789,3847,0,46.5,16.92
臺南市,中西區,合計,28895,10663,18232,213,29108,64466,78163,45.15,16.54
臺南市,合計,合計,648317,232475,415842,5891,654208,1592388,1868739,41.08,14.6
高雄市,鹽埕區,藍橋里,628,197,431,5,633,1261,0,50.2,15.62
高雄市,鹽埕區,慈愛里,156,50,106,0,156,321,0,48.6,15.58
高雄市,鹽埕區,博愛里,326,102,224,5,331,626,0,52.88,16.29
高雄市,鹽埕區,壽星里,541,237,304,5,546,1222,0,44.68,19.39
高雄市,鹽埕區,中山里,593,244,349,10,603,1240,0,48.63,19.68
高雄市,鹽埕區,教仁里,929,357,572,7,936,1941,0,48.22,18.39
高雄市,鹽埕區,新樂里,415,171,244,0,415,805,0,51.55,21.24
高雄市,鹽埕區,中原里,299,97,202,3,302,569,0,53.08,17.05
高雄市,鹽埕區,光明里,582,189,393,3,585,1394,0,41.97,13.56
高雄市,鹽埕區,育仁里,360,128,232,3,363,733,0,49.52,17.46
高雄市,鹽埕區,河濱里,782,298,484,9,791,1581,0,50.03,18.85
高雄市,鹽埕區,沙地里,332,97,235,2,334,721,0,46.32,13.45
高雄市,鹽埕區,南端里,424,152,272,2,426,935,0,45.56,16.26
高雄市,鹽埕區,港都里,499,163,336,5,504,1042,0,48.37,15.64
高雄市,鹽埕區,江西里,487,167,320,3,490,1023,0,47.9,16.32
高雄市,鹽埕區,新豐里,377,149,228,4,381,775,0,49.16,19.23
高雄市,鹽埕區,府北里,864,322,542,4,868,1989,0,43.64,16.19
高雄市,鹽埕區,陸橋里,513,185,328,3,516,1114,0,46.32,16.61
高雄市,鹽埕區,瀨南里,278,92,186,1,279,547,0,51.01,16.82
高雄市,鹽埕區,新化里,271,100,171,4,275,543,0,50.64,18.42
高雄市,鹽埕區,江南里,262,48,214,2,264,569,0,46.4,8.44
高雄市,鹽埕區,合計,9918,3545,6373,80,9998,20951,23272,47.72,16.92
高雄市,鼓山區,鼓峰里,844,462,382,8,852,1923,0,44.31,24.02
高雄市,鼓山區,雄峰里,821,529,292,10,831,1924,0,43.19,27.49
高雄市,鼓山區,前峰里,1951,966,985,11,1962,4040,0,48.56,23.91
高雄市,鼓山區,光榮里,1551,454,1097,17,1568,3318,0,47.26,13.68
高雄市,鼓山區,民族里,640,233,407,4,644,1257,0,51.23,18.54
高雄市,鼓山區,內惟里,481,148,333,7,488,1072,0,45.52,13.81
高雄市,鼓山區,建國里,1085,425,660,5,1090,2405,0,45.32,17.67
高雄市,鼓山區,忠正里,1549,617,932,14,1563,3652,0,42.8,16.89
高雄市,鼓山區,自強里,374,343,31,1,375,703,0,53.34,48.79
高雄市,鼓山區,龍井里,519,196,323,3,522,1210,0,43.14,16.2
高雄市,鼓山區,正德里,860,264,596,5,865,1928,0,44.87,13.69
高雄市,鼓山區,平和里,1604,533,1071,7,1611,3346,0,48.15,15.93
高雄市,鼓山區,民強里,1216,419,797,6,1222,2539,0,48.13,16.5
高雄市,鼓山區,厚生里,1359,457,902,8,1367,2970,0,46.03,15.39
高雄市,鼓山區,龍子里,6604,2888,3716,38,6642,15526,0,42.78,18.6
高雄市,鼓山區,龍水里,9776,4466,5310,52,9828,22850,0,43.01,19.54
高雄市,鼓山區,明誠里,6796,3365,3431,27,6823,16357,0,41.71,20.57
高雄市,鼓山區,華豐里,1648,834,814,9,1657,3836,0,43.2,21.74
高雄市,鼓山區,裕興里,1425,740,685,10,1435,3144,0,45.64,23.54
高雄市,鼓山區,裕豐里,1141,675,466,10,1151,2453,0,46.92,27.52
高雄市,鼓山區,鼓岩里,477,155,322,5,482,1125,0,42.84,13.78
高雄市,鼓山區,樹德里,565,170,395,4,569,1113,0,51.12,15.27
高雄市,鼓山區,寶樹里,520,183,337,4,524,1920,0,27.29,9.53
高雄市,鼓山區,興宗里,559,203,356,6,565,1241,0,45.53,16.36
高雄市,鼓山區,光化里,533,211,322,2,535,1207,0,44.32,17.48
高雄市,鼓山區,山下里,604,260,344,6,610,1306,0,46.71,19.91
高雄市,鼓山區,河邊里,556,220,336,6,562,1301,0,43.2,16.91
高雄市,鼓山區,綠川里,615,204,411,5,620,1361,0,45.55,14.99
高雄市,鼓山區,登山里,255,97,158,3,258,605,0,42.64,16.03
高雄市,鼓山區,峰南里,353,99,254,5,358,778,0,46.02,12.72
高雄市,鼓山區,麗興里,415,141,274,9,424,928,0,45.69,15.19
高雄市,鼓山區,新民里,421,112,309,2,423,955,0,44.29,11.73
高雄市,鼓山區,延平里,362,99,263,4,366,715,0,51.19,13.85
高雄市,鼓山區,維生里,576,190,386,5,581,1190,0,48.82,15.97
高雄市,鼓山區,惠安里,473,136,337,4,477,1102,0,43.28,12.34
高雄市,鼓山區,壽山里,527,144,383,5,532,1307,0,40.7,11.02
高雄市,鼓山區,哨船頭里,428,179,249,4,432,963,0,44.86,18.59
高雄市,鼓山區,桃源里,234,83,151,5,239,527,0,45.35,15.75
高雄市,鼓山區,合計,50717,21900,28817,336,51053,116097,141101,43.97,18.86
高雄市,左營區,進學里,647,315,332,6,653,2636,0,24.77,11.95
高雄市,左營區,尾西里,476,151,325,5,481,973,0,49.43,15.52
高雄市,左營區,頂北里,271,98,173,3,274,512,0,53.52,19.14
高雄市,左營區,中北里,300,63,237,4,304,603,0,50.41,10.45
高雄市,左營區,中南里,244,63,181,1,245,496,0,49.4,12.7
高雄市,左營區,廟東里,409,87,322,3,412,799,0,51.56,10.89
高雄市,左營區,廟北里,404,97,307,4,408,839,0,48.63,11.56
高雄市,左營區,尾南里,326,80,246,2,328,705,0,46.52,11.35
高雄市,左營區,尾北里,1401,530,871,15,1416,3265,0,43.37,16.23
高雄市,左營區,屏山里,638,444,194,14,652,1512,0,43.12,29.37
高雄市,左營區,祥和里,148,113,35,0,148,331,0,44.71,34.14
高雄市,左營區,永清里,189,133,56,2,191,600,0,31.83,22.17
高雄市,左營區,莒光里,731,445,286,4,735,1687,0,43.57,26.38
高雄市,左營區,光輝里,1032,522,510,6,1038,2403,0,43.2,21.72
高雄市,左營區,合群里,1242,1109,133,13,1255,2489,0,50.42,44.56
高雄市,左營區,明建里,288,200,88,3,291,611,0,47.63,32.73
高雄市,左營區,頂西里,443,100,343,7,450,907,0,49.61,11.03
高雄市,左營區,聖后里,367,102,265,1,368,711,0,51.76,14.35
高雄市,左營區,聖西里,155,46,109,1,156,329,0,47.42,13.98
高雄市,左營區,聖南里,253,76,177,2,255,522,0,48.85,14.56
高雄市,左營區,城南里,241,65,176,2,243,491,0,49.49,13.24
高雄市,左營區,路東里,366,114,252,3,369,690,0,53.48,16.52
高雄市,左營區,廍北里,194,35,159,3,197,391,0,50.38,8.95
高雄市,左營區,廍南里,293,92,201,3,296,575,0,51.48,16.0
高雄市,左營區,埤西里,405,154,251,1,406,842,0,48.22,18.29
高雄市,左營區,埤北里,557,334,223,11,568,1260,0,45.08,26.51
高雄市,左營區,埤東里,415,157,258,4,419,920,0,45.54,17.07
高雄市,左營區,海勝里,2703,2179,524,40,2743,5561,0,49.33,39.18
高雄市,左營區,崇實里,1352,778,574,5,1357,3147,0,43.12,24.72
高雄市,左營區,自助里,366,205,161,1,367,907,0,40.46,22.6
高雄市,左營區,果貿里,1264,985,279,10,1274,2680,0,47.54,36.75
高雄市,左營區,果惠里,695,534,161,6,701,1445,0,48.51,36.96
高雄市,左營區,果峰里,662,524,138,7,669,1540,0,43.44,34.03
高雄市,左營區,新下里,5896,2856,3040,47,5943,13601,0,43.7,21.0
高雄市,左營區,新上里,10897,4619,6278,82,10979,25163,0,43.63,18.36
高雄市,左營區,新中里,2179,644,1535,18,2197,4725,0,46.5,13.63
高雄市,左營區,新光里,5755,2620,3135,31,5786,13461,0,42.98,19.46
高雄市,左營區,菜公里,11552,5218,6334,79,11631,28382,0,40.98,18.38
高雄市,左營區,福山里,13768,6594,7174,84,13852,35376,0,39.16,18.64
高雄市,左營區,合計,69524,33481,36043,533,70057,164087,196916,42.7,20.4
高雄市,楠梓區,清豐里,8668,3297,5371,61,8729,21636,0,40.34,15.24
高雄市,楠梓區,東寧里,1757,666,1091,7,1764,4264,0,41.37,15.62
高雄市,楠梓區,五常里,2358,847,1511,18,2376,6356,0,37.38,13.33
高雄市,楠梓區,享平里,1273,443,830,3,1276,3150,0,40.51,14.06
高雄市,楠梓區,中陽里,1331,406,925,13,1344,3252,0,41.33,12.48
高雄市,楠梓區,惠楠里,1044,388,656,6,1050,3163,0,33.2,12.27
高雄市,楠梓區,惠民里,1738,674,1064,12,1750,3884,0,45.06,17.35
高雄市,楠梓區,惠豐里,2016,991,1025,17,2033,4669,0,43.54,21.23
高雄市,楠梓區,錦屏里,1355,340,1015,12,1367,2830,0,48.3,12.01
高雄市,楠梓區,玉屏里,1023,218,805,9,1032,2059,0,50.12,10.59
高雄市,楠梓區,金田里,1669,460,1209,16,1685,3828,0,44.02,12.02
高雄市,楠梓區,稔田里,717,151,566,8,725,1375,0,52.73,10.98
高雄市,楠梓區,瑞屏里,1399,527,872,11,1410,3487,0,40.44,15.11
高雄市,楠梓區,翠屏里,6091,3107,2984,41,6132,16189,0,37.88,19.19
高雄市,楠梓區,宏南里,356,191,165,3,359,657,0,54.64,29.07
高雄市,楠梓區,宏毅里,1055,465,590,5,1060,2064,0,51.36,22.53
高雄市,楠梓區,宏榮里,1082,548,534,4,1086,2417,0,44.93,22.67
高雄市,楠梓區,廣昌里,1269,569,700,11,1280,2885,0,44.37,19.72
高雄市,楠梓區,久昌里,1065,483,582,8,1073,2765,0,38.81,17.47
高雄市,楠梓區,大昌里,772,346,426,9,781,2046,0,38.17,16.91
高雄市,楠梓區,福昌里,962,357,605,9,971,2023,0,48.0,17.65
高雄市,楠梓區,盛昌里,2316,1128,1188,16,2332,5347,0,43.61,21.1
高雄市,楠梓區,泰昌里,564,217,347,4,568,1397,0,40.66,15.53
高雄市,楠梓區,興昌里,1808,732,1076,14,1822,4314,0,42.23,16.97
高雄市,楠梓區,建昌里,1071,491,580,6,1077,2534,0,42.5,19.38
高雄市,楠梓區,宏昌里,1394,650,744,7,1401,3221,0,43.5,20.18
高雄市,楠梓區,和昌里,888,415,473,5,893,1997,0,44.72,20.78
高雄市,楠梓區,慶昌里,1533,740,793,10,1543,3122,0,49.42,23.7
高雄市,楠梓區,隆昌里,1388,646,742,16,1404,3235,0,43.4,19.97
高雄市,楠梓區,秀昌里,949,475,474,3,952,2104,0,45.25,22.58
高雄市,楠梓區,裕昌里,1849,768,1081,14,1863,4652,0,40.05,16.51
高雄市,楠梓區,國昌里,1430,603,827,8,1438,3394,0,42.37,17.77
高雄市,楠梓區,加昌里,3350,1715,1635,20,3370,8252,0,40.84,20.78
高雄市,楠梓區,仁昌里,1934,973,961,15,1949,4959,0,39.3,19.62
高雄市,楠梓區,藍田里,2975,1288,1687,23,2998,7507,0,39.94,17.16
高雄市,楠梓區,中興里,695,217,478,8,703,1558,0,45.12,13.93
高雄市,楠梓區,中和里,1435,493,942,9,1444,4154,0,34.76,11.87
高雄市,楠梓區,合計,64579,27025,37554,461,65040,156746,189931,41.49,17.24
高雄市,三民區,鼎金里,1548,543,1005,8,1556,3804,0,40.9,14.27
高雄市,三民區,鼎盛里,3017,1196,1821,13,3030,7370,0,41.11,16.23
高雄市,三民區,鼎強里,1625,569,1056,11,1636,3793,0,43.13,15.0
高雄市,三民區,鼎力里,1697,639,1058,12,1709,3884,0,44.0,16.45
高雄市,三民區,鼎西里,2840,1022,1818,13,2853,7030,0,40.58,14.54
高雄市,三民區,鼎中里,1588,499,1089,11,1599,3436,0,46.54,14.52
高雄市,三民區,鼎泰里,9188,4121,5067,60,9248,20899,0,44.25,19.72
高雄市,三民區,本館里,3535,1347,2188,18,3553,8380,0,42.4,16.07
高雄市,三民區,本和里,3030,1185,1845,27,3057,6992,0,43.72,16.95
高雄市,三民區,本文里,867,319,548,8,875,1915,0,45.69,16.66
高雄市,三民區,本武里,711,229,482,7,718,1561,0,46.0,14.67
高雄市,三民區,本元里,2191,864,1327,19,2210,4987,0,44.32,17.33
高雄市,三民區,本安里,1923,810,1113,13,1936,4277,0,45.27,18.94
高雄市,三民區,本上里,1978,866,1112,5,1983,4461,0,44.45,19.41
高雄市,三民區,本揚里,3228,1327,1901,18,3246,7143,0,45.44,18.58
高雄市,三民區,寶獅里,1622,638,984,7,1629,3486,0,46.73,18.3
高雄市,三民區,寶德里,2078,774,1304,12,2090,4824,0,43.33,16.04
高雄市,三民區,寶泰里,1525,552,973,11,1536,3831,0,40.09,14.41
高雄市,三民區,寶興里,2737,1022,1715,25,2762,6396,0,43.18,15.98
高雄市,三民區,寶中里,1223,435,788,10,1233,2807,0,43.93,15.5
高雄市,三民區,寶華里,1351,600,751,7,1358,3089,0,43.96,19.42
高雄市,三民區,寶國里,3192,1288,1904,31,3223,7514,0,42.89,17.14
高雄市,三民區,寶民里,1224,514,710,9,1233,3030,0,40.69,16.96
高雄市,三民區,寶慶里,1082,421,661,7,1089,2557,0,42.59,16.46
高雄市,三民區,寶業里,2426,1000,1426,15,2441,5630,0,43.36,17.76
高雄市,三民區,寶盛里,2262,942,1320,19,2281,4748,0,48.04,19.84
高雄市,三民區,寶安里,2802,1222,1580,19,2821,6808,0,41.44,17.95
高雄市,三民區,寶龍里,1888,738,1150,16,1904,3982,0,47.82,18.53
高雄市,三民區,寶珠里,2259,864,1395,15,2274,6719,0,33.84,12.86
高雄市,三民區,寶玉里,3287,1348,1939,20,3307,7920,0,41.76,17.02
高雄市,三民區,灣子里,1509,603,906,5,1514,3836,0,39.47,15.72
高雄市,三民區,灣愛里,1012,336,676,14,1026,2898,0,35.4,11.59
高雄市,三民區,灣中里,2027,709,1318,11,2038,5297,0,38.47,13.38
高雄市,三民區,灣華里,1048,388,660,7,1055,2586,0,40.8,15.0
高雄市,三民區,灣勝里,770,208,562,9,779,1821,0,42.78,11.42
高雄市,三民區,灣利里,1427,388,1039,7,1434,3021,0,47.47,12.84
高雄市,三民區,灣復里,1378,523,855,12,1390,3493,0,39.79,14.97
高雄市,三民區,正興里,4727,1960,2767,25,4752,11804,0,40.26,16.6
高雄市,三民區,正順里,1678,645,1033,5,1683,3743,0,44.96,17.23
高雄市,三民區,灣興里,801,264,537,6,807,1778,0,45.39,14.85
高雄市,三民區,灣成里,1013,393,620,9,1022,2499,0,40.9,15.73
高雄市,三民區,安康里,1026,343,683,6,1032,2682,0,38.48,12.79
高雄市,三民區,安寧里,771,265,506,13,784,1744,0,44.95,15.19
高雄市,三民區,安吉里,1852,748,1104,13,1865,4294,0,43.43,17.42
高雄市,三民區,安發里,1910,743,1167,13,1923,4233,0,45.43,17.55
高雄市,三民區,安東里,1412,472,940,9,1421,2893,0,49.12,16.32
高雄市,三民區,安和里,1158,363,795,12,1170,2309,0,50.67,15.72
高雄市,三民區,達德里,643,194,449,0,643,1208,0,53.23,16.06
高雄市,三民區,達明里,719,237,482,8,727,1482,0,49.06,15.99
高雄市,三民區,達仁里,662,217,445,4,666,1379,0,48.3,15.74
高雄市,三民區,達勇里,404,139,265,2,406,882,0,46.03,15.76
高雄市,三民區,同德里,1305,479,826,9,1314,2589,0,50.75,18.5
高雄市,三民區,德智里,988,383,605,9,997,2030,0,49.11,18.87
高雄市,三民區,德仁里,869,312,557,7,876,1812,0,48.34,17.22
高雄市,三民區,安生里,695,210,485,4,699,1339,0,52.2,15.68
高雄市,三民區,德東里,395,129,266,1,396,748,0,52.94,17.25
高雄市,三民區,德行里,570,193,377,3,573,1023,0,56.01,18.87
高雄市,三民區,精華里,697,243,454,4,701,1448,0,48.41,16.78
高雄市,三民區,民享里,1006,333,673,5,1011,1900,0,53.21,17.53
高雄市,三民區,安宜里,1466,482,984,9,1475,2953,0,49.95,16.32
高雄市,三民區,安泰里,1655,614,1041,21,1676,3633,0,46.13,16.9
高雄市,三民區,安邦里,1721,586,1135,13,1734,3606,0,48.09,16.25
高雄市,三民區,十全里,754,230,524,1,755,1671,0,45.18,13.76
高雄市,三民區,十美里,832,281,551,5,837,1690,0,49.53,16.63
高雄市,三民區,德北里,933,354,579,5,938,1992,0,47.09,17.77
高雄市,三民區,立誠里,336,102,234,3,339,659,0,51.44,15.48
高雄市,三民區,立業里,384,114,270,2,386,914,0,42.23,12.47
高雄市,三民區,港東里,591,192,399,3,594,1341,0,44.3,14.32
高雄市,三民區,港新里,630,249,381,1,631,1337,0,47.2,18.62
高雄市,三民區,港西里,329,122,207,7,336,760,0,44.21,16.05
高雄市,三民區,博愛里,541,216,325,2,543,1126,0,48.22,19.18
高雄市,三民區,博惠里,1835,688,1147,16,1851,3922,0,47.2,17.54
高雄市,三民區,長明里,425,184,241,1,426,1008,0,42.26,18.25
高雄市,三民區,建東里,446,193,253,1,447,1147,0,38.97,16.83
高雄市,三民區,興德里,863,359,504,7,870,1905,0,45.67,18.85
高雄市,三民區,鳳南里,456,127,329,7,463,886,0,52.26,14.33
高雄市,三民區,鳳北里,656,209,447,8,664,1307,0,50.8,15.99
高雄市,三民區,德西里,427,163,264,4,431,998,0,43.19,16.33
高雄市,三民區,豐裕里,972,315,657,9,981,2347,0,41.8,13.42
高雄市,三民區,川東里,528,195,333,3,531,1212,0,43.81,16.09
高雄市,三民區,裕民里,505,191,314,2,507,1226,0,41.35,15.58
高雄市,三民區,力行里,495,177,318,1,496,1046,0,47.42,16.92
高雄市,三民區,千歲里,578,223,355,6,584,1082,0,53.97,20.61
高雄市,三民區,立德里,557,218,339,2,559,1156,0,48.36,18.86
高雄市,三民區,千北里,459,153,306,4,463,1009,0,45.89,15.16
高雄市,三民區,千秋里,884,304,580,1,885,1967,0,44.99,15.46
高雄市,三民區,合計,124654,47555,77099,842,125496,285944,334725,43.89,16.63
高雄市,新興區,浩然里,834,419,415,6,840,1749,0,48.03,23.96
高雄市,新興區,振成里,483,214,269,3,486,1026,0,47.37,20.86
高雄市,新興區,德生里,1303,569,734,7,1310,2842,0,46.09,20.02
高雄市,新興區,振華里,494,231,263,2,496,1011,0,49.06,22.85
高雄市,新興區,正氣里,647,268,379,3,650,1282,0,50.7,20.9
高雄市,新興區,德政里,303,152,151,4,307,626,0,49.04,24.28
高雄市,新興區,仁聲里,420,176,244,1,421,979,0,43.0,17.98
高雄市,新興區,德望里,829,347,482,3,832,1808,0,46.02,19.19
高雄市,新興區,華聲里,407,150,257,3,410,902,0,45.45,16.63
高雄市,新興區,蕉園里,359,143,216,4,363,706,0,51.42,20.25
高雄市,新興區,永寧里,598,230,368,2,600,1289,0,46.55,17.84
高雄市,新興區,玉衡里,314,117,197,4,318,736,0,43.21,15.9
高雄市,新興區,順昌里,857,333,524,0,857,1998,0,42.89,16.67
高雄市,新興區,文昌里,1325,553,772,4,1329,2739,0,48.52,20.19
高雄市,新興區,光耀里,1053,454,599,7,1060,2197,0,48.25,20.66
高雄市,新興區,興昌里,783,351,432,8,791,1572,0,50.32,22.33
高雄市,新興區,開平里,1575,670,905,16,1591,3254,0,48.89,20.59
高雄市,新興區,成功里,585,284,301,5,590,1299,0,45.42,21.86
高雄市,新興區,新江里,456,156,300,4,460,1074,0,42.83,14.53
高雄市,新興區,黎明里,386,152,234,2,388,801,0,48.44,18.98
高雄市,新興區,愛平里,437,166,271,2,439,996,0,44.08,16.67
高雄市,新興區,南港里,986,330,656,10,996,1859,0,53.58,17.75
高雄市,新興區,中東里,1074,474,600,5,1079,2712,0,39.79,17.48
高雄市,新興區,明莊里,307,108,199,2,309,692,0,44.65,15.61
高雄市,新興區,大明里,474,173,301,5,479,1021,0,46.91,16.94
高雄市,新興區,秋山里,417,153,264,2,419,960,0,43.65,15.94
高雄市,新興區,長驛里,388,154,234,4,392,934,0,41.97,16.49
高雄市,新興區,建興里,386,126,260,1,387,919,0,42.11,13.71
高雄市,新興區,建華里,390,130,260,1,391,785,0,49.81,16.56
高雄市,新興區,漢民里,326,119,207,3,329,685,0,48.03,17.37
高雄市,新興區,榮治里,332,153,179,2,334,702,0,47.58,21.79
高雄市,新興區,東坡里,573,174,399,5,578,1152,0,50.17,15.1
高雄市,新興區,合計,20101,8229,11872,130,20231,43307,49925,46.72,19.0
高雄市,前金區,三川里,326,81,245,1,327,658,0,49.7,12.31
高雄市,前金區,草江里,487,222,265,4,491,983,0,49.95,22.58
高雄市,前金區,長城里,579,191,388,7,586,1310,0,44.73,14.58
高雄市,前金區,北金里,373,134,239,0,373,809,0,46.11,16.56
高雄市,前金區,東金里,472,174,298,2,474,957,0,49.53,18.18
高雄市,前金區,新生里,1626,740,886,9,1635,3581,0,45.66,20.66
高雄市,前金區,後金里,310,129,181,1,311,662,0,46.98,19.49
高雄市,前金區,長興里,531,217,314,4,535,1150,0,46.52,18.87
高雄市,前金區,青山里,813,329,484,11,824,1817,0,45.35,18.11
高雄市,前金區,民生里,351,159,192,1,352,778,0,45.24,20.44
高雄市,前金區,復元里,476,198,278,4,480,992,0,48.39,19.96
高雄市,前金區,林投里,404,133,271,2,406,1030,0,39.42,12.91
高雄市,前金區,國民里,410,159,251,5,415,901,0,46.06,17.65
高雄市,前金區,社東里,679,306,373,3,682,1424,0,47.89,21.49
高雄市,前金區,社西里,508,237,271,2,510,1017,0,50.15,23.3
高雄市,前金區,博孝里,465,185,280,2,467,986,0,47.36,18.76
高雄市,前金區,長生里,820,376,444,6,826,1640,0,50.37,22.93
高雄市,前金區,榮復里,487,199,288,4,491,1043,0,47.08,19.08
高雄市,前金區,文西里,449,161,288,4,453,941,0,48.14,17.11
高雄市,前金區,文東里,541,223,318,3,544,1108,0,49.1,20.13
高雄市,前金區,合計,11107,4553,6554,75,11182,23787,26498,47.01,19.14
高雄市,苓雅區,博仁里,340,162,178,1,341,681,0,50.07,23.79
高雄市,苓雅區,苓洲里,623,287,336,7,630,1496,0,42.11,19.18
高雄市,苓雅區,苓昇里,506,213,293,2,508,1147,0,44.29,18.57
高雄市,苓雅區,苓中里,702,260,442,12,714,1552,0,46.01,16.75
高雄市,苓雅區,苓雅里,610,276,334,1,611,1384,0,44.15,19.94
高雄市,苓雅區,苓東里,603,210,393,1,604,1405,0,42.99,14.95
高雄市,苓雅區,城北里,657,276,381,5,662,1540,0,42.99,17.92
高雄市,苓雅區,城西里,258,96,162,2,260,506,0,51.38,18.97
高雄市,苓雅區,城東里,798,325,473,8,806,1861,0,43.31,17.46
高雄市,苓雅區,意誠里,1387,650,737,7,1394,3663,0,38.06,17.75
高雄市,苓雅區,鼓中里,411,154,257,1,412,878,0,46.92,17.54
高雄市,苓雅區,田西里,608,266,342,5,613,1259,0,48.69,21.13
高雄市,苓雅區,人和里,717,272,445,10,727,1714,0,42.42,15.87
高雄市,苓雅區,仁政里,635,287,348,4,639,1191,0,53.65,24.1
高雄市,苓雅區,廣澤里,817,281,536,5,822,1686,0,48.75,16.67
高雄市,苓雅區,美田里,493,209,284,3,496,1085,0,45.71,19.26
高雄市,苓雅區,華堂里,1374,573,801,9,1383,2948,0,46.91,19.44
高雄市,苓雅區,日中里,1002,377,625,3,1005,2080,0,48.32,18.13
高雄市,苓雅區,普照里,1383,556,827,13,1396,2971,0,46.99,18.71
高雄市,苓雅區,和煦里,898,379,519,6,904,1962,0,46.08,19.32
高雄市,苓雅區,晴朗里,754,321,433,4,758,2551,0,29.71,12.58
高雄市,苓雅區,普天里,1565,675,890,12,1577,3394,0,46.46,19.89
高雄市,苓雅區,林富里,1029,444,585,7,1036,2101,0,49.31,21.13
高雄市,苓雅區,林圍里,1061,507,554,5,1066,2233,0,47.74,22.7
高雄市,苓雅區,林安里,649,306,343,2,651,1434,0,45.4,21.34
高雄市,苓雅區,光華里,319,101,218,4,323,666,0,48.5,15.17
高雄市,苓雅區,林興里,556,162,394,2,558,1226,0,45.51,13.21
高雄市,苓雅區,林華里,1214,447,767,7,1221,2632,0,46.39,16.98
高雄市,苓雅區,林西里,666,278,388,1,667,1516,0,44.0,18.34
高雄市,苓雅區,林中里,1254,498,756,5,1259,2734,0,46.05,18.22
高雄市,苓雅區,林泉里,873,418,455,7,880,1845,0,47.7,22.66
高雄市,苓雅區,林南里,1308,656,652,6,1314,2771,0,47.42,23.67
高雄市,苓雅區,中正里,1266,548,718,11,1277,2724,0,46.88,20.12
高雄市,苓雅區,尚義里,696,298,398,4,700,1480,0,47.3,20.14
高雄市,苓雅區,同慶里,986,469,517,8,994,2090,0,47.56,22.44
高雄市,苓雅區,凱旋里,940,491,449,2,942,2096,0,44.94,23.43
高雄市,苓雅區,安祥里,1105,486,619,7,1112,2380,0,46.72,20.42
高雄市,苓雅區,奏捷里,710,315,395,7,717,1489,0,48.15,21.16
高雄市,苓雅區,福壽里,679,206,473,7,686,1389,0,49.39,14.83
高雄市,苓雅區,福南里,787,286,501,10,797,1620,0,49.2,17.65
高雄市,苓雅區,五權里,1091,492,599,13,1104,2086,0,52.92,23.59
高雄市,苓雅區,民主里,1731,718,1013,17,1748,3752,0,46.59,19.14
高雄市,苓雅區,林德里,833,360,473,3,836,1742,0,47.99,20.67
高雄市,苓雅區,林貴里,776,326,450,4,780,1748,0,44.62,18.65
高雄市,苓雅區,林榮里,1667,752,915,8,1675,3776,0,44.36,19.92
高雄市,苓雅區,英明里,816,296,520,6,822,1791,0,45.9,16.53
高雄市,苓雅區,林靖里,734,400,334,9,743,1489,0,49.9,26.86
高雄市,苓雅區,朝陽里,619,229,390,4,623,1371,0,45.44,16.7
高雄市,苓雅區,福隆里,1128,391,737,11,1139,2410,0,47.26,16.22
高雄市,苓雅區,福祥里,527,233,294,3,530,1158,0,45.77,20.12
高雄市,苓雅區,福海里,450,220,230,7,457,1023,0,44.67,21.51
高雄市,苓雅區,福康里,850,278,572,11,861,1787,0,48.18,15.56
高雄市,苓雅區,福人里,818,342,476,11,829,1974,0,42.0,17.33
高雄市,苓雅區,福地里,1067,413,654,13,1080,2537,0,42.57,16.28
高雄市,苓雅區,福居里,1057,349,708,11,1068,2583,0,41.35,13.51
高雄市,苓雅區,福東里,1098,455,643,3,1101,2521,0,43.67,18.05
高雄市,苓雅區,福西里,783,276,507,5,788,1685,0,46.77,16.38
高雄市,苓雅區,永康里,985,441,544,4,989,2051,0,48.22,21.5
高雄市,苓雅區,正文里,993,396,597,4,997,2240,0,44.51,17.68
高雄市,苓雅區,正言里,1201,510,691,8,1209,2641,0,45.78,19.31
高雄市,苓雅區,正大里,1995,931,1064,18,2013,4822,0,41.75,19.31
高雄市,苓雅區,五福里,1637,689,948,11,1648,3581,0,46.02,19.24
高雄市,苓雅區,正心里,1596,674,922,8,1604,3399,0,47.19,19.83
高雄市,苓雅區,正道里,1720,721,999,13,1733,4055,0,42.74,17.78
高雄市,苓雅區,正義里,1160,421,739,4,1164,2329,0,49.98,18.08
高雄市,苓雅區,正仁里,1006,442,564,6,1012,2409,0,42.01,18.35
高雄市,苓雅區,文昌里,1546,561,985,12,1558,3573,0,43.6,15.7
高雄市,苓雅區,建軍里,796,272,524,10,806,1945,0,41.44,13.98
高雄市,苓雅區,衛武里,887,410,477,4,891,1894,0,47.04,21.65
高雄市,苓雅區,合計,64806,27019,37787,464,65270,143752,166008,45.4,18.8
高雄市,前鎮區,草衙里,3592,1104,2488,29,3621,9285,0,39.0,11.89
高雄市,前鎮區,明孝里,980,290,690,8,988,2288,0,43.18,12.67
高雄市,前鎮區,明正里,2217,691,1526,22,2239,4994,0,44.83,13.84
高雄市,前鎮區,明義里,978,335,643,11,989,2203,0,44.89,15.21
高雄市,前鎮區,仁愛里,565,161,404,8,573,1263,0,45.37,12.75
高雄市,前鎮區,德昌里,732,285,447,7,739,1891,0,39.08,15.07
高雄市,前鎮區,平等里,855,291,564,8,863,2883,0,29.93,10.09
高雄市,前鎮區,平昌里,241,58,183,6,247,606,0,40.76,9.57
高雄市,前鎮區,明禮里,627,163,464,5,632,1420,0,44.51,11.48
高雄市,前鎮區,信義里,636,169,467,4,640,1365,0,46.89,12.38
高雄市,前鎮區,信德里,916,307,609,7,923,2203,0,41.9,13.94
高雄市,前鎮區,明道里,446,117,329,3,449,1033,0,43.47,11.33
高雄市,前鎮區,興化里,313,90,223,4,317,656,0,48.32,13.72
高雄市,前鎮區,興仁里,311,70,241,0,311,673,0,46.21,10.4
高雄市,前鎮區,前鎮里,593,169,424,11,604,1293,0,46.71,13.07
高雄市,前鎮區,鎮東里,830,233,597,6,836,1636,0,51.1,14.24
高雄市,前鎮區,鎮榮里,910,265,645,11,921,2041,0,45.12,12.98
高雄市,前鎮區,鎮昌里,856,255,601,8,864,1918,0,45.05,13.3
高雄市,前鎮區,鎮海里,1755,638,1117,9,1764,3979,0,44.33,16.03
高雄市,前鎮區,鎮陽里,400,147,253,3,403,902,0,44.68,16.3
高雄市,前鎮區,興邦里,1251,543,708,8,1259,2779,0,45.3,19.54
高雄市,前鎮區,鎮中里,366,122,244,1,367,802,0,45.76,15.21
高雄市,前鎮區,鎮北里,497,176,321,8,505,1077,0,46.89,16.34
高雄市,前鎮區,忠純里,2518,1736,782,32,2550,5166,0,49.36,33.6
高雄市,前鎮區,忠誠里,981,798,183,17,998,1970,0,50.66,40.51
高雄市,前鎮區,西山里,1464,675,789,11,1475,3261,0,45.23,20.7
高雄市,前鎮區,民權里,1930,963,967,9,1939,3898,0,49.74,24.7
高雄市,前鎮區,建隆里,585,263,322,7,592,1249,0,47.4,21.06
高雄市,前鎮區,振興里,1007,464,543,3,1010,2251,0,44.87,20.61
高雄市,前鎮區,良和里,1358,716,642,4,1362,2750,0,49.53,26.04
高雄市,前鎮區,西甲里,909,330,579,4,913,2053,0,44.47,16.07
高雄市,前鎮區,盛興里,1108,537,571,6,1114,2633,0,42.31,20.39
高雄市,前鎮區,盛豐里,1303,505,798,12,1315,2968,0,44.31,17.01
高雄市,前鎮區,興中里,1296,545,751,14,1310,2985,0,43.89,18.26
高雄市,前鎮區,興東里,2486,1075,1411,21,2507,5492,0,45.65,19.57
高雄市,前鎮區,忠孝里,1371,651,720,13,1384,2994,0,46.23,21.74
高雄市,前鎮區,復國里,1176,428,748,10,1186,2585,0,45.88,16.56
高雄市,前鎮區,竹內里,1240,415,825,13,1253,2634,0,47.57,15.76
高雄市,前鎮區,竹東里,925,351,574,2,927,2104,0,44.06,16.68
高雄市,前鎮區,竹南里,2890,1205,1685,17,2907,6665,0,43.62,18.08
高雄市,前鎮區,竹北里,998,397,601,8,1006,2331,0,43.16,17.03
高雄市,前鎮區,竹西里,1832,773,1059,9,1841,3965,0,46.43,19.5
高雄市,前鎮區,竹中里,1534,636,898,8,1542,3340,0,46.17,19.04
高雄市,前鎮區,瑞竹里,644,222,422,6,650,1563,0,41.59,14.2
高雄市,前鎮區,瑞南里,1918,658,1260,10,1928,4567,0,42.22,14.41
高雄市,前鎮區,瑞豐里,1086,385,701,8,1094,2650,0,41.28,14.53
高雄市,前鎮區,瑞祥里,1892,713,1179,11,1903,4492,0,42.36,15.87
高雄市,前鎮區,瑞東里,943,284,659,2,945,2252,0,41.96,12.61
高雄市,前鎮區,瑞和里,788,237,551,6,794,1810,0,43.87,13.09
高雄市,前鎮區,瑞平里,1603,563,1040,9,1612,3473,0,46.42,16.21
高雄市,前鎮區,瑞隆里,1494,511,983,11,1505,3408,0,44.16,14.99
高雄市,前鎮區,瑞北里,1356,420,936,10,1366,3140,0,43.5,13.38
高雄市,前鎮區,瑞西里,1063,291,772,10,1073,2484,0,43.2,11.71
高雄市,前鎮區,瑞崗里,1142,372,770,4,1146,2474,0,46.32,15.04
高雄市,前鎮區,瑞興里,1081,334,747,6,1087,2446,0,44.44,13.65
高雄市,前鎮區,瑞誠里,1068,400,668,9,1077,2518,0,42.77,15.89
高雄市,前鎮區,瑞文里,987,296,691,7,994,2355,0,42.21,12.57
高雄市,前鎮區,瑞華里,1962,756,1206,7,1969,4394,0,44.81,17.21
高雄市,前鎮區,瑞昌里,1316,403,913,8,1324,3072,0,43.1,13.12
高雄市,前鎮區,合計,70121,26987,43134,531,70652,159582,184355,44.27,16.91
高雄市,旗津區,旗下里,510,131,379,5,515,1181,0,43.61,11.09
高雄市,旗津區,永安里,383,127,256,5,388,1056,0,36.74,12.03
高雄市,旗津區,振興里,621,172,449,7,628,1544,0,40.67,11.14
高雄市,旗津區,慈愛里,792,218,574,3,795,2240,0,35.49,9.73
高雄市,旗津區,復興里,990,392,598,11,1001,2922,0,34.26,13.42
高雄市,旗津區,中華里,638,169,469,3,641,1497,0,42.82,11.29
高雄市,旗津區,實踐里,506,300,206,5,511,1394,0,36.66,21.52
高雄市,旗津區,北汕里,872,277,595,6,878,2620,0,33.51,10.57
高雄市,旗津區,南汕里,779,184,595,9,788,2021,0,38.99,9.1
高雄市,旗津區,上竹里,1033,212,821,9,1042,2749,0,37.9,7.71
高雄市,旗津區,中洲里,742,182,560,3,745,1802,0,41.34,10.1
高雄市,旗津區,安順里,330,62,268,2,332,863,0,38.47,7.18
高雄市,旗津區,中興里,1012,296,716,7,1019,2457,0,41.47,12.05
高雄市,旗津區,合計,9208,2722,6486,75,9283,24346,27515,38.13,11.18
高雄市,小港區,小港里,980,344,636,7,987,2204,0,44.78,15.61
高雄市,小港區,港口里,1375,610,765,8,1383,3080,0,44.9,19.81
高雄市,小港區,港正里,998,461,537,5,1003,2455,0,40.86,18.78
高雄市,小港區,港墘里,658,251,407,4,662,1658,0,39.93,15.14
高雄市,小港區,港明里,1122,388,734,8,1130,3006,0,37.59,12.91
高雄市,小港區,港后里,1091,393,698,4,1095,2482,0,44.12,15.83
高雄市,小港區,港南里,902,326,576,3,905,2715,0,33.33,12.01
高雄市,小港區,港興里,1010,364,646,10,1020,2209,0,46.17,16.48
高雄市,小港區,鳳宮里,996,334,662,3,999,2601,0,38.41,12.84
高雄市,小港區,店鎮里,2249,783,1466,16,2265,5620,0,40.3,13.93
高雄市,小港區,大苓里,1048,384,664,13,1061,2419,0,43.86,15.87
高雄市,小港區,二苓里,1418,442,976,5,1423,3563,0,39.94,12.41
高雄市,小港區,三苓里,1185,429,756,10,1195,2779,0,43.0,15.44
高雄市,小港區,正苓里,1471,617,854,12,1483,3906,0,37.97,15.8
高雄市,小港區,順苓里,1721,658,1063,10,1731,4344,0,39.85,15.15
高雄市,小港區,六苓里,1082,390,692,10,1092,2502,0,43.65,15.59
高雄市,小港區,宏亮里,1210,462,748,8,1218,3165,0,38.48,14.6
高雄市,小港區,山東里,1146,532,614,2,1148,2869,0,40.01,18.54
高雄市,小港區,青島里,1009,598,411,6,1015,2305,0,44.03,25.94
高雄市,小港區,濟南里,1660,777,883,16,1676,4066,0,41.22,19.11
高雄市,小港區,泰山里,1333,490,843,11,1344,3176,0,42.32,15.43
高雄市,小港區,山明里,4224,1450,2774,35,4259,11217,0,37.97,12.93
高雄市,小港區,高松里,1596,562,1034,10,1606,4154,0,38.66,13.53
高雄市,小港區,松金里,1002,334,668,10,1012,2549,0,39.7,13.1
高雄市,小港區,松山里,1328,506,822,14,1342,3066,0,43.77,16.5
高雄市,小港區,大坪里,1118,362,756,10,1128,2844,0,39.66,12.73
高雄市,小港區,坪頂里,2183,751,1432,15,2198,6006,0,36.6,12.5
高雄市,小港區,孔宅里,1927,724,1203,21,1948,4655,0,41.85,15.55
高雄市,小港區,廈莊里,1477,571,906,19,1496,3839,0,38.97,14.87
高雄市,小港區,合作里,1147,375,772,4,1151,2569,0,44.8,14.6
高雄市,小港區,桂林里,3079,1060,2019,15,3094,7687,0,40.25,13.79
高雄市,小港區,中厝里,1360,468,892,11,1371,3630,0,37.77,12.89
高雄市,小港區,鳳鳴里,1215,421,794,14,1229,3132,0,39.24,13.44
高雄市,小港區,龍鳳里,1193,392,801,4,1197,3059,0,39.13,12.81
高雄市,小港區,鳳森里,897,239,658,7,904,2196,0,41.17,10.88
高雄市,小港區,鳳林里,1205,327,878,9,1214,3013,0,40.29,10.85
高雄市,小港區,鳳興里,925,267,658,10,935,2483,0,37.66,10.75
高雄市,小港區,鳳源里,1342,313,1029,11,1353,3605,0,37.53,8.68
高雄市,小港區,合計,52882,19155,33727,390,53272,132828,156580,40.11,14.42
高雄市,鳳山區,縣口里,173,73,100,3,176,406,0,43.35,17.98
高雄市,鳳山區,成功里,278,101,177,3,281,599,0,46.91,16.86
高雄市,鳳山區,光明里,573,222,351,5,578,1288,0,44.88,17.24
高雄市,鳳山區,興中里,429,212,217,1,430,847,0,50.77,25.03
高雄市,鳳山區,南興里,413,166,247,2,415,864,0,48.03,19.21
高雄市,鳳山區,和德里,963,440,523,7,970,2199,0,44.11,20.01
高雄市,鳳山區,鳳崗里,491,234,257,3,494,1023,0,48.29,22.87
高雄市,鳳山區,中和里,1589,795,794,11,1600,3304,0,48.43,24.06
高雄市,鳳山區,鎮北里,3720,1448,2272,24,3744,10134,0,36.94,14.29
高雄市,鳳山區,縣衙里,358,173,185,3,361,800,0,45.13,21.63
高雄市,鳳山區,文英里,1515,623,892,7,1522,3583,0,42.48,17.39
高雄市,鳳山區,鎮西里,2154,899,1255,16,2170,4831,0,44.92,18.61
高雄市,鳳山區,鎮東里,955,383,572,4,959,2419,0,39.64,15.83
高雄市,鳳山區,埤頂里,2511,1192,1319,13,2524,5862,0,43.06,20.33
高雄市,鳳山區,中正里,1877,1508,369,15,1892,4101,0,46.14,36.77
高雄市,鳳山區,鎮南里,1967,727,1240,20,1987,4690,0,42.37,15.5
高雄市,鳳山區,老爺里,2797,906,1891,13,2810,6676,0,42.09,13.57
高雄市,鳳山區,瑞竹里,2113,980,1133,22,2135,5045,0,42.32,19.43
高雄市,鳳山區,忠義里,2043,953,1090,24,2067,4468,0,46.26,21.33
高雄市,鳳山區,誠義里,1685,852,833,12,1697,3708,0,45.77,22.98
高雄市,鳳山區,新興里,714,263,451,5,719,3408,0,21.1,7.72
高雄市,鳳山區,海光里,1249,716,533,15,1264,2855,0,44.27,25.08
高雄市,鳳山區,忠誠里,1494,559,935,9,1503,3386,0,44.39,16.51
高雄市,鳳山區,新甲里,1339,519,820,14,1353,2970,0,45.56,17.47
高雄市,鳳山區,武漢里,2003,742,1261,16,2019,4656,0,43.36,15.94
高雄市,鳳山區,正義里,2608,847,1761,22,2630,6047,0,43.49,14.01
高雄市,鳳山區,一甲里,1262,386,876,7,1269,3158,0,40.18,12.22
高雄市,鳳山區,福興里,2328,751,1577,21,2349,5638,0,41.66,13.32
高雄市,鳳山區,東門里,2224,1226,998,17,2241,5295,0,42.32,23.15
高雄市,鳳山區,瑞興里,2017,1004,1013,15,2032,4791,0,42.41,20.96
高雄市,鳳山區,天興里,1504,524,980,9,1513,3443,0,43.94,15.22
高雄市,鳳山區,新強里,2311,911,1400,9,2320,5183,0,44.76,17.58
高雄市,鳳山區,國泰里,1593,686,907,10,1603,3682,0,43.54,18.63
高雄市,鳳山區,鳳東里,2677,1146,1531,21,2698,6156,0,43.83,18.62
高雄市,鳳山區,新富里,1645,593,1052,9,1654,3986,0,41.5,14.88
高雄市,鳳山區,國光里,1476,654,822,12,1488,3202,0,46.47,20.42
高雄市,鳳山區,國隆里,1064,346,718,9,1073,2412,0,44.49,14.34
高雄市,鳳山區,文德里,3793,1816,1977,19,3812,8807,0,43.28,20.62
高雄市,鳳山區,過埤里,5114,2088,3026,19,5133,13720,0,37.41,15.22
高雄市,鳳山區,曹公里,875,411,464,8,883,1878,0,47.02,21.88
高雄市,鳳山區,興仁里,1519,644,875,12,1531,3300,0,46.39,19.52
高雄市,鳳山區,五福里,1323,459,864,11,1334,2954,0,45.16,15.54
高雄市,鳳山區,忠孝里,2442,1144,1298,17,2459,5599,0,43.92,20.43
高雄市,鳳山區,生明里,889,493,396,10,899,1995,0,45.06,24.71
高雄市,鳳山區,和興里,2038,854,1184,18,2056,4606,0,44.64,18.54
高雄市,鳳山區,協和里,1466,781,685,15,1481,3154,0,46.96,24.76
高雄市,鳳山區,文山里,2715,1013,1702,17,2732,6154,0,44.39,16.46
高雄市,鳳山區,福誠里,1964,699,1265,17,1981,4554,0,43.5,15.35
高雄市,鳳山區,誠德里,1014,564,450,11,1025,2537,0,40.4,22.23
高雄市,鳳山區,三民里,505,218,287,7,512,1040,0,49.23,20.96
高雄市,鳳山區,北門里,1665,648,1017,17,1682,3969,0,42.38,16.33
高雄市,鳳山區,富甲里,728,254,474,10,738,1831,0,40.31,13.87
高雄市,鳳山區,南成里,3513,1167,2346,30,3543,8197,0,43.22,14.24
高雄市,鳳山區,文華里,3605,1860,1745,30,3635,8181,0,44.43,22.74
高雄市,鳳山區,大德里,1705,557,1148,13,1718,4349,0,39.5,12.81
高雄市,鳳山區,武松里,1048,414,634,5,1053,2612,0,40.31,15.85
高雄市,鳳山區,文衡里,1681,741,940,13,1694,4036,0,41.97,18.36
高雄市,鳳山區,文福里,4070,1889,2181,29,4099,9452,0,43.37,19.99
高雄市,鳳山區,誠信里,812,526,286,7,819,2046,0,40.03,25.71
高雄市,鳳山區,誠智里,1071,593,478,9,1080,2686,0,40.21,22.08
高雄市,鳳山區,國富里,1178,562,616,8,1186,2531,0,46.86,22.2
高雄市,鳳山區,武慶里,1009,390,619,8,1017,2292,0,44.37,17.02
高雄市,鳳山區,海洋里,1671,674,997,12,1683,3737,0,45.04,18.04
高雄市,鳳山區,新武里,1043,346,697,10,1053,2353,0,44.75,14.7
高雄市,鳳山區,新樂里,1817,732,1085,4,1821,4273,0,42.62,17.13
高雄市,鳳山區,新泰里,1642,718,924,6,1648,4006,0,41.14,17.92
高雄市,鳳山區,中崙里,1063,461,602,9,1072,2454,0,43.68,18.79
高雄市,鳳山區,中榮里,1744,741,1003,9,1753,4441,0,39.47,16.69
高雄市,鳳山區,中民里,1830,651,1179,18,1848,4469,0,41.35,14.57
高雄市,鳳山區,二甲里,1918,677,1241,14,1932,4472,0,43.2,15.14
高雄市,鳳山區,龍成里,1133,363,770,5,1138,2740,0,41.53,13.25
高雄市,鳳山區,富榮里,984,376,608,8,992,2367,0,41.91,15.89
高雄市,鳳山區,善美里,2065,745,1320,13,2078,5524,0,37.62,13.49
高雄市,鳳山區,南和里,1102,334,768,9,1111,2597,0,42.78,12.86
高雄市,鳳山區,福祥里,1096,322,774,4,1100,2652,0,41.48,12.14
高雄市,鳳山區,保安里,2636,997,1639,23,2659,6389,0,41.62,15.6
高雄市,鳳山區,合計,127598,53682,73916,932,128530,302069,358785,42.55,17.77
高雄市,林園區,東林里,1020,327,693,7,1027,2799,0,36.69,11.68
高雄市,林園區,林園里,1248,432,816,13,1261,3070,0,41.07,14.07
高雄市,林園區,溪州里,1540,478,1062,14,1554,4129,0,37.64,11.58
高雄市,林園區,潭頭里,1061,394,667,17,1078,2749,0,39.21,14.33
高雄市,林園區,中厝里,1233,478,755,21,1254,2981,0,42.07,16.03
高雄市,林園區,中門里,983,329,654,17,1000,2474,0,40.42,13.3
高雄市,林園區,頂厝里,1771,528,1243,20,1791,4546,0,39.4,11.61
高雄市,林園區,港埔里,754,198,556,8,762,1795,0,42.45,11.03
高雄市,林園區,西溪里,1297,294,1003,21,1318,3401,0,38.75,8.64
高雄市,林園區,港嘴里,708,171,537,5,713,1671,0,42.67,10.23
高雄市,林園區,北汕里,526,189,337,4,530,1576,0,33.63,11.99
高雄市,林園區,林內里,715,312,403,8,723,1960,0,36.89,15.92
高雄市,林園區,王公里,1615,559,1056,15,1630,4087,0,39.88,13.68
高雄市,林園區,林家里,480,154,326,2,482,1274,0,37.83,12.09
高雄市,林園區,龔厝里,852,247,605,7,859,1939,0,44.3,12.74
高雄市,林園區,鳳芸里,713,164,549,9,722,1726,0,41.83,9.5
高雄市,林園區,中芸里,691,151,540,10,701,1767,0,39.67,8.55
高雄市,林園區,東汕里,318,90,228,3,321,883,0,36.35,10.19
高雄市,林園區,西汕里,264,55,209,0,264,729,0,36.21,7.54
高雄市,林園區,仁愛里,1202,362,840,10,1212,2918,0,41.54,12.41
高雄市,林園區,文賢里,1012,393,619,11,1023,2393,0,42.75,16.42
高雄市,林園區,廣應里,1338,429,909,12,1350,3366,0,40.11,12.75
高雄市,林園區,五福里,849,269,580,12,861,2660,0,32.37,10.11
高雄市,林園區,中汕里,766,150,616,11,777,2268,0,34.26,6.61
高雄市,林園區,合計,22956,7153,15803,257,23213,59161,69161,39.24,12.09
高雄市,大寮區,拷潭里,590,154,436,7,597,1391,0,42.92,11.07
高雄市,大寮區,內坑里,2103,794,1309,17,2120,5790,0,36.61,13.71
高雄市,大寮區,大寮里,2386,736,1650,40,2426,6676,0,36.34,11.02
高雄市,大寮區,上寮里,987,257,730,5,992,2414,0,41.09,10.65
高雄市,大寮區,三隆里,1871,596,1275,19,1890,4615,0,40.95,12.91
高雄市,大寮區,琉球里,1975,567,1408,13,1988,4639,0,42.85,12.22
高雄市,大寮區,翁園里,1752,434,1318,16,1768,3885,0,45.51,11.17
高雄市,大寮區,前庄里,1083,439,644,14,1097,2318,0,47.33,18.94
高雄市,大寮區,中庄里,4186,1419,2767,33,4219,10756,0,39.22,13.19
高雄市,大寮區,後庄里,3084,1225,1859,29,3113,7626,0,40.82,16.06
高雄市,大寮區,義仁里,749,207,542,11,760,1803,0,42.15,11.48
高雄市,大寮區,新厝里,595,175,420,4,599,1666,0,35.95,10.5
高雄市,大寮區,過溪里,998,327,671,5,1003,2472,0,40.57,13.23
高雄市,大寮區,潮寮里,1185,308,877,12,1197,2917,0,41.04,10.56
高雄市,大寮區,會結里,591,194,397,4,595,1538,0,38.69,12.61
高雄市,大寮區,會社里,2339,987,1352,23,2362,6229,0,37.92,15.85
高雄市,大寮區,山頂里,2970,1437,1533,24,2994,7455,0,40.16,19.28
高雄市,大寮區,忠義里,245,152,93,3,248,541,0,45.84,28.1
高雄市,大寮區,永芳里,2766,991,1775,23,2789,6812,0,40.94,14.55
高雄市,大寮區,義和里,957,265,692,10,967,2201,0,43.93,12.04
高雄市,大寮區,溪寮里,677,216,461,5,682,1545,0,44.14,13.98
高雄市,大寮區,江山里,825,255,570,6,831,1851,0,44.89,13.78
高雄市,大寮區,昭明里,1398,393,1005,13,1411,3723,0,37.9,10.56
高雄市,大寮區,光武里,42,27,15,4,46,111,0,41.44,24.32
高雄市,大寮區,中興里,2751,1642,1109,41,2792,6664,0,41.9,24.64
高雄市,大寮區,合計,39105,14197,24908,381,39486,97638,112129,40.44,14.54
高雄市,大樹區,竹寮里,1120,414,706,6,1126,2680,0,42.01,15.45
高雄市,大樹區,九曲里,1906,729,1177,20,1926,5186,0,37.14,14.06
高雄市,大樹區,久堂里,1732,657,1075,21,1753,4079,0,42.98,16.11
高雄市,大樹區,水安里,1026,314,712,10,1036,2313,0,44.79,13.58
高雄市,大樹區,水寮里,1013,293,720,8,1021,2219,0,46.01,13.2
高雄市,大樹區,檨腳里,1347,416,931,10,1357,3451,0,39.32,12.05
高雄市,大樹區,興山里,418,84,334,3,421,1026,0,41.03,8.19
高雄市,大樹區,和山里,406,104,302,0,406,994,0,40.85,10.46
高雄市,大樹區,姑山里,435,332,103,4,439,962,0,45.63,34.51
高雄市,大樹區,大坑里,566,164,402,5,571,1434,0,39.82,11.44
高雄市,大樹區,井腳里,653,140,513,4,657,1505,0,43.65,9.3
高雄市,大樹區,小坪里,562,171,391,12,574,1311,0,43.78,13.04
高雄市,大樹區,龍目里,763,135,628,12,775,1752,0,44.24,7.71
高雄市,大樹區,大樹里,996,257,739,14,1010,2492,0,40.53,10.31
高雄市,大樹區,三和里,377,135,242,3,380,994,0,38.23,13.58
高雄市,大樹區,溪埔里,626,161,465,7,633,1539,0,41.13,10.46
高雄市,大樹區,興田里,753,311,442,6,759,1855,0,40.92,16.77
高雄市,大樹區,統嶺里,265,84,181,1,266,670,0,39.7,12.54
高雄市,大樹區,合計,14964,4901,10063,146,15110,36462,41549,41.44,13.44
高雄市,大社區,嘉誠里,317,125,192,4,321,899,0,35.71,13.9
高雄市,大社區,保社里,1410,501,909,20,1430,3267,0,43.77,15.34
高雄市,大社區,大社里,2044,706,1338,18,2062,4936,0,41.77,14.3
高雄市,大社區,翠屏里,692,197,495,6,698,1648,0,42.35,11.95
高雄市,大社區,三奶里,1170,359,811,18,1188,2706,0,43.9,13.27
高雄市,大社區,觀音里,2419,735,1684,18,2437,5416,0,45.0,13.57
高雄市,大社區,神農里,1918,647,1271,11,1929,4948,0,38.99,13.08
高雄市,大社區,中里里,1330,428,902,18,1348,3171,0,42.51,13.5
高雄市,大社區,保安里,1311,385,926,17,1328,3118,0,42.59,12.35
高雄市,大社區,合計,12611,4083,8528,130,12741,30109,34208,42.32,13.56
高雄市,仁武區,大灣里,1836,640,1196,9,1845,4416,0,41.78,14.49
高雄市,仁武區,灣內里,3151,1130,2021,20,3171,7950,0,39.89,14.21
高雄市,仁武區,考潭里,1216,473,743,8,1224,2625,0,46.63,18.02
高雄市,仁武區,烏林里,1365,479,886,16,1381,3764,0,36.69,12.73
高雄市,仁武區,仁福里,328,107,221,4,332,849,0,39.1,12.6
高雄市,仁武區,仁武里,2035,637,1398,20,2055,5452,0,37.69,11.68
高雄市,仁武區,文武里,3767,1272,2495,26,3793,9055,0,41.89,14.05
高雄市,仁武區,竹後里,1019,221,798,6,1025,2172,0,47.19,10.17
高雄市,仁武區,八卦里,7046,2778,4268,45,7091,17709,0,40.04,15.69
高雄市,仁武區,高楠里,1089,387,702,12,1101,2610,0,42.18,14.83
高雄市,仁武區,後安里,1065,271,794,8,1073,2542,0,42.21,10.66
高雄市,仁武區,中華里,646,264,382,4,650,1606,0,40.47,16.44
高雄市,仁武區,五和里,1999,709,1290,11,2010,5171,0,38.87,13.71
高雄市,仁武區,仁和里,1702,643,1059,10,1712,3838,0,44.61,16.75
高雄市,仁武區,赤山里,2847,1111,1736,25,2872,6762,0,42.47,16.43
高雄市,仁武區,仁慈里,1062,418,644,11,1073,2202,0,48.73,18.98
高雄市,仁武區,合計,32173,11540,20633,235,32408,78723,92846,41.17,14.66
高雄市,鳥松區,鳥松里,4422,1739,2683,35,4457,10418,0,42.78,16.69
高雄市,鳥松區,夢裡里,2310,935,1375,13,2323,4917,0,47.24,19.02
高雄市,鳥松區,大華里,4811,2084,2727,28,4839,9866,0,49.05,21.12
高雄市,鳥松區,坔埔里,1631,545,1086,12,1643,3551,0,46.27,15.35
高雄市,鳥松區,仁美里,2749,827,1922,24,2773,6496,0,42.69,12.73
高雄市,鳥松區,大竹里,337,95,242,0,337,678,0,49.71,14.01
高雄市,鳥松區,華美里,1733,614,1119,10,1743,3874,0,44.99,15.85
高雄市,鳥松區,合計,17993,6839,11154,122,18115,39800,44727,45.52,17.18
高雄市,岡山區,平安里,470,194,276,6,476,1073,0,44.36,18.08
高雄市,岡山區,岡山里,1674,637,1037,8,1682,4363,0,38.55,14.6
高雄市,岡山區,壽天里,1439,651,788,9,1448,3149,0,45.98,20.67
高雄市,岡山區,維仁里,415,144,271,5,420,985,0,42.64,14.62
高雄市,岡山區,後紅里,1694,801,893,17,1711,4134,0,41.39,19.38
高雄市,岡山區,大遼里,634,165,469,10,644,1366,0,47.14,12.08
高雄市,岡山區,忠孝里,1318,1021,297,19,1337,2810,0,47.58,36.33
高雄市,岡山區,和平里,152,71,81,2,154,300,0,51.33,23.67
高雄市,岡山區,前峰里,1181,443,738,17,1198,2809,0,42.65,15.77
高雄市,岡山區,劉厝里,706,222,484,8,714,1401,0,50.96,15.85
高雄市,岡山區,協和里,1612,669,943,23,1635,3572,0,45.77,18.73
高雄市,岡山區,後協里,2223,1040,1183,22,2245,5458,0,41.13,19.05
高雄市,岡山區,信義里,658,368,290,3,661,1556,0,42.48,23.65
高雄市,岡山區,潭底里,337,83,254,3,340,761,0,44.68,10.91
高雄市,岡山區,三和里,364,81,283,5,369,867,0,42.56,9.34
高雄市,岡山區,仁壽里,1502,630,872,12,1514,3290,0,46.02,19.15
高雄市,岡山區,碧紅里,1542,613,929,11,1553,3822,0,40.63,16.04
高雄市,岡山區,程香里,1712,771,941,19,1731,4091,0,42.31,18.85
高雄市,岡山區,竹圍里,2657,1019,1638,15,2672,6810,0,39.24,14.96
高雄市,岡山區,台上里,2313,842,1471,12,2325,5811,0,40.01,14.49
高雄市,岡山區,灣裡里,771,273,498,2,773,1862,0,41.51,14.66
高雄市,岡山區,白米里,784,299,485,4,788,1933,0,40.77,15.47
高雄市,岡山區,石潭里,890,326,564,2,892,1850,0,48.22,17.62
高雄市,岡山區,福興里,472,176,296,3,475,1048,0,45.32,16.79
高雄市,岡山區,本洲里,678,219,459,4,682,1683,0,40.52,13.01
高雄市,岡山區,嘉興里,1395,388,1007,13,1408,3339,0,42.17,11.62
高雄市,岡山區,嘉峰里,774,284,490,11,785,1747,0,44.93,16.26
高雄市,岡山區,華崗里,750,143,607,6,756,1567,0,48.25,9.13
高雄市,岡山區,大莊里,361,134,227,5,366,984,0,37.2,13.62
高雄市,岡山區,協榮里,869,449,420,2,871,2090,0,41.67,21.48
高雄市,岡山區,為隨里,289,89,200,4,293,631,0,46.43,14.1
高雄市,岡山區,壽峰里,965,423,542,7,972,2230,0,43.59,18.97
高雄市,岡山區,仁義里,980,864,116,14,994,1809,0,54.95,47.76
高雄市,岡山區,合計,34581,14532,20049,303,34884,81201,96433,42.96,17.9
高雄市,橋頭區,橋頭里,944,344,600,7,951,2052,0,46.35,16.76
高雄市,橋頭區,橋南里,540,161,379,6,546,1060,0,51.51,15.19
高雄市,橋頭區,仕隆里,1130,339,791,8,1138,2289,0,49.72,14.81
高雄市,橋頭區,仕豐里,1252,464,788,10,1262,2597,0,48.59,17.87
高雄市,橋頭區,芋寮里,561,169,392,1,562,1196,0,46.99,14.13
高雄市,橋頭區,東林里,1074,277,797,13,1087,2294,0,47.38,12.07
高雄市,橋頭區,西林里,651,154,497,5,656,1371,0,47.85,11.23
高雄市,橋頭區,白樹里,1441,496,945,12,1453,3241,0,44.83,15.3
高雄市,橋頭區,筆秀里,727,201,526,6,733,1506,0,48.67,13.35
高雄市,橋頭區,新莊里,1866,707,1159,8,1874,4359,0,42.99,16.22
高雄市,橋頭區,甲北里,931,306,625,15,946,2139,0,44.23,14.31
高雄市,橋頭區,甲南里,1072,333,739,13,1085,2401,0,45.19,13.87
高雄市,橋頭區,頂鹽里,593,187,406,4,597,1340,0,44.55,13.96
高雄市,橋頭區,中崎里,283,61,222,2,285,662,0,43.05,9.21
高雄市,橋頭區,仕和里,1765,549,1216,14,1779,3625,0,49.08,15.14
高雄市,橋頭區,德松里,665,209,456,9,674,1442,0,46.74,14.49
高雄市,橋頭區,三德里,354,77,277,2,356,776,0,45.88,9.92
高雄市,橋頭區,合計,15849,5034,10815,135,15984,34350,39528,46.53,14.66
高雄市,燕巢區,尖山里,435,129,306,0,435,1096,0,39.69,11.77
高雄市,燕巢區,瓊林里,914,292,622,8,922,2055,0,44.87,14.21
高雄市,燕巢區,安招里,1393,458,935,19,1412,3308,0,42.68,13.85
高雄市,燕巢區,角宿里,1142,421,721,16,1158,2690,0,43.05,15.65
高雄市,燕巢區,鳳雄里,1048,343,705,11,1059,2471,0,42.86,13.88
高雄市,燕巢區,金山里,165,79,86,6,171,464,0,36.85,17.03
高雄市,燕巢區,東燕里,869,289,580,13,882,2315,0,38.1,12.48
高雄市,燕巢區,南燕里,1500,610,890,13,1513,3871,0,39.09,15.76
高雄市,燕巢區,西燕里,1278,443,835,12,1290,3315,0,38.91,13.36
高雄市,燕巢區,橫山里,700,242,458,8,708,1874,0,37.78,12.91
高雄市,燕巢區,深水里,889,292,597,11,900,2396,0,37.56,12.19
高雄市,燕巢區,合計,10333,3598,6735,117,10450,25855,29312,40.42,13.92
高雄市,田寮區,鹿埔里,141,52,89,1,142,347,0,40.92,14.99
高雄市,田寮區,南安里,360,104,256,14,374,1016,0,36.81,10.24
高雄市,田寮區,大同里,142,27,115,1,143,364,0,39.29,7.42
高雄市,田寮區,田寮里,128,28,100,1,129,364,0,35.44,7.69
高雄市,田寮區,七星里,223,54,169,4,227,594,0,38.22,9.09
高雄市,田寮區,崇德里,343,142,201,5,348,914,0,38.07,15.54
高雄市,田寮區,西德里,254,90,164,7,261,777,0,33.59,11.58
高雄市,田寮區,三和里,111,45,66,1,112,333,0,33.63,13.51
高雄市,田寮區,古亭里,160,41,119,2,162,484,0,33.47,8.47
高雄市,田寮區,新興里,453,112,341,6,459,1164,0,39.43,9.62
高雄市,田寮區,合計,2315,695,1620,42,2357,6357,6860,37.08,10.93
高雄市,阿蓮區,石安里,486,127,359,3,489,1283,0,38.11,9.9
高雄市,阿蓮區,中路里,825,170,655,10,835,1973,0,42.32,8.62
高雄市,阿蓮區,峯山里,463,119,344,3,466,1209,0,38.54,9.84
高雄市,阿蓮區,港後里,870,339,531,7,877,2122,0,41.33,15.98
高雄市,阿蓮區,崗山里,274,101,173,5,279,761,0,36.66,13.27
高雄市,阿蓮區,阿蓮里,1791,572,1219,17,1808,4888,0,36.99,11.7
高雄市,阿蓮區,清蓮里,955,281,674,9,964,2590,0,37.22,10.85
高雄市,阿蓮區,和蓮里,918,266,652,10,928,2291,0,40.51,11.61
高雄市,阿蓮區,青旗里,566,208,358,1,567,1541,0,36.79,13.5
高雄市,阿蓮區,復安里,630,209,421,10,640,1648,0,38.83,12.68
高雄市,阿蓮區,玉庫里,457,102,355,9,466,1043,0,44.68,9.78
高雄市,阿蓮區,南蓮里,1132,439,693,8,1140,2960,0,38.51,14.83
高雄市,阿蓮區,合計,9367,2933,6434,92,9459,24309,28170,38.91,12.07
高雄市,路竹區,竹滬里,1152,410,742,8,1160,3254,0,35.65,12.6
高雄市,路竹區,頂寮里,469,173,296,6,475,1144,0,41.52,15.12
高雄市,路竹區,新達里,440,158,282,9,449,1195,0,37.57,13.22
高雄市,路竹區,後鄉里,433,145,288,4,437,1098,0,39.8,13.21
高雄市,路竹區,北嶺里,567,195,372,7,574,1220,0,47.05,15.98
高雄市,路竹區,社西里,898,340,558,11,909,2211,0,41.11,15.38
高雄市,路竹區,甲北里,818,277,541,9,827,2084,0,39.68,13.29
高雄市,路竹區,甲南里,1199,502,697,12,1211,3276,0,36.97,15.32
高雄市,路竹區,下坑里,966,295,671,10,976,2623,0,37.21,11.25
高雄市,路竹區,竹園里,652,190,462,10,662,1825,0,36.27,10.41
高雄市,路竹區,竹東里,1377,530,847,17,1394,3439,0,40.54,15.41
高雄市,路竹區,竹西里,869,332,537,7,876,2163,0,40.5,15.35
高雄市,路竹區,文北里,1148,412,736,9,1157,2976,0,38.88,13.84
高雄市,路竹區,文南里,1012,398,614,11,1023,2337,0,43.77,17.03
高雄市,路竹區,三爺里,357,114,243,3,360,841,0,42.81,13.56
高雄市,路竹區,鴨寮里,771,281,490,8,779,1908,0,40.83,14.73
高雄市,路竹區,社東里,683,210,473,6,689,1711,0,40.27,12.27
高雄市,路竹區,社中里,331,103,228,2,333,846,0,39.36,12.17
高雄市,路竹區,竹南里,1165,452,713,11,1176,2643,0,44.49,17.1
高雄市,路竹區,社南里,1813,715,1098,20,1833,4526,0,40.5,15.8
高雄市,路竹區,合計,17120,6232,10888,180,17300,43320,51490,39.94,14.39
高雄市,湖內區,海山里,477,162,315,3,480,1070,0,44.86,15.14
高雄市,湖內區,劉家里,393,121,272,2,395,981,0,40.27,12.33
高雄市,湖內區,太爺里,354,96,258,6,360,768,0,46.88,12.5
高雄市,湖內區,公舘里,854,303,551,8,862,2214,0,38.93,13.69
高雄市,湖內區,葉厝里,1024,270,754,10,1034,2648,0,39.05,10.2
高雄市,湖內區,大湖里,1439,538,901,12,1451,3677,0,39.46,14.63
高雄市,湖內區,田尾里,399,145,254,4,403,997,0,40.42,14.54
高雄市,湖內區,湖內里,1478,561,917,9,1487,3781,0,39.33,14.84
高雄市,湖內區,海埔里,716,191,525,8,724,1752,0,41.32,10.9
高雄市,湖內區,文賢里,482,144,338,3,485,1198,0,40.48,12.02
高雄市,湖內區,中賢里,766,203,563,6,772,2155,0,35.82,9.42
高雄市,湖內區,逸賢里,427,117,310,3,430,1133,0,37.95,10.33
高雄市,湖內區,忠興里,275,87,188,2,277,700,0,39.57,12.43
高雄市,湖內區,湖東里,937,377,560,10,947,2739,0,34.57,13.76
高雄市,湖內區,合計,10021,3315,6706,86,10107,25813,29772,39.15,12.84
高雄市,茄萣區,福德里,419,100,319,5,424,955,0,44.4,10.47
高雄市,茄萣區,萬福里,334,104,230,3,337,854,0,39.46,12.18
高雄市,茄萣區,白雲里,681,248,433,8,689,1718,0,40.1,14.44
高雄市,茄萣區,嘉賜里,1451,442,1009,10,1461,3784,0,38.61,11.68
高雄市,茄萣區,嘉安里,668,228,440,3,671,1771,0,37.89,12.87
高雄市,茄萣區,嘉定里,419,102,317,4,423,1100,0,38.45,9.27
高雄市,茄萣區,保定里,1118,326,792,3,1121,2955,0,37.94,11.03
高雄市,茄萣區,光定里,304,101,203,4,308,919,0,33.51,10.99
高雄市,茄萣區,大定里,341,119,222,3,344,1060,0,32.45,11.23
高雄市,茄萣區,吉定里,434,110,324,4,438,1114,0,39.32,9.87
高雄市,茄萣區,嘉樂里,764,257,507,5,769,2061,0,37.31,12.47
高雄市,茄萣區,嘉泰里,381,100,281,3,384,1067,0,35.99,9.37
高雄市,茄萣區,嘉福里,313,106,207,3,316,966,0,32.71,10.97
高雄市,茄萣區,和協里,458,136,322,3,461,1116,0,41.31,12.19
高雄市,茄萣區,崎漏里,1658,622,1036,26,1684,4679,0,35.99,13.29
高雄市,茄萣區,合計,9743,3101,6642,87,9830,26119,29883,37.64,11.87
高雄市,永安區,永安里,637,252,385,5,642,1558,0,41.21,16.17
高雄市,永安區,永華里,737,271,466,4,741,1799,0,41.19,15.06
高雄市,永安區,新港里,883,285,598,9,892,2291,0,38.93,12.44
高雄市,永安區,鹽田里,139,37,102,3,142,374,0,37.97,9.89
高雄市,永安區,保寧里,949,377,572,4,953,2564,0,37.17,14.7
高雄市,永安區,維新里,1254,415,839,12,1266,3396,0,37.28,12.22
高雄市,永安區,合計,4599,1637,2962,37,4636,11982,13609,38.69,13.66
高雄市,彌陀區,光和里,500,165,335,5,505,1250,0,40.4,13.2
高雄市,彌陀區,彌靖里,779,293,486,8,787,1846,0,42.63,15.87
高雄市,彌陀區,彌仁里,210,97,113,5,215,533,0,40.34,18.2
高雄市,彌陀區,彌壽里,341,152,189,4,345,738,0,46.75,20.6
高雄市,彌陀區,彌陀里,737,310,427,6,743,1710,0,43.45,18.13
高雄市,彌陀區,舊港里,621,250,371,8,629,1565,0,40.19,15.97
高雄市,彌陀區,文安里,668,226,442,13,681,1681,0,40.51,13.44
高雄市,彌陀區,鹽埕里,803,297,506,7,810,2007,0,40.36,14.8
高雄市,彌陀區,過港里,356,136,220,8,364,918,0,39.65,14.81
高雄市,彌陀區,海尾里,295,120,175,2,297,804,0,36.94,14.93
高雄市,彌陀區,漯底里,452,203,249,6,458,1134,0,40.39,17.9
高雄市,彌陀區,南寮里,798,296,502,12,810,2085,0,38.85,14.2
高雄市,彌陀區,合計,6560,2545,4015,84,6644,16271,18759,40.83,15.64
高雄市,梓官區,梓信里,912,252,660,4,916,2095,0,43.72,12.03
高雄市,梓官區,梓義里,828,255,573,2,830,2030,0,40.89,12.56
高雄市,梓官區,梓和里,1092,322,770,7,1099,2213,0,49.66,14.55
高雄市,梓官區,梓平里,658,183,475,12,670,1476,0,45.39,12.4
高雄市,梓官區,中崙里,560,180,380,3,563,1154,0,48.79,15.6
高雄市,梓官區,赤崁里,762,218,544,12,774,1791,0,43.22,12.17
高雄市,梓官區,禮蚵里,797,196,601,9,806,2055,0,39.22,9.54
高雄市,梓官區,智蚵里,1122,363,759,8,1130,2858,0,39.54,12.7
高雄市,梓官區,信蚵里,873,309,564,9,882,2313,0,38.13,13.36
高雄市,梓官區,同安里,387,117,270,2,389,970,0,40.1,12.06
高雄市,梓官區,大舍里,1527,460,1067,15,1542,3701,0,41.66,12.43
高雄市,梓官區,赤東里,911,238,673,6,917,2221,0,41.29,10.72
高雄市,梓官區,赤西里,341,122,219,5,346,801,0,43.2,15.23
高雄市,梓官區,茄苳里,910,309,601,5,915,2258,0,40.52,13.68
高雄市,梓官區,典寶里,1296,472,824,15,1311,2972,0,44.11,15.88
高雄市,梓官區,合計,12976,3996,8980,114,13090,30908,35292,42.35,12.93
高雄市,旗山區,太平里,832,340,492,9,841,2165,0,38.85,15.7
高雄市,旗山區,大德里,917,409,508,14,931,2273,0,40.96,17.99
高雄市,旗山區,湄洲里,581,219,362,4,585,1578,0,37.07,13.88
高雄市,旗山區,圓富里,586,217,369,9,595,1802,0,33.02,12.04
高雄市,旗山區,中正里,455,216,239,5,460,1418,0,32.44,15.23
高雄市,旗山區,大林里,415,176,239,6,421,1338,0,31.46,13.15
高雄市,旗山區,上洲里,385,88,297,2,387,1008,0,38.39,8.73
高雄市,旗山區,新光里,319,119,200,7,326,759,0,42.95,15.68
高雄市,旗山區,南勝里,839,234,605,15,854,2092,0,40.82,11.19
高雄市,旗山區,中寮里,67,22,45,1,68,179,0,37.99,12.29
高雄市,旗山區,東平里,806,306,500,11,817,1924,0,42.46,15.9
高雄市,旗山區,東昌里,390,172,218,2,392,983,0,39.88,17.5
高雄市,旗山區,竹峰里,567,247,320,10,577,1544,0,37.37,16.0
高雄市,旗山區,瑞吉里,755,283,472,6,761,1999,0,38.07,14.16
高雄市,旗山區,永和里,1108,397,711,12,1120,3245,0,34.51,12.23
高雄市,旗山區,三協里,833,311,522,6,839,2216,0,37.86,14.03
高雄市,旗山區,鯤洲里,326,61,265,2,328,705,0,46.52,8.65
高雄市,旗山區,大山里,482,140,342,5,487,1254,0,38.84,11.16
高雄市,旗山區,中洲里,324,81,243,6,330,797,0,41.41,10.16
高雄市,旗山區,南洲里,523,166,357,7,530,1262,0,42.0,13.15
高雄市,旗山區,廣福里,221,116,105,5,226,611,0,36.99,18.99
高雄市,旗山區,合計,11731,4320,7411,144,11875,31152,35449,38.12,13.87
高雄市,美濃區,福安里,984,451,533,10,994,2547,0,39.03,17.71
高雄市,美濃區,合和里,832,445,387,10,842,2321,0,36.28,19.17
高雄市,美濃區,祿興里,972,499,473,10,982,2552,0,38.48,19.55
高雄市,美濃區,中壇里,699,373,326,7,706,1978,0,35.69,18.86
高雄市,美濃區,德興里,537,311,226,9,546,1462,0,37.35,21.27
高雄市,美濃區,龍山里,685,334,351,14,699,2113,0,33.08,15.81
高雄市,美濃區,獅山里,954,402,552,15,969,2433,0,39.83,16.52
高雄市,美濃區,龍肚里,534,244,290,3,537,1382,0,38.86,17.66
高雄市,美濃區,廣德里,469,203,266,4,473,1299,0,36.41,15.63
高雄市,美濃區,興隆里,428,180,248,4,432,1158,0,37.31,15.54
高雄市,美濃區,中圳里,756,385,371,8,764,2066,0,36.98,18.64
高雄市,美濃區,東門里,424,181,243,7,431,1184,0,36.4,15.29
高雄市,美濃區,泰安里,610,310,300,5,615,1527,0,40.28,20.3
高雄市,美濃區,瀰濃里,792,358,434,4,796,2186,0,36.41,16.38
高雄市,美濃區,清水里,661,324,337,4,665,1720,0,38.66,18.84
高雄市,美濃區,吉洋里,682,302,380,9,691,1826,0,37.84,16.54
高雄市,美濃區,吉和里,493,258,235,9,502,1334,0,37.63,19.34
高雄市,美濃區,吉東里,590,212,378,8,598,1779,0,33.61,11.92
高雄市,美濃區,廣林里,512,234,278,10,522,1436,0,36.35,16.3
高雄市,美濃區,合計,12614,6006,6608,150,12764,34303,38209,37.21,17.51
高雄市,六龜區,新威里,227,75,152,5,232,714,0,32.49,10.5
高雄市,六龜區,新興里,193,63,130,2,195,649,0,30.05,9.71
高雄市,六龜區,新寮里,238,85,153,4,242,626,0,38.66,13.58
高雄市,六龜區,新發里,224,82,142,2,226,926,0,24.41,8.86
高雄市,六龜區,荖濃里,332,120,212,2,334,1359,0,24.58,8.83
高雄市,六龜區,六龜里,235,81,154,7,242,942,0,25.69,8.6
高雄市,六龜區,義寶里,353,155,198,2,355,1029,0,34.5,15.06
高雄市,六龜區,興龍里,221,63,158,6,227,785,0,28.92,8.03
高雄市,六龜區,中興里,460,244,216,10,470,1363,0,34.48,17.9
高雄市,六龜區,寶來里,240,89,151,7,247,858,0,28.79,10.37
高雄市,六龜區,文武里,374,146,228,2,376,1379,0,27.27,10.59
高雄市,六龜區,大津里,122,41,81,4,126,303,0,41.58,13.53
高雄市,六龜區,合計,3219,1244,1975,53,3272,10933,12236,29.93,11.38
高雄市,甲仙區,東安里,109,55,54,3,112,445,0,25.17,12.36
高雄市,甲仙區,西安里,354,228,126,2,356,835,0,42.63,27.31
高雄市,甲仙區,和安里,232,134,98,2,234,668,0,35.03,20.06
高雄市,甲仙區,大田里,437,206,231,11,448,1557,0,28.77,13.23
高雄市,甲仙區,寶隆里,221,73,148,3,224,651,0,34.41,11.21
高雄市,甲仙區,關山里,200,80,120,4,204,587,0,34.75,13.63
高雄市,甲仙區,小林里,130,59,71,2,132,514,0,25.68,11.48
高雄市,甲仙區,合計,1683,835,848,27,1710,5257,5798,32.53,15.88
高雄市,杉林區,杉林里,166,53,113,3,169,597,0,28.31,8.88
高雄市,杉林區,木梓里,156,49,107,2,158,655,0,24.12,7.48
高雄市,杉林區,集來里,326,103,223,3,329,1230,0,26.75,8.37
高雄市,杉林區,新庄里,477,227,250,12,489,1464,0,33.4,15.51
高雄市,杉林區,上平里,468,220,248,4,472,1537,0,30.71,14.31
高雄市,杉林區,月眉里,549,275,274,9,558,1603,0,34.81,17.16
高雄市,杉林區,月美里,381,148,233,11,392,1207,0,32.48,12.26
高雄市,杉林區,大愛里,519,205,314,4,523,1965,0,26.62,10.43
高雄市,杉林區,合計,3042,1280,1762,48,3090,10258,11365,30.12,12.48
高雄市,內門區,溝坪里,242,91,151,7,249,931,0,26.75,9.77
高雄市,內門區,金竹里,203,63,140,6,209,627,0,33.33,10.05
高雄市,內門區,永富里,285,115,170,7,292,955,0,30.58,12.04
高雄市,內門區,永吉里,118,56,62,2,120,413,0,29.06,13.56
高雄市,內門區,永興里,119,45,74,2,121,384,0,31.51,11.72
高雄市,內門區,石坑里,118,43,75,0,118,493,0,23.94,8.72
高雄市,內門區,內門里,363,151,212,5,368,963,0,38.21,15.68
高雄市,內門區,內豊里,366,137,229,3,369,1176,0,31.38,11.65
高雄市,內門區,觀亭里,560,243,317,7,567,1682,0,33.71,14.45
高雄市,內門區,中埔里,175,97,78,2,177,537,0,32.96,18.06
高雄市,內門區,內東里,279,98,181,6,285,765,0,37.25,12.81
高雄市,內門區,內南里,100,46,54,3,103,403,0,25.56,11.41
高雄市,內門區,東埔里,151,51,100,1,152,474,0,32.07,10.76
高雄市,內門區,三平里,196,64,132,5,201,638,0,31.5,10.03
高雄市,內門區,木柵里,185,48,137,3,188,589,0,31.92,8.15
高雄市,內門區,內興里,164,23,141,4,168,602,0,27.91,3.82
高雄市,內門區,瑞山里,117,58,59,5,122,318,0,38.36,18.24
高雄市,內門區,光興里,193,80,113,1,194,645,0,30.08,12.4
高雄市,內門區,合計,3934,1509,2425,69,4003,12595,13870,31.78,11.98
高雄市,茂林區,茂林里,226,173,53,1,227,712,0,31.88,24.3
高雄市,茂林區,萬山里,132,93,39,4,136,356,0,38.2,26.12
高雄市,茂林區,多納里,145,113,32,5,150,491,0,30.55,23.01
高雄市,茂林區,合計,503,379,124,10,513,1559,1879,32.91,24.31
高雄市,桃源區,桃源里,143,116,27,3,146,766,0,19.06,15.14
高雄市,桃源區,寶山里,102,79,23,3,105,458,0,22.93,17.25
高雄市,桃源區,建山里,99,71,28,1,100,587,0,17.04,12.1
高雄市,桃源區,高中里,133,102,31,0,133,620,0,21.45,16.45
高雄市,桃源區,勤和里,45,26,19,1,46,212,0,21.7,12.26
高雄市,桃源區,復興里,61,54,7,1,62,287,0,21.6,18.82
高雄市,桃源區,拉芙蘭里,69,35,34,3,72,230,0,31.3,15.22
高雄市,桃源區,梅山里,71,49,22,1,72,255,0,28.24,19.22
高雄市,桃源區,合計,723,532,191,13,736,3415,4205,21.55,15.58
高雄市,那瑪夏區,達卡努瓦里,334,265,69,5,339,1343,0,25.24,19.73
高雄市,那瑪夏區,瑪雅里,202,172,30,0,202,602,0,33.55,28.57
高雄市,那瑪夏區,南沙魯里,152,66,86,1,153,482,0,31.74,13.69
高雄市,那瑪夏區,合計,688,503,185,6,694,2427,3141,28.59,20.73
高雄市,合計,合計,986618,388792,597826,7917,994535,2353773,2755491,42.25,16.52
新竹縣,竹北市,斗崙里,2994,1658,1336,19,3013,6791,0,44.37,24.41
新竹縣,竹北市,鹿場里,4845,2667,2178,39,4884,10611,0,46.03,25.13
新竹縣,竹北市,東平里,5431,2676,2755,47,5478,11738,0,46.67,22.8
新竹縣,竹北市,中興里,3799,2001,1798,28,3827,8015,0,47.75,24.97
新竹縣,竹北市,隘口里,1311,725,586,10,1321,2974,0,44.42,24.38
新竹縣,竹北市,東海里,1100,735,365,12,1112,2997,0,37.1,24.52
新竹縣,竹北市,竹北里,2899,1725,1174,16,2915,7661,0,38.05,22.52
新竹縣,竹北市,竹仁里,3522,2185,1337,34,3556,8745,0,40.66,24.99
新竹縣,竹北市,竹義里,2078,1226,852,16,2094,5860,0,35.73,20.92
新竹縣,竹北市,泰和里,2236,1367,869,17,2253,5932,0,37.98,23.04
新竹縣,竹北市,新社里,2689,1595,1094,25,2714,7074,0,38.37,22.55
新竹縣,竹北市,聯興里,1766,1034,732,27,1793,4441,0,40.37,23.28
新竹縣,竹北市,麻園里,753,389,364,4,757,1986,0,38.12,19.59
新竹縣,竹北市,溪州里,1031,519,512,15,1046,2468,0,42.38,21.03
新竹縣,竹北市,白地里,800,408,392,13,813,2202,0,36.92,18.53
新竹縣,竹北市,新港里,496,181,315,7,503,1218,0,41.3,14.86
新竹縣,竹北市,大義里,638,245,393,6,644,1607,0,40.07,15.25
新竹縣,竹北市,崇義里,751,280,471,5,756,1914,0,39.5,14.63
新竹縣,竹北市,大眉里,692,375,317,8,700,1741,0,40.21,21.54
新竹縣,竹北市,尚義里,620,226,394,9,629,1683,0,37.37,13.43
新竹縣,竹北市,十興里,3046,1597,1449,26,3072,6632,0,46.32,24.08
新竹縣,竹北市,新國里,2318,1257,1061,15,2333,6000,0,38.88,20.95
新竹縣,竹北市,新庄里,394,230,164,10,404,1064,0,37.97,21.62
新竹縣,竹北市,北崙里,1650,1017,633,15,1665,3833,0,43.44,26.53
新竹縣,竹北市,新崙里,2519,1397,1122,28,2547,6255,0,40.72,22.33
新竹縣,竹北市,福德里,1348,817,531,10,1358,3262,0,41.63,25.05
新竹縣,竹北市,東興里,2845,1413,1432,28,2873,7126,0,40.32,19.83
新竹縣,竹北市,北興里,2184,1094,1090,16,2200,5571,0,39.49,19.64
新竹縣,竹北市,興安里,1473,896,577,13,1486,3538,0,42.0,25.33
新竹縣,竹北市,文化里,1498,775,723,16,1514,3337,0,45.37,23.22
新竹縣,竹北市,中崙里,2827,1638,1189,11,2838,6155,0,46.11,26.61
新竹縣,竹北市,合計,62553,34348,28205,545,63098,150431,203904,41.94,22.83
新竹縣,竹東鎮,上坪里,100,72,28,0,100,303,0,33.0,23.76
新竹縣,竹東鎮,瑞峰里,136,84,52,1,137,402,0,34.08,20.9
新竹縣,竹東鎮,軟橋里,131,87,44,3,134,369,0,36.31,23.58
新竹縣,竹東鎮,員崠里,831,592,239,8,839,2251,0,37.27,26.3
新竹縣,竹東鎮,東寧里,1257,886,371,7,1264,3227,0,39.17,27.46
新竹縣,竹東鎮,上舘里,3271,2338,933,31,3302,9255,0,35.68,25.26
新竹縣,竹東鎮,大鄉里,1596,1120,476,23,1619,4597,0,35.22,24.36
新竹縣,竹東鎮,東華里,309,206,103,2,311,643,0,48.37,32.04
新竹縣,竹東鎮,商華里,984,716,268,10,994,3051,0,32.58,23.47
新竹縣,竹東鎮,竹東里,579,338,241,9,588,1321,0,44.51,25.59
新竹縣,竹東鎮,榮樂里,596,411,185,2,598,1352,0,44.23,30.4
新竹縣,竹東鎮,鷄林里,1362,925,437,12,1374,3726,0,36.88,24.83
新竹縣,竹東鎮,仁愛里,1272,845,427,10,1282,3284,0,39.04,25.73
新竹縣,竹東鎮,五豐里,2415,1604,811,18,2433,7516,0,32.37,21.34
新竹縣,竹東鎮,三重里,2372,1539,833,22,2394,6371,0,37.58,24.16
新竹縣,竹東鎮,頭重里,1890,1218,672,21,1911,4492,0,42.54,27.11
新竹縣,竹東鎮,員山里,771,465,306,11,782,1905,0,41.05,24.41
新竹縣,竹東鎮,柯湖里,232,141,91,3,235,585,0,40.17,24.1
新竹縣,竹東鎮,二重里,4413,2736,1677,32,4445,11579,0,38.39,23.63
新竹縣,竹東鎮,中山里,638,460,178,13,651,1672,0,38.94,27.51
新竹縣,竹東鎮,中正里,833,548,285,14,847,2198,0,38.54,24.93
新竹縣,竹東鎮,南華里,435,294,141,1,436,1002,0,43.51,29.34
新竹縣,竹東鎮,榮華里,2717,1918,799,28,2745,6974,0,39.36,27.5
新竹縣,竹東鎮,忠孝里,559,373,186,7,566,1533,0,36.92,24.33
新竹縣,竹東鎮,陸豐里,246,159,87,2,248,579,0,42.83,27.46
新竹縣,竹東鎮,合計,29945,20075,9870,290,30235,80187,96850,37.71,25.04
新竹縣,新埔鎮,內立里,408,224,184,9,417,1106,0,37.7,20.25
新竹縣,新埔鎮,寶石里,368,229,139,5,373,857,0,43.52,26.72
新竹縣,新埔鎮,文山里,1812,1130,682,17,1829,4469,0,40.93,25.29
新竹縣,新埔鎮,五埔里,726,462,264,5,731,1976,0,36.99,23.38
新竹縣,新埔鎮,四座里,1380,765,615,13,1393,3266,0,42.65,23.42
新竹縣,新埔鎮,旱坑里,686,414,272,3,689,1753,0,39.3,23.62
新竹縣,新埔鎮,田新里,1260,802,458,7,1267,3147,0,40.26,25.48
新竹縣,新埔鎮,新埔里,400,256,144,7,407,964,0,42.22,26.56
新竹縣,新埔鎮,新生里,251,134,117,2,253,558,0,45.34,24.01
新竹縣,新埔鎮,新民里,454,313,141,3,457,1011,0,45.2,30.96
新竹縣,新埔鎮,上寮里,703,420,283,12,715,1823,0,39.22,23.04
新竹縣,新埔鎮,下寮里,1048,615,433,15,1063,2507,0,42.4,24.53
新竹縣,新埔鎮,南平里,431,246,185,5,436,977,0,44.63,25.18
新竹縣,新埔鎮,北平里,256,139,117,4,260,642,0,40.5,21.65
新竹縣,新埔鎮,巨埔里,491,240,251,6,497,1082,0,45.93,22.18
新竹縣,新埔鎮,照門里,480,282,198,6,486,1332,0,36.49,21.17
新竹縣,新埔鎮,清水里,189,96,93,1,190,403,0,47.15,23.82
新竹縣,新埔鎮,鹿鳴里,278,129,149,2,280,701,0,39.94,18.4
新竹縣,新埔鎮,新北里,241,139,102,3,244,570,0,42.81,24.39
新竹縣,新埔鎮,合計,11862,7035,4827,125,11987,29144,32991,41.13,24.14
新竹縣,關西鎮,東興里,220,162,58,4,224,472,0,47.46,34.32
新竹縣,關西鎮,西安里,761,541,220,10,771,1896,0,40.66,28.53
新竹縣,關西鎮,南雄里,289,195,94,5,294,677,0,43.43,28.8
新竹縣,關西鎮,北斗里,1440,922,518,24,1464,3579,0,40.91,25.76
新竹縣,關西鎮,仁安里,400,242,158,7,407,960,0,42.4,25.21
新竹縣,關西鎮,北山里,319,182,137,5,324,756,0,42.86,24.07
新竹縣,關西鎮,南山里,350,203,147,9,359,1025,0,35.02,19.8
新竹縣,關西鎮,東安里,1308,833,475,13,1321,3726,0,35.45,22.36
新竹縣,關西鎮,東光里,449,278,171,4,453,1248,0,36.3,22.28
新竹縣,關西鎮,新富里,171,96,75,2,173,529,0,32.7,18.15
新竹縣,關西鎮,金山里,208,135,73,1,209,549,0,38.07,24.59
新竹縣,關西鎮,錦山里,284,202,82,4,288,904,0,31.86,22.35
新竹縣,關西鎮,玉山里,130,69,61,2,132,431,0,30.63,16.01
新竹縣,關西鎮,大同里,346,167,179,4,350,787,0,44.47,21.22
新竹縣,關西鎮,石光里,655,394,261,7,662,1735,0,38.16,22.71
新竹縣,關西鎮,上林里,326,205,121,5,331,798,0,41.48,25.69
新竹縣,關西鎮,新力里,214,150,64,3,217,537,0,40.41,27.93
新竹縣,關西鎮,南和里,310,179,131,10,320,799,0,40.05,22.4
新竹縣,關西鎮,東山里,326,183,143,4,330,824,0,40.05,22.21
新竹縣,關西鎮,南新里,311,202,109,8,319,889,0,35.88,22.72
新竹縣,關西鎮,東平里,405,252,153,8,413,926,0,44.6,27.21
新竹縣,關西鎮,合計,9222,5792,3430,139,9361,24047,27521,38.93,24.09
新竹縣,湖口鄉,孝勢村,517,346,171,6,523,1181,0,44.28,29.3
新竹縣,湖口鄉,仁勢村,378,230,148,4,382,855,0,44.68,26.9
新竹縣,湖口鄉,愛勢村,1557,998,559,24,1581,3959,0,39.93,25.21
新竹縣,湖口鄉,信勢村,1940,1231,709,22,1962,5246,0,37.4,23.47
新竹縣,湖口鄉,中勢村,1247,805,442,11,1258,3221,0,39.06,24.99
新竹縣,湖口鄉,德盛村,1674,1055,619,12,1686,4921,0,34.26,21.44
新竹縣,湖口鄉,和興村,1021,584,437,7,1028,2816,0,36.51,20.74
新竹縣,湖口鄉,長嶺村,1116,720,396,11,1127,3163,0,35.63,22.76
新竹縣,湖口鄉,長安村,371,219,152,1,372,1045,0,35.6,20.96
新竹縣,湖口鄉,湖口村,1063,658,405,11,1074,2753,0,39.01,23.9
新竹縣,湖口鄉,湖鏡村,1002,734,268,15,1017,2452,0,41.48,29.93
新竹縣,湖口鄉,湖南村,606,418,188,6,612,1495,0,40.94,27.96
新竹縣,湖口鄉,波羅村,746,459,287,6,752,2217,0,33.92,20.7
新竹縣,湖口鄉,鳳凰村,1617,1064,553,23,1640,5086,0,32.25,20.92
新竹縣,湖口鄉,鳳山村,1171,848,323,11,1182,3248,0,36.39,26.11
新竹縣,湖口鄉,中興村,1886,1339,547,18,1904,6149,0,30.96,21.78
新竹縣,湖口鄉,信義村,1416,880,536,12,1428,3854,0,37.05,22.83
新竹縣,湖口鄉,中正村,1348,843,505,10,1358,3485,0,38.97,24.19
新竹縣,湖口鄉,東興村,1464,909,555,13,1477,4375,0,33.76,20.78
新竹縣,湖口鄉,勝利村,1366,950,416,12,1378,4199,0,32.82,22.62
新竹縣,湖口鄉,合計,23506,15290,8216,235,23741,65720,79420,36.12,23.27
新竹縣,新豐鄉,福興村,400,237,163,9,409,1086,0,37.66,21.82
新竹縣,新豐鄉,後湖村,626,351,275,10,636,1798,0,35.37,19.52
新竹縣,新豐鄉,青埔村,646,387,259,12,658,1867,0,35.24,20.73
新竹縣,新豐鄉,埔和村,1014,434,580,10,1024,2772,0,36.94,15.66
新竹縣,新豐鄉,瑞興村,575,349,226,4,579,1847,0,31.35,18.9
新竹縣,新豐鄉,坡頭村,310,123,187,3,313,833,0,37.58,14.77
新竹縣,新豐鄉,中崙村,1093,687,406,12,1105,3202,0,34.51,21.46
新竹縣,新豐鄉,重興村,1757,1088,669,21,1778,5247,0,33.89,20.74
新竹縣,新豐鄉,新豐村,728,340,388,5,733,2073,0,35.36,16.4
新竹縣,新豐鄉,員山村,983,651,332,9,992,2634,0,37.66,24.72
新竹縣,新豐鄉,松林村,1703,1092,611,20,1723,4372,0,39.41,24.98
新竹縣,新豐鄉,上坑村,571,364,207,12,583,1508,0,38.66,24.14
新竹縣,新豐鄉,鳳坑村,399,246,153,4,403,1044,0,38.6,23.56
新竹縣,新豐鄉,忠孝村,1345,866,479,11,1356,3558,0,38.11,24.34
新竹縣,新豐鄉,山崎村,1709,1095,614,14,1723,4427,0,38.92,24.73
新竹縣,新豐鄉,松柏村,2027,1275,752,11,2038,5803,0,35.12,21.97
新竹縣,新豐鄉,崎頂村,994,620,374,15,1009,2708,0,37.26,22.9
新竹縣,新豐鄉,合計,16880,10205,6675,182,17062,46779,57654,36.47,21.82
新竹縣,芎林鄉,五龍村,200,139,61,0,200,491,0,40.73,28.31
新竹縣,芎林鄉,華龍村,167,118,49,2,169,384,0,44.01,30.73
新竹縣,芎林鄉,秀湖村,362,267,95,6,368,934,0,39.4,28.59
新竹縣,芎林鄉,永興村,156,118,38,3,159,409,0,38.88,28.85
新竹縣,芎林鄉,石潭村,1020,687,333,6,1026,2655,0,38.64,25.88
新竹縣,芎林鄉,新鳳村,588,378,210,9,597,1577,0,37.86,23.97
新竹縣,芎林鄉,中坑村,239,176,63,4,243,626,0,38.82,28.12
新竹縣,芎林鄉,水坑村,309,192,117,5,314,779,0,40.31,24.65
新竹縣,芎林鄉,文林村,924,655,269,12,936,2349,0,39.85,27.88
新竹縣,芎林鄉,芎林村,658,406,252,7,665,1559,0,42.66,26.04
新竹縣,芎林鄉,上山村,1990,1213,777,16,2006,4643,0,43.2,26.13
新竹縣,芎林鄉,下山村,483,300,183,4,487,1098,0,44.35,27.32
新竹縣,芎林鄉,合計,7096,4649,2447,74,7170,17504,19888,40.96,26.56
新竹縣,橫山鄉,橫山村,1216,833,383,22,1238,3300,0,37.52,25.24
新竹縣,橫山鄉,田寮村,344,213,131,3,347,847,0,40.97,25.15
新竹縣,橫山鄉,南昌村,80,57,23,0,80,180,0,44.44,31.67
新竹縣,橫山鄉,豐鄉村,75,41,34,2,77,203,0,37.93,20.2
新竹縣,橫山鄉,豐田村,121,79,42,1,122,320,0,38.13,24.69
新竹縣,橫山鄉,內灣村,338,229,109,12,350,882,0,39.68,25.96
新竹縣,橫山鄉,福興村,161,103,58,5,166,419,0,39.62,24.58
新竹縣,橫山鄉,沙坑村,407,266,141,11,418,938,0,44.56,28.36
新竹縣,橫山鄉,新興村,626,466,160,8,634,1488,0,42.61,31.32
新竹縣,橫山鄉,大肚村,605,452,153,7,612,1628,0,37.59,27.76
新竹縣,橫山鄉,力行村,339,248,91,3,342,802,0,42.64,30.92
新竹縣,橫山鄉,合計,4312,2987,1325,74,4386,11007,12408,39.85,27.14
新竹縣,北埔鄉,北埔村,413,274,139,2,415,1117,0,37.15,24.53
新竹縣,北埔鄉,南興村,415,291,124,7,422,1142,0,36.95,25.48
新竹縣,北埔鄉,埔尾村,933,624,309,10,943,2547,0,37.02,24.5
新竹縣,北埔鄉,水磜村,281,167,114,1,282,818,0,34.47,20.42
新竹縣,北埔鄉,南埔村,178,129,49,3,181,363,0,49.86,35.54
新竹縣,北埔鄉,大林村,271,196,75,1,272,720,0,37.78,27.22
新竹縣,北埔鄉,大湖村,185,128,57,2,187,541,0,34.57,23.66
新竹縣,北埔鄉,南坑村,142,97,45,2,144,325,0,44.31,29.85
新竹縣,北埔鄉,外坪村,121,73,48,1,122,297,0,41.08,24.58
新竹縣,北埔鄉,合計,2939,1979,960,29,2968,7870,8864,37.71,25.15
新竹縣,寶山鄉,雙溪村,1016,605,411,6,1022,2659,0,38.44,22.75
新竹縣,寶山鄉,大崎村,877,559,318,2,879,2006,0,43.82,27.87
新竹縣,寶山鄉,三峰村,394,240,154,9,403,1015,0,39.7,23.65
新竹縣,寶山鄉,新城村,425,255,170,5,430,1168,0,36.82,21.83
新竹縣,寶山鄉,深井村,327,210,117,0,327,794,0,41.18,26.45
新竹縣,寶山鄉,寶斗村,229,155,74,4,233,731,0,31.87,21.2
新竹縣,寶山鄉,山湖村,249,159,90,0,249,541,0,46.03,29.39
新竹縣,寶山鄉,寶山村,342,229,113,5,347,847,0,40.97,27.04
新竹縣,寶山鄉,油田村,250,164,86,2,252,578,0,43.6,28.37
新竹縣,寶山鄉,雙新村,1030,661,369,11,1041,2676,0,38.9,24.7
新竹縣,寶山鄉,合計,5139,3237,1902,44,5183,13015,14570,39.82,24.87
新竹縣,峨眉鄉,峨眉村,366,265,101,9,375,815,0,46.01,32.52
新竹縣,峨眉鄉,中盛村,269,154,115,4,273,665,0,41.05,23.16
新竹縣,峨眉鄉,石井村,242,160,82,0,242,563,0,42.98,28.42
新竹縣,峨眉鄉,富興村,494,323,171,2,496,1340,0,37.01,24.1
新竹縣,峨眉鄉,七星村,248,154,94,1,249,605,0,41.16,25.45
新竹縣,峨眉鄉,湖光村,327,185,142,6,333,850,0,39.18,21.76
新竹縣,峨眉鄉,合計,1946,1241,705,22,1968,4838,5323,40.68,25.65
新竹縣,尖石鄉,義興村,168,123,45,1,169,587,0,28.79,20.95
新竹縣,尖石鄉,嘉樂村,267,205,62,4,271,818,0,33.13,25.06
新竹縣,尖石鄉,新樂村,310,262,48,8,318,1210,0,26.28,21.65
新竹縣,尖石鄉,梅花村,201,165,36,3,204,626,0,32.59,26.36
新竹縣,尖石鄉,錦屏村,257,204,53,1,258,1161,0,22.22,17.57
新竹縣,尖石鄉,玉峰村,242,159,83,2,244,1329,0,18.36,11.96
新竹縣,尖石鄉,秀巒村,260,193,67,5,265,1629,0,16.27,11.85
新竹縣,尖石鄉,合計,1705,1311,394,24,1729,7360,9561,23.49,17.81
新竹縣,五峰鄉,大隘村,344,302,42,6,350,1281,0,27.32,23.58
新竹縣,五峰鄉,花園村,204,148,56,2,206,711,0,28.97,20.82
新竹縣,五峰鄉,竹林村,100,77,23,0,100,377,0,26.53,20.42
新竹縣,五峰鄉,桃山村,357,249,108,6,363,1367,0,26.55,18.22
新竹縣,五峰鄉,合計,1005,776,229,14,1019,3736,4431,27.28,20.77
新竹縣,合計,合計,178110,108925,69185,1797,179907,461638,573385,38.97,23.6
苗栗縣,苗栗市,中苗里,478,332,146,1,479,1116,0,42.92,29.75
苗栗縣,苗栗市,建功里,1695,1210,485,11,1706,4048,0,42.14,29.89
苗栗縣,苗栗市,青苗里,359,237,122,6,365,1005,0,36.32,23.58
苗栗縣,苗栗市,玉清里,1033,765,268,6,1039,2166,0,47.97,35.32
苗栗縣,苗栗市,玉華里,1528,1110,418,18,1546,3579,0,43.2,31.01
苗栗縣,苗栗市,維新里,1498,1064,434,13,1511,3590,0,42.09,29.64
苗栗縣,苗栗市,維祥里,1224,870,354,12,1236,3260,0,37.91,26.69
苗栗縣,苗栗市,綠苗里,320,222,98,3,323,805,0,40.12,27.58
苗栗縣,苗栗市,高苗里,1207,847,360,5,1212,3216,0,37.69,26.34
苗栗縣,苗栗市,玉苗里,364,222,142,4,368,856,0,42.99,25.93
苗栗縣,苗栗市,大同里,231,152,79,3,234,497,0,47.08,30.58
苗栗縣,苗栗市,新苗里,353,214,139,4,357,841,0,42.45,25.45
苗栗縣,苗栗市,勝利里,1642,1127,515,15,1657,3843,0,43.12,29.33
苗栗縣,苗栗市,恭敬里,501,325,176,7,508,1333,0,38.11,24.38
苗栗縣,苗栗市,上苗里,668,431,237,11,679,1503,0,45.18,28.68
苗栗縣,苗栗市,北苗里,2075,1421,654,16,2091,5025,0,41.61,28.28
苗栗縣,苗栗市,清華里,1388,941,447,10,1398,3087,0,45.29,30.48
苗栗縣,苗栗市,嘉盛里,1379,948,431,14,1393,3365,0,41.4,28.17
苗栗縣,苗栗市,福星里,1570,1052,518,17,1587,4152,0,38.22,25.34
苗栗縣,苗栗市,新川里,442,300,142,5,447,1166,0,38.34,25.73
苗栗縣,苗栗市,文山里,1601,1107,494,12,1613,4041,0,39.92,27.39
苗栗縣,苗栗市,福麗里,2051,1466,585,14,2065,5344,0,38.64,27.43
苗栗縣,苗栗市,水源里,938,642,296,10,948,2448,0,38.73,26.23
苗栗縣,苗栗市,新英里,566,376,190,10,576,1664,0,34.62,22.6
苗栗縣,苗栗市,福安里,1258,863,395,10,1268,3443,0,36.83,25.07
苗栗縣,苗栗市,嘉新里,1241,882,359,13,1254,2769,0,45.29,31.85
苗栗縣,苗栗市,南勢里,645,450,195,5,650,1926,0,33.75,23.36
苗栗縣,苗栗市,文聖里,1263,860,403,12,1275,3556,0,35.85,24.18
苗栗縣,苗栗市,合計,29518,20436,9082,267,29785,73644,87384,40.44,27.75
苗栗縣,苑裡鎮,苑東里,820,387,433,7,827,2145,0,38.55,18.04
苗栗縣,苑裡鎮,苑南里,604,255,349,2,606,1435,0,42.23,17.77
苗栗縣,苑裡鎮,苑北里,360,144,216,7,367,878,0,41.8,16.4
苗栗縣,苑裡鎮,西平里,575,227,348,3,578,1612,0,35.86,14.08
苗栗縣,苑裡鎮,苑港里,420,125,295,3,423,1191,0,35.52,10.5
苗栗縣,苑裡鎮,西勢里,709,291,418,6,715,1961,0,36.46,14.84
苗栗縣,苑裡鎮,海岸里,342,143,199,4,346,1037,0,33.37,13.79
苗栗縣,苑裡鎮,房裡里,774,341,433,3,777,2186,0,35.54,15.6
苗栗縣,苑裡鎮,客庄里,1518,680,838,11,1529,3952,0,38.69,17.21
苗栗縣,苑裡鎮,中正里,710,308,402,7,717,2128,0,33.69,14.47
苗栗縣,苑裡鎮,苑坑里,285,101,184,0,285,912,0,31.25,11.07
苗栗縣,苑裡鎮,水坡里,224,72,152,0,224,628,0,35.67,11.46
苗栗縣,苑裡鎮,新復里,535,251,284,6,541,1353,0,39.99,18.55
苗栗縣,苑裡鎮,山脚里,483,214,269,2,485,1350,0,35.93,15.85
苗栗縣,苑裡鎮,舊社里,624,291,333,9,633,1788,0,35.4,16.28
苗栗縣,苑裡鎮,福田里,426,197,229,4,430,1235,0,34.82,15.95
苗栗縣,苑裡鎮,石鎮里,186,86,100,1,187,546,0,34.25,15.75
苗栗縣,苑裡鎮,蕉埔里,277,146,131,0,277,770,0,35.97,18.96
苗栗縣,苑裡鎮,社苓里,775,315,460,5,780,2413,0,32.32,13.05
苗栗縣,苑裡鎮,泰田里,568,200,368,6,574,1649,0,34.81,12.13
苗栗縣,苑裡鎮,上舘里,555,251,304,15,570,1604,0,35.54,15.65
苗栗縣,苑裡鎮,玉田里,556,239,317,6,562,1758,0,31.97,13.59
苗栗縣,苑裡鎮,南勢里,221,84,137,4,225,680,0,33.09,12.35
苗栗縣,苑裡鎮,山柑里,438,219,219,5,443,1419,0,31.22,15.43
苗栗縣,苑裡鎮,田心里,661,301,360,4,665,1872,0,35.52,16.08
苗栗縣,苑裡鎮,合計,13646,5868,7778,120,13766,38502,44437,35.75,15.24
苗栗縣,通霄鎮,通東里,407,179,228,4,411,1064,0,38.63,16.82
苗栗縣,通霄鎮,通西里,791,361,430,7,798,1916,0,41.65,18.84
苗栗縣,通霄鎮,平元里,720,313,407,8,728,1805,0,40.33,17.34
苗栗縣,通霄鎮,梅南里,516,201,315,7,523,1531,0,34.16,13.13
苗栗縣,通霄鎮,圳頭里,247,112,135,3,250,676,0,36.98,16.57
苗栗縣,通霄鎮,通南里,872,397,475,9,881,2637,0,33.41,15.05
苗栗縣,通霄鎮,城北里,225,107,118,2,227,658,0,34.5,16.26
苗栗縣,通霄鎮,城南里,313,142,171,9,322,903,0,35.66,15.73
苗栗縣,通霄鎮,南和里,290,114,176,4,294,769,0,38.23,14.82
苗栗縣,通霄鎮,福興里,224,110,114,5,229,622,0,36.82,17.68
苗栗縣,通霄鎮,坪頂里,394,210,184,6,400,1189,0,33.64,17.66
苗栗縣,通霄鎮,五南里,441,215,226,5,446,1325,0,33.66,16.23
苗栗縣,通霄鎮,五北里,457,184,273,5,462,1379,0,33.5,13.34
苗栗縣,通霄鎮,內湖里,529,246,283,3,532,1822,0,29.2,13.5
苗栗縣,通霄鎮,楓樹里,145,79,66,0,145,415,0,34.94,19.04
苗栗縣,通霄鎮,烏眉里,289,186,103,7,296,856,0,34.58,21.73
苗栗縣,通霄鎮,福龍里,122,80,42,2,124,385,0,32.21,20.78
苗栗縣,通霄鎮,福源里,223,114,109,6,229,770,0,29.74,14.81
苗栗縣,通霄鎮,通灣里,628,301,327,4,632,2187,0,28.9,13.76
苗栗縣,通霄鎮,新埔里,335,110,225,5,340,1078,0,31.54,10.2
苗栗縣,通霄鎮,內島里,220,91,129,3,223,709,0,31.45,12.83
苗栗縣,通霄鎮,白東里,427,221,206,3,430,1405,0,30.6,15.73
苗栗縣,通霄鎮,白西里,226,107,119,3,229,709,0,32.3,15.09
苗栗縣,通霄鎮,平安里,679,300,379,6,685,2009,0,34.1,14.93
苗栗縣,通霄鎮,合計,9720,4480,5240,116,9836,28819,32701,34.13,15.55
苗栗縣,竹南鎮,竹南里,811,475,336,4,815,1893,0,43.05,25.09
苗栗縣,竹南鎮,照南里,1440,763,677,14,1454,3293,0,44.15,23.17
苗栗縣,竹南鎮,正南里,966,486,480,9,975,2715,0,35.91,17.9
苗栗縣,竹南鎮,新南里,2002,1078,924,19,2021,4759,0,42.47,22.65
苗栗縣,竹南鎮,大厝里,2106,1248,858,16,2122,5205,0,40.77,23.98
苗栗縣,竹南鎮,營盤里,1324,669,655,16,1340,3484,0,38.46,19.2
苗栗縣,竹南鎮,聖福里,1365,778,587,9,1374,3366,0,40.82,23.11
苗栗縣,竹南鎮,竹興里,1049,568,481,7,1056,3259,0,32.4,17.43
苗栗縣,竹南鎮,龍鳳里,751,410,341,5,756,2041,0,37.04,20.09
苗栗縣,竹南鎮,山佳里,1661,995,666,12,1673,4916,0,34.03,20.24
苗栗縣,竹南鎮,中港里,404,223,181,4,408,1080,0,37.78,20.65
苗栗縣,竹南鎮,中華里,1155,644,511,11,1166,2759,0,42.26,23.34
苗栗縣,竹南鎮,中英里,537,305,232,2,539,1520,0,35.46,20.07
苗栗縣,竹南鎮,中美里,721,405,316,4,725,1941,0,37.35,20.87
苗栗縣,竹南鎮,開元里,438,230,208,4,442,1207,0,36.62,19.06
苗栗縣,竹南鎮,海口里,1356,739,617,6,1362,4107,0,33.16,17.99
苗栗縣,竹南鎮,港墘里,823,440,383,11,834,2198,0,37.94,20.02
苗栗縣,竹南鎮,公舘里,374,254,120,7,381,1138,0,33.48,22.32
苗栗縣,竹南鎮,大埔里,1554,845,709,16,1570,4771,0,32.91,17.71
苗栗縣,竹南鎮,頂埔里,797,404,393,13,810,2066,0,39.21,19.55
苗栗縣,竹南鎮,崎頂里,1399,763,636,18,1417,3817,0,37.12,19.99
苗栗縣,竹南鎮,公義里,365,193,172,4,369,1009,0,36.57,19.13
苗栗縣,竹南鎮,佳興里,1192,624,568,20,1212,3241,0,37.4,19.25
苗栗縣,竹南鎮,天文里,844,512,332,1,845,2154,0,39.23,23.77
苗栗縣,竹南鎮,龍山里,908,459,449,10,918,2327,0,39.45,19.72
苗栗縣,竹南鎮,合計,26342,14510,11832,242,26584,70266,87307,37.83,20.65
苗栗縣,頭份市,流東里,709,480,229,8,717,2182,0,32.86,22.0
苗栗縣,頭份市,珊湖里,620,426,194,4,624,1710,0,36.49,24.91
苗栗縣,頭份市,斗煥里,1081,784,297,12,1093,2890,0,37.82,27.13
苗栗縣,頭份市,新華里,1417,1041,376,11,1428,3743,0,38.15,27.81
苗栗縣,頭份市,興隆里,1631,1108,523,11,1642,4464,0,36.78,24.82
苗栗縣,頭份市,上埔里,920,660,260,8,928,2565,0,36.18,25.73
苗栗縣,頭份市,土牛里,370,228,142,3,373,1018,0,36.64,22.4
苗栗縣,頭份市,頭份里,1179,797,382,12,1191,3264,0,36.49,24.42
苗栗縣,頭份市,忠孝里,1289,906,383,12,1301,3066,0,42.43,29.55
苗栗縣,頭份市,仁愛里,578,382,196,2,580,1574,0,36.85,24.27
苗栗縣,頭份市,信義里,337,226,111,4,341,977,0,34.9,23.13
苗栗縣,頭份市,和平里,487,291,196,6,493,1036,0,47.59,28.09
苗栗縣,頭份市,民族里,790,551,239,10,800,2007,0,39.86,27.45
苗栗縣,頭份市,東庄里,1541,1029,512,9,1550,4392,0,35.29,23.43
苗栗縣,頭份市,後庄里,1725,1061,664,8,1733,4339,0,39.94,24.45
苗栗縣,頭份市,山下里,1537,1017,520,16,1553,4022,0,38.61,25.29
苗栗縣,頭份市,蟠桃里,1180,780,400,7,1187,3306,0,35.9,23.59
苗栗縣,頭份市,田寮里,1413,911,502,5,1418,3987,0,35.57,22.85
苗栗縣,頭份市,蘆竹里,503,293,210,4,507,1289,0,39.33,22.73
苗栗縣,頭份市,上興里,646,406,240,8,654,2144,0,30.5,18.94
苗栗縣,頭份市,下興里,888,595,293,7,895,2511,0,35.64,23.7
苗栗縣,頭份市,尖山里,522,362,160,5,527,1295,0,40.69,27.95
苗栗縣,頭份市,尖下里,917,639,278,5,922,2511,0,36.72,25.45
苗栗縣,頭份市,廣興里,365,263,102,7,372,878,0,42.37,29.95
苗栗縣,頭份市,濫坑里,825,588,237,12,837,2216,0,37.77,26.53
苗栗縣,頭份市,民權里,862,521,341,5,867,2277,0,38.08,22.88
苗栗縣,頭份市,民生里,824,544,280,9,833,2362,0,35.27,23.03
苗栗縣,頭份市,建國里,1381,932,449,10,1391,3387,0,41.07,27.52
苗栗縣,頭份市,成功里,1316,920,396,16,1332,3570,0,37.31,25.77
苗栗縣,頭份市,自強里,778,501,277,6,784,1951,0,40.18,25.68
苗栗縣,頭份市,合興里,915,604,311,11,926,2514,0,36.83,24.03
苗栗縣,頭份市,文化里,1342,817,525,11,1353,3515,0,38.49,23.24
苗栗縣,頭份市,中興里,1010,679,331,6,1016,2774,0,36.63,24.48
苗栗縣,頭份市,合計,31898,21342,10556,270,32168,85736,104902,37.52,24.89
苗栗縣,後龍鎮,南龍里,461,246,215,5,466,1399,0,33.31,17.58
苗栗縣,後龍鎮,中龍里,315,152,163,3,318,731,0,43.5,20.79
苗栗縣,後龍鎮,北龍里,499,237,262,5,504,1248,0,40.38,18.99
苗栗縣,後龍鎮,大庄里,1477,814,663,5,1482,4216,0,35.15,19.31
苗栗縣,後龍鎮,溪洲里,691,393,298,10,701,2258,0,31.05,17.4
苗栗縣,後龍鎮,豐富里,512,346,166,3,515,1219,0,42.25,28.38
苗栗縣,後龍鎮,校椅里,393,262,131,5,398,1026,0,38.79,25.54
苗栗縣,後龍鎮,埔頂里,844,440,404,17,861,2669,0,32.26,16.49
苗栗縣,後龍鎮,新民里,492,278,214,4,496,1304,0,38.04,21.32
苗栗縣,後龍鎮,復興里,241,120,121,2,243,679,0,35.79,17.67
苗栗縣,後龍鎮,東明里,445,207,238,4,449,1462,0,30.71,14.16
苗栗縣,後龍鎮,大山里,494,236,258,6,500,1503,0,33.27,15.7
苗栗縣,後龍鎮,灣寶里,379,171,208,9,388,1231,0,31.52,13.89
苗栗縣,後龍鎮,海寶里,307,147,160,4,311,957,0,32.5,15.36
苗栗縣,後龍鎮,外埔里,302,176,126,3,305,982,0,31.06,17.92
苗栗縣,後龍鎮,海埔里,268,122,146,6,274,897,0,30.55,13.6
苗栗縣,後龍鎮,秀水里,240,111,129,3,243,682,0,35.63,16.28
苗栗縣,後龍鎮,水尾里,338,166,172,5,343,1023,0,33.53,16.23
苗栗縣,後龍鎮,龍津里,209,109,100,4,213,591,0,36.04,18.44
苗栗縣,後龍鎮,龍坑里,409,169,240,4,413,1251,0,33.01,13.51
苗栗縣,後龍鎮,福寧里,213,107,106,3,216,718,0,30.08,14.9
苗栗縣,後龍鎮,中和里,304,170,134,6,310,1010,0,30.69,16.83
苗栗縣,後龍鎮,南港里,357,170,187,4,361,1188,0,30.39,14.31
苗栗縣,後龍鎮,合計,10190,5349,4841,120,10310,30244,34941,34.09,17.69
苗栗縣,卓蘭鎮,中街里,316,168,148,2,318,698,0,45.56,24.07
苗栗縣,卓蘭鎮,新厝里,599,322,277,8,607,1479,0,41.04,21.77
苗栗縣,卓蘭鎮,上新里,755,353,402,6,761,1991,0,38.22,17.73
苗栗縣,卓蘭鎮,豐田里,351,165,186,6,357,937,0,38.1,17.61
苗栗縣,卓蘭鎮,西坪里,238,137,101,1,239,674,0,35.46,20.33
苗栗縣,卓蘭鎮,景山里,273,148,125,2,275,923,0,29.79,16.03
苗栗縣,卓蘭鎮,老庄里,744,370,374,6,750,1876,0,39.98,19.72
苗栗縣,卓蘭鎮,新榮里,423,184,239,6,429,1056,0,40.63,17.42
苗栗縣,卓蘭鎮,內灣里,741,357,384,3,744,2071,0,35.92,17.24
苗栗縣,卓蘭鎮,苗豐里,265,128,137,5,270,702,0,38.46,18.23
苗栗縣,卓蘭鎮,坪林里,343,187,156,6,349,1067,0,32.71,17.53
苗栗縣,卓蘭鎮,西坪里、坪林里,251,160,91,6,257,715,0,35.94,22.38
苗栗縣,卓蘭鎮,合計,5299,2679,2620,57,5356,14189,16007,37.75,18.88
苗栗縣,大湖鄉,大湖村,633,450,183,5,638,1539,0,41.46,29.24
苗栗縣,大湖鄉,明湖村,256,201,55,1,257,557,0,46.14,36.09
苗栗縣,大湖鄉,靜湖村,593,434,159,10,603,1714,0,35.18,25.32
苗栗縣,大湖鄉,富興村,390,238,152,6,396,1323,0,29.93,17.99
苗栗縣,大湖鄉,大南村,172,129,43,3,175,529,0,33.08,24.39
苗栗縣,大湖鄉,大寮村,423,285,138,4,427,1155,0,36.97,24.68
苗栗縣,大湖鄉,南湖村,221,146,75,1,222,599,0,37.06,24.37
苗栗縣,大湖鄉,義和村,428,270,158,8,436,1448,0,30.11,18.65
苗栗縣,大湖鄉,東興村,234,158,76,3,237,739,0,32.07,21.38
苗栗縣,大湖鄉,武榮村,182,131,51,2,184,484,0,38.02,27.07
苗栗縣,大湖鄉,栗林村,278,183,95,4,282,988,0,28.54,18.52
苗栗縣,大湖鄉,新開村,298,174,124,5,303,993,0,30.51,17.52
苗栗縣,大湖鄉,合計,4108,2799,1309,52,4160,12068,13686,34.47,23.19
苗栗縣,公館鄉,館中村,645,393,252,3,648,1507,0,43.0,26.08
苗栗縣,公館鄉,館東村,930,648,282,9,939,2286,0,41.08,28.35
苗栗縣,公館鄉,館南村,1257,848,409,17,1274,3412,0,37.34,24.85
苗栗縣,公館鄉,大坑村,349,212,137,5,354,921,0,38.44,23.02
苗栗縣,公館鄉,中義村,763,500,263,12,775,2259,0,34.31,22.13
苗栗縣,公館鄉,玉泉村,923,606,317,4,927,2296,0,40.37,26.39
苗栗縣,公館鄉,石墻村,521,372,149,3,524,1448,0,36.19,25.69
苗栗縣,公館鄉,福基村,390,284,106,7,397,995,0,39.9,28.54
苗栗縣,公館鄉,福星村,784,527,257,13,797,2019,0,39.47,26.1
苗栗縣,公館鄉,開礦村,105,82,23,1,106,280,0,37.86,29.29
苗栗縣,公館鄉,福德村,160,91,69,2,162,339,0,47.79,26.84
苗栗縣,公館鄉,五谷村,857,533,324,17,874,2213,0,39.49,24.08
苗栗縣,公館鄉,玉谷村,532,357,175,8,540,1453,0,37.16,24.57
苗栗縣,公館鄉,鶴岡村,643,445,198,7,650,1579,0,41.17,28.18
苗栗縣,公館鄉,鶴山村,537,358,179,3,540,1427,0,37.84,25.09
苗栗縣,公館鄉,仁安村,480,325,155,2,482,1270,0,37.95,25.59
苗栗縣,公館鄉,尖山村,536,333,203,6,542,1415,0,38.3,23.53
苗栗縣,公館鄉,南河村,87,71,16,2,89,213,0,41.78,33.33
苗栗縣,公館鄉,北河村,104,66,38,0,104,329,0,31.61,20.06
苗栗縣,公館鄉,合計,10603,7051,3552,121,10724,27661,32119,38.77,25.49
苗栗縣,銅鑼鄉,福興村,410,347,63,2,412,940,0,43.83,36.91
苗栗縣,銅鑼鄉,銅鑼村,1723,1211,512,15,1738,4334,0,40.1,27.94
苗栗縣,銅鑼鄉,朝陽村,681,489,192,5,686,1617,0,42.42,30.24
苗栗縣,銅鑼鄉,樟樹村,404,273,131,9,413,1247,0,33.12,21.89
苗栗縣,銅鑼鄉,九湖村,418,295,123,4,422,1142,0,36.95,25.83
苗栗縣,銅鑼鄉,竹森村,331,244,87,0,331,1021,0,32.42,23.9
苗栗縣,銅鑼鄉,中平村,1109,735,374,6,1115,3115,0,35.79,23.6
苗栗縣,銅鑼鄉,興隆村,188,123,65,3,191,540,0,35.37,22.78
苗栗縣,銅鑼鄉,盛隆村,143,92,51,2,145,411,0,35.28,22.38
苗栗縣,銅鑼鄉,新隆村,227,156,71,3,230,525,0,43.81,29.71
苗栗縣,銅鑼鄉,合計,5634,3965,1669,49,5683,14892,17039,38.16,26.63
苗栗縣,南庄鄉,東村,417,312,105,4,421,1102,0,38.2,28.31
苗栗縣,南庄鄉,西村,223,156,67,2,225,609,0,36.95,25.62
苗栗縣,南庄鄉,南江村,369,279,90,5,374,1283,0,29.15,21.75
苗栗縣,南庄鄉,田美村,274,189,85,3,277,793,0,34.93,23.83
苗栗縣,南庄鄉,獅山村,264,184,80,4,268,793,0,33.8,23.2
苗栗縣,南庄鄉,南富村,464,328,136,8,472,1037,0,45.52,31.63
苗栗縣,南庄鄉,員林村,383,259,124,2,385,986,0,39.05,26.27
苗栗縣,南庄鄉,蓬萊村,231,185,46,3,234,838,0,27.92,22.08
苗栗縣,南庄鄉,東河村,225,184,41,7,232,912,0,25.44,20.18
苗栗縣,南庄鄉,合計,2850,2076,774,38,2888,8353,9430,34.57,24.85
苗栗縣,頭屋鄉,頭屋村,983,700,283,5,988,2420,0,40.83,28.93
苗栗縣,頭屋鄉,象山村,686,454,232,7,693,1786,0,38.8,25.42
苗栗縣,頭屋鄉,北坑村,244,184,60,2,246,687,0,35.81,26.78
苗栗縣,頭屋鄉,獅潭村,651,455,196,9,660,1635,0,40.37,27.83
苗栗縣,頭屋鄉,曲洞村,398,268,130,1,399,848,0,47.05,31.6
苗栗縣,頭屋鄉,飛鳳村,164,114,50,1,165,377,0,43.77,30.24
苗栗縣,頭屋鄉,明德村,424,291,133,6,430,968,0,44.42,30.06
苗栗縣,頭屋鄉,鳴鳳村,126,78,48,2,128,302,0,42.38,25.83
苗栗縣,頭屋鄉,合計,3676,2544,1132,33,3709,9023,10112,41.11,28.19
苗栗縣,三義鄉,廣盛村,1588,1082,506,18,1606,3909,0,41.08,27.68
苗栗縣,三義鄉,双湖村,691,474,217,4,695,1787,0,38.89,26.52
苗栗縣,三義鄉,双潭村,487,336,151,3,490,1321,0,37.09,25.44
苗栗縣,三義鄉,勝興村,1325,836,489,17,1342,3286,0,40.84,25.44
苗栗縣,三義鄉,西湖村,566,419,147,11,577,1427,0,40.43,29.36
苗栗縣,三義鄉,龍騰村,170,123,47,0,170,402,0,42.29,30.6
苗栗縣,三義鄉,鯉魚潭村,466,220,246,6,472,1241,0,38.03,17.73
苗栗縣,三義鄉,合計,5293,3490,1803,59,5352,13373,15480,40.02,26.1
苗栗縣,西湖鄉,高埔村,230,185,45,4,234,595,0,39.33,31.09
苗栗縣,西湖鄉,下埔村,194,152,42,4,198,564,0,35.11,26.95
苗栗縣,西湖鄉,五湖村,279,198,81,4,283,790,0,35.82,25.06
苗栗縣,西湖鄉,四湖村,205,152,53,2,207,627,0,33.01,24.24
苗栗縣,西湖鄉,金獅村,181,130,51,1,182,482,0,37.76,26.97
苗栗縣,西湖鄉,龍洞村,150,91,59,3,153,446,0,34.3,20.4
苗栗縣,西湖鄉,三湖村,314,218,96,4,318,871,0,36.51,25.03
苗栗縣,西湖鄉,湖東村,340,242,98,3,343,1112,0,30.85,21.76
苗栗縣,西湖鄉,二湖村,214,145,69,3,217,646,0,33.59,22.45
苗栗縣,西湖鄉,合計,2107,1513,594,28,2135,6133,6635,34.81,24.67
苗栗縣,造橋鄉,造橋村,754,524,230,8,762,2010,0,37.91,26.07
苗栗縣,造橋鄉,平興村,175,126,49,1,176,442,0,39.82,28.51
苗栗縣,造橋鄉,豐湖村,376,251,125,5,381,969,0,39.32,25.9
苗栗縣,造橋鄉,大西村,1204,792,412,8,1212,3315,0,36.56,23.89
苗栗縣,造橋鄉,錦水村,182,124,58,3,185,479,0,38.62,25.89
苗栗縣,造橋鄉,大龍村,192,126,66,0,192,485,0,39.59,25.98
苗栗縣,造橋鄉,朝陽村,435,246,189,5,440,1252,0,35.14,19.65
苗栗縣,造橋鄉,談文村,291,181,110,2,293,837,0,35.01,21.62
苗栗縣,造橋鄉,龍昇村,301,148,153,2,303,943,0,32.13,15.69
苗栗縣,造橋鄉,合計,3910,2518,1392,34,3944,10732,12084,36.75,23.46
苗栗縣,三灣鄉,三灣村,772,522,250,3,775,2118,0,36.59,24.65
苗栗縣,三灣鄉,內灣村,267,183,84,6,273,613,0,44.54,29.85
苗栗縣,三灣鄉,銅鏡村,320,237,83,5,325,822,0,39.54,28.83
苗栗縣,三灣鄉,頂寮村,73,46,27,1,74,227,0,32.6,20.26
苗栗縣,三灣鄉,北埔村,160,100,60,6,166,517,0,32.11,19.34
苗栗縣,三灣鄉,大河村,201,136,65,3,204,523,0,39.01,26.0
苗栗縣,三灣鄉,大坪村,181,121,60,3,184,391,0,47.06,30.95
苗栗縣,三灣鄉,永和村,161,121,40,3,164,368,0,44.57,32.88
苗栗縣,三灣鄉,合計,2135,1466,669,30,2165,5579,6259,38.81,26.28
苗栗縣,獅潭鄉,百壽村,93,82,11,2,95,322,0,29.5,25.47
苗栗縣,獅潭鄉,永興村,203,145,58,5,208,531,0,39.17,27.31
苗栗縣,獅潭鄉,新店村,318,224,94,6,324,869,0,37.28,25.78
苗栗縣,獅潭鄉,和興村,199,134,65,1,200,539,0,37.11,24.86
苗栗縣,獅潭鄉,豐林村,200,150,50,5,205,548,0,37.41,27.37
苗栗縣,獅潭鄉,新豐村,123,88,35,3,126,323,0,39.01,27.24
苗栗縣,獅潭鄉,竹木村,278,203,75,3,281,650,0,43.23,31.23
苗栗縣,獅潭鄉,合計,1414,1026,388,25,1439,3782,4094,38.05,27.13
苗栗縣,泰安鄉,八卦村,84,64,20,2,86,336,0,25.6,19.05
苗栗縣,泰安鄉,錦水村,313,256,57,3,316,1070,0,29.53,23.93
苗栗縣,泰安鄉,清安村,289,228,61,4,293,871,0,33.64,26.18
苗栗縣,泰安鄉,大興村,190,161,29,2,192,480,0,40.0,33.54
苗栗縣,泰安鄉,中興村,130,109,21,1,131,501,0,26.15,21.76
苗栗縣,泰安鄉,梅園村,133,107,26,4,137,481,0,28.48,22.25
苗栗縣,泰安鄉,象鼻村,179,147,32,4,183,666,0,27.48,22.07
苗栗縣,泰安鄉,士林村,197,178,19,6,203,590,0,34.41,30.17
苗栗縣,泰安鄉,合計,1515,1250,265,26,1541,4995,5695,30.85,25.03
苗栗縣,合計,合計,169858,104362,65496,1687,171545,457991,540312,37.46,22.79
彰化縣,彰化市,文化里,530,255,275,6,536,1253,0,42.78,20.35
彰化縣,彰化市,下廍里,2122,1064,1058,16,2138,4972,0,43.0,21.4
彰化縣,彰化市,興北里,678,306,372,4,682,1603,0,42.55,19.09
彰化縣,彰化市,信義里,376,177,199,4,380,760,0,50.0,23.29
彰化縣,彰化市,民生里,574,295,279,5,579,1331,0,43.5,22.16
彰化縣,彰化市,陽明里,745,346,399,8,753,1723,0,43.7,20.08
彰化縣,彰化市,萬安里,1720,808,912,12,1732,3835,0,45.16,21.07
彰化縣,彰化市,新興里,2267,1044,1223,16,2283,5212,0,43.8,20.03
彰化縣,彰化市,新華里,763,381,382,11,774,1718,0,45.05,22.18
彰化縣,彰化市,龍山里,831,390,441,4,835,1895,0,44.06,20.58
彰化縣,彰化市,中山里,345,197,148,2,347,762,0,45.54,25.85
彰化縣,彰化市,中正里,641,330,311,8,649,1377,0,47.13,23.97
彰化縣,彰化市,永福里,396,162,234,2,398,862,0,46.17,18.79
彰化縣,彰化市,光復里,262,91,171,4,266,642,0,41.43,14.17
彰化縣,彰化市,光華里,361,158,203,1,362,706,0,51.27,22.38
彰化縣,彰化市,萬壽里,383,133,250,1,384,864,0,44.44,15.39
彰化縣,彰化市,中央里,374,153,221,3,377,748,0,50.4,20.45
彰化縣,彰化市,富貴里,387,143,244,6,393,863,0,45.54,16.57
彰化縣,彰化市,民權里,465,215,250,5,470,1067,0,44.05,20.15
彰化縣,彰化市,西興里,1470,703,767,9,1479,3304,0,44.76,21.28
彰化縣,彰化市,西勢里,1555,812,743,14,1569,3585,0,43.77,22.65
彰化縣,彰化市,忠孝里,528,257,271,4,532,1129,0,47.12,22.76
彰化縣,彰化市,忠權里,1328,675,653,16,1344,3158,0,42.56,21.37
彰化縣,彰化市,五權里,1525,767,758,18,1543,4175,0,36.96,18.37
彰化縣,彰化市,長樂里,458,184,274,2,460,930,0,49.46,19.78
彰化縣,彰化市,東芳里,1390,634,756,13,1403,3505,0,40.03,18.09
彰化縣,彰化市,南安里,884,440,444,9,893,2137,0,41.79,20.59
彰化縣,彰化市,南美里,734,333,401,5,739,1884,0,39.23,17.68
彰化縣,彰化市,莿桐里,1321,632,689,14,1335,3079,0,43.36,20.53
彰化縣,彰化市,磚磘里,1268,628,640,8,1276,3285,0,38.84,19.12
彰化縣,彰化市,平和里,1679,827,852,18,1697,4235,0,40.07,19.53
彰化縣,彰化市,桃源里,961,466,495,7,968,2424,0,39.93,19.22
彰化縣,彰化市,卦山里,1090,581,509,12,1102,2437,0,45.22,23.84
彰化縣,彰化市,東興里,676,317,359,7,683,1511,0,45.2,20.98
彰化縣,彰化市,大同里,454,208,246,4,458,974,0,47.02,21.36
彰化縣,彰化市,永生里,544,266,278,3,547,1169,0,46.79,22.75
彰化縣,彰化市,華陽里,746,407,339,6,752,1770,0,42.49,22.99
彰化縣,彰化市,華北里,634,323,311,5,639,1426,0,44.81,22.65
彰化縣,彰化市,南瑶里,3237,1580,1657,18,3255,7458,0,43.64,21.19
彰化縣,彰化市,成功里,656,320,336,4,660,1470,0,44.9,21.77
彰化縣,彰化市,延和里,2084,1020,1064,19,2103,4938,0,42.59,20.66
彰化縣,彰化市,南興里,3128,1487,1641,26,3154,7515,0,41.97,19.79
彰化縣,彰化市,西安里,1224,582,642,7,1231,2775,0,44.36,20.97
彰化縣,彰化市,彰安里,1252,583,669,16,1268,2845,0,44.57,20.49
彰化縣,彰化市,光南里,638,317,321,3,641,1419,0,45.17,22.34
彰化縣,彰化市,介壽里,960,565,395,4,964,2598,0,37.11,21.75
彰化縣,彰化市,延平里,3773,1906,1867,25,3798,8962,0,42.38,21.27
彰化縣,彰化市,建寶里,1019,550,469,9,1028,2240,0,45.89,24.55
彰化縣,彰化市,福安里,449,212,237,9,458,981,0,46.69,21.61
彰化縣,彰化市,大竹里,1315,635,680,9,1324,3193,0,41.47,19.89
彰化縣,彰化市,竹中里,634,329,305,10,644,1653,0,38.96,19.9
彰化縣,彰化市,安溪里,787,386,401,8,795,1899,0,41.86,20.33
彰化縣,彰化市,香山里,1308,603,705,14,1322,3295,0,40.12,18.3
彰化縣,彰化市,牛埔里,1239,545,694,16,1255,2951,0,42.53,18.47
彰化縣,彰化市,福山里,2712,1230,1482,32,2744,6731,0,40.77,18.27
彰化縣,彰化市,中庄里,961,436,525,11,972,2426,0,40.07,17.97
彰化縣,彰化市,三村里,436,209,227,3,439,1183,0,37.11,17.67
彰化縣,彰化市,國聖里,1016,453,563,13,1029,2414,0,42.63,18.77
彰化縣,彰化市,寶廍里,480,217,263,8,488,1222,0,39.93,17.76
彰化縣,彰化市,茄苳里,381,190,191,7,388,936,0,41.45,20.3
彰化縣,彰化市,茄南里,1239,613,626,16,1255,2915,0,43.05,21.03
彰化縣,彰化市,阿夷里,3345,1746,1599,24,3369,8423,0,40.0,20.73
彰化縣,彰化市,古夷里,929,419,510,6,935,2377,0,39.34,17.63
彰化縣,彰化市,復興里,1773,909,864,21,1794,4046,0,44.34,22.47
彰化縣,彰化市,和調里,1126,562,564,6,1132,2634,0,42.98,21.34
彰化縣,彰化市,石牌里,416,201,215,7,423,1132,0,37.37,17.76
彰化縣,彰化市,福田里,469,223,246,5,474,1249,0,37.95,17.85
彰化縣,彰化市,竹巷里,322,134,188,2,324,840,0,38.57,15.95
彰化縣,彰化市,田中里,360,182,178,0,360,885,0,40.68,20.56
彰化縣,彰化市,快官里,459,211,248,2,461,1114,0,41.38,18.94
彰化縣,彰化市,台鳳里,1667,912,755,9,1676,4349,0,38.54,20.97
彰化縣,彰化市,崙平里,2255,1153,1102,15,2270,5297,0,42.85,21.77
彰化縣,彰化市,向陽里,2184,1188,996,14,2198,5234,0,41.99,22.7
彰化縣,彰化市,合計,79698,38916,40782,690,80388,189909,229765,42.33,20.49
彰化縣,鹿港鎮,大有里,466,175,291,3,469,1109,0,42.29,15.78
彰化縣,鹿港鎮,中興里,220,74,146,1,221,506,0,43.68,14.62
彰化縣,鹿港鎮,洛津里,315,124,191,0,315,847,0,37.19,14.64
彰化縣,鹿港鎮,順興里,377,138,239,2,379,906,0,41.83,15.23
彰化縣,鹿港鎮,頂厝里,2876,1183,1693,28,2904,7832,0,37.08,15.1
彰化縣,鹿港鎮,東崎里,1813,760,1053,18,1831,5195,0,35.25,14.63
彰化縣,鹿港鎮,埔崙里,1920,695,1225,27,1947,5046,0,38.59,13.77
彰化縣,鹿港鎮,東石里,1596,529,1067,16,1612,4391,0,36.71,12.05
彰化縣,鹿港鎮,郭厝里,216,79,137,2,218,521,0,41.84,15.16
彰化縣,鹿港鎮,新宮里,399,140,259,1,400,837,0,47.79,16.73
彰化縣,鹿港鎮,玉順里,447,155,292,5,452,1126,0,40.14,13.77
彰化縣,鹿港鎮,景福里,470,210,260,5,475,1084,0,43.82,19.37
彰化縣,鹿港鎮,泰興里,495,206,289,4,499,1130,0,44.16,18.23
彰化縣,鹿港鎮,長興里,123,56,67,1,124,267,0,46.44,20.97
彰化縣,鹿港鎮,龍山里,280,110,170,4,284,618,0,45.95,17.8
彰化縣,鹿港鎮,興化里,248,106,142,3,251,574,0,43.73,18.47
彰化縣,鹿港鎮,菜園里,409,116,293,4,413,877,0,47.09,13.23
彰化縣,鹿港鎮,街尾里,996,394,602,13,1009,2170,0,46.5,18.16
彰化縣,鹿港鎮,頂番里,1328,700,628,12,1340,3879,0,34.54,18.05
彰化縣,鹿港鎮,頭崙里,901,441,460,15,916,2598,0,35.26,16.97
彰化縣,鹿港鎮,廖厝里,1326,683,643,13,1339,4105,0,32.62,16.64
彰化縣,鹿港鎮,溝墘里,1454,758,696,17,1471,4124,0,35.67,18.38
彰化縣,鹿港鎮,草中里,1169,621,548,8,1177,3189,0,36.91,19.47
彰化縣,鹿港鎮,頭南里,716,389,327,12,728,2191,0,33.23,17.75
彰化縣,鹿港鎮,山崙里,1059,467,592,9,1068,3032,0,35.22,15.4
彰化縣,鹿港鎮,海埔里,1180,471,709,14,1194,3575,0,33.4,13.17
彰化縣,鹿港鎮,詔安里,670,284,386,2,672,2076,0,32.37,13.68
彰化縣,鹿港鎮,洋厝里,893,379,514,22,915,2425,0,37.73,15.63
彰化縣,鹿港鎮,永安里,1568,646,922,17,1585,4383,0,36.16,14.74
彰化縣,鹿港鎮,合計,25930,11089,14841,278,26208,70613,86115,37.11,15.7
彰化縣,和美鎮,竹營里,2140,1075,1065,20,2160,6113,0,35.33,17.59
彰化縣,和美鎮,和東里,1646,789,857,12,1658,4323,0,38.35,18.25
彰化縣,和美鎮,和南里,181,99,82,0,181,398,0,45.48,24.87
彰化縣,和美鎮,和北里,625,292,333,5,630,1796,0,35.08,16.26
彰化縣,和美鎮,和西里,1215,589,626,14,1229,3164,0,38.84,18.62
彰化縣,和美鎮,四張里,1017,461,556,9,1026,2785,0,36.84,16.55
彰化縣,和美鎮,頭前里,540,276,264,10,550,1672,0,32.89,16.51
彰化縣,和美鎮,還社里,339,176,163,4,343,847,0,40.5,20.78
彰化縣,和美鎮,面前里,802,349,453,8,810,2119,0,38.23,16.47
彰化縣,和美鎮,鎮平里,1058,524,534,12,1070,2869,0,37.3,18.26
彰化縣,和美鎮,大霞里,466,236,230,2,468,1464,0,31.97,16.12
彰化縣,和美鎮,源埤里,613,290,323,12,625,1857,0,33.66,15.62
彰化縣,和美鎮,南佃里,810,379,431,8,818,2204,0,37.11,17.2
彰化縣,和美鎮,雅溝里,457,201,256,6,463,1318,0,35.13,15.25
彰化縣,和美鎮,山犁里,2006,981,1025,10,2016,5228,0,38.56,18.76
彰化縣,和美鎮,嘉犁里,726,350,376,6,732,1959,0,37.37,17.87
彰化縣,和美鎮,鐵山里,1060,492,568,13,1073,2669,0,40.2,18.43
彰化縣,和美鎮,詔安里,767,371,396,6,773,2034,0,38.0,18.24
彰化縣,和美鎮,柑井里,1185,526,659,16,1201,3450,0,34.81,15.25
彰化縣,和美鎮,竹園里,357,140,217,7,364,868,0,41.94,16.13
彰化縣,和美鎮,新庄里,964,471,493,19,983,2388,0,41.16,19.72
彰化縣,和美鎮,犁盛里,915,399,516,13,928,2277,0,40.76,17.52
彰化縣,和美鎮,中寮里,363,155,208,5,368,1109,0,33.18,13.98
彰化縣,和美鎮,中圍里,1052,478,574,13,1065,2845,0,37.43,16.8
彰化縣,和美鎮,糖友里,1556,812,744,14,1570,4308,0,36.44,18.85
彰化縣,和美鎮,塗厝里,589,311,278,6,595,1748,0,34.04,17.79
彰化縣,和美鎮,地潭里,244,135,109,3,247,842,0,29.33,16.03
彰化縣,和美鎮,湖內里,446,173,273,6,452,1196,0,37.79,14.46
彰化縣,和美鎮,嘉寶里,627,283,344,5,632,2038,0,31.01,13.89
彰化縣,和美鎮,月眉里,1124,490,634,13,1137,3033,0,37.49,16.16
彰化縣,和美鎮,好修里,565,246,319,5,570,1548,0,36.82,15.89
彰化縣,和美鎮,仁愛里,892,420,472,7,899,2716,0,33.1,15.46
彰化縣,和美鎮,合計,27347,12969,14378,289,27636,75185,89825,36.76,17.25
彰化縣,線西鄉,線西村,435,270,165,1,436,1187,0,36.73,22.75
彰化縣,線西鄉,頂庄村,826,500,326,13,839,2276,0,36.86,21.97
彰化縣,線西鄉,寓埔村,779,420,359,9,788,2324,0,33.91,18.07
彰化縣,線西鄉,塭仔村,442,221,221,1,443,1240,0,35.73,17.82
彰化縣,線西鄉,溝內村,383,200,183,3,386,1223,0,31.56,16.35
彰化縣,線西鄉,下犁村,680,323,357,9,689,1914,0,36.0,16.88
彰化縣,線西鄉,頂犁村,797,434,363,6,803,2519,0,31.88,17.23
彰化縣,線西鄉,德興村,502,263,239,9,511,1348,0,37.91,19.51
彰化縣,線西鄉,合計,4844,2631,2213,51,4895,14031,16573,34.89,18.75
彰化縣,伸港鄉,曾家村,528,249,279,8,536,1748,0,30.66,14.24
彰化縣,伸港鄉,蚵寮村,416,126,290,5,421,1157,0,36.39,10.89
彰化縣,伸港鄉,埤墘村,478,231,247,8,486,1484,0,32.75,15.57
彰化縣,伸港鄉,溪底村,695,295,400,2,697,2048,0,34.03,14.4
彰化縣,伸港鄉,泉州村,677,355,322,4,681,1990,0,34.22,17.84
彰化縣,伸港鄉,泉厝村,458,231,227,3,461,1273,0,36.21,18.15
彰化縣,伸港鄉,海尾村,663,334,329,8,671,1826,0,36.75,18.29
彰化縣,伸港鄉,全興村,500,322,178,6,506,1714,0,29.52,18.79
彰化縣,伸港鄉,定興村,845,436,409,12,857,2652,0,32.32,16.44
彰化縣,伸港鄉,新港村,1719,815,904,7,1726,5173,0,33.37,15.75
彰化縣,伸港鄉,什股村,621,368,253,5,626,2344,0,26.71,15.7
彰化縣,伸港鄉,大同村,953,430,523,9,962,2622,0,36.69,16.4
彰化縣,伸港鄉,七嘉村,984,489,495,5,989,3002,0,32.94,16.29
彰化縣,伸港鄉,汴頭村,725,361,364,11,736,2240,0,32.86,16.12
彰化縣,伸港鄉,合計,10262,5042,5220,93,10355,31273,37802,33.11,16.12
彰化縣,福興鄉,番社村,531,169,362,3,534,1480,0,36.08,11.42
彰化縣,福興鄉,社尾村,491,198,293,4,495,1453,0,34.07,13.63
彰化縣,福興鄉,大崙村,447,195,252,8,455,1237,0,36.78,15.76
彰化縣,福興鄉,外埔村,508,194,314,5,513,1505,0,34.09,12.89
彰化縣,福興鄉,外中村,421,147,274,5,426,1168,0,36.47,12.59
彰化縣,福興鄉,元中村,453,196,257,2,455,1273,0,35.74,15.4
彰化縣,福興鄉,三汴村,538,214,324,5,543,1360,0,39.93,15.74
彰化縣,福興鄉,萬豐村,367,140,227,2,369,832,0,44.35,16.83
彰化縣,福興鄉,番婆村,724,548,176,8,732,2397,0,30.54,22.86
彰化縣,福興鄉,橋頭村,938,413,525,5,943,2653,0,35.54,15.57
彰化縣,福興鄉,秀厝村,810,325,485,13,823,2550,0,32.27,12.75
彰化縣,福興鄉,鎮平村,370,186,184,3,373,1172,0,31.83,15.87
彰化縣,福興鄉,三和村,381,109,272,6,387,1047,0,36.96,10.41
彰化縣,福興鄉,麥厝村,631,239,392,13,644,2180,0,29.54,10.96
彰化縣,福興鄉,廈粘村,588,295,293,5,593,1856,0,31.95,15.89
彰化縣,福興鄉,頂粘村,648,334,314,7,655,2276,0,28.78,14.67
彰化縣,福興鄉,福寶村,331,181,150,5,336,1276,0,26.33,14.18
彰化縣,福興鄉,二港村,456,182,274,5,461,1275,0,36.16,14.27
彰化縣,福興鄉,福興村,1294,510,784,9,1303,3643,0,35.77,14.0
彰化縣,福興鄉,福南村,818,369,449,11,829,2581,0,32.12,14.3
彰化縣,福興鄉,同安村,748,318,430,5,753,2364,0,31.85,13.45
彰化縣,福興鄉,西勢村,689,309,380,11,700,1917,0,36.52,16.12
彰化縣,福興鄉,合計,13182,5771,7411,140,13322,39495,46114,33.73,14.61
彰化縣,秀水鄉,秀水村,687,275,412,4,691,1676,0,41.23,16.41
彰化縣,秀水鄉,安溪村,851,364,487,9,860,2038,0,42.2,17.86
彰化縣,秀水鄉,莊雅村,1040,550,490,7,1047,2642,0,39.63,20.82
彰化縣,秀水鄉,金興村,636,330,306,8,644,1828,0,35.23,18.05
彰化縣,秀水鄉,陝西村,503,268,235,5,508,1438,0,35.33,18.64
彰化縣,秀水鄉,安東村,1484,729,755,16,1500,3871,0,38.75,18.83
彰化縣,秀水鄉,鶴鳴村,1273,585,688,6,1279,3154,0,40.55,18.55
彰化縣,秀水鄉,馬興村,895,386,509,9,904,2279,0,39.67,16.94
彰化縣,秀水鄉,義興村,504,238,266,10,514,1479,0,34.75,16.09
彰化縣,秀水鄉,福安村,1685,791,894,12,1697,4523,0,37.52,17.49
彰化縣,秀水鄉,埔崙村,840,375,465,12,852,1939,0,43.94,19.34
彰化縣,秀水鄉,曾厝村,634,293,341,6,640,1677,0,38.16,17.47
彰化縣,秀水鄉,金陵村,667,264,403,6,673,1737,0,38.74,15.2
彰化縣,秀水鄉,下崙村,772,308,464,7,779,2170,0,35.9,14.19
彰化縣,秀水鄉,合計,12471,5756,6715,117,12588,32451,38830,38.79,17.74
彰化縣,花壇鄉,花壇村,1325,663,662,12,1337,3179,0,42.06,20.86
彰化縣,花壇鄉,金墩村,676,317,359,13,689,1758,0,39.19,18.03
彰化縣,花壇鄉,中庄村,922,463,459,5,927,2329,0,39.8,19.88
彰化縣,花壇鄉,劉厝村,456,189,267,10,466,1069,0,43.59,17.68
彰化縣,花壇鄉,崙雅村,558,239,319,6,564,1419,0,39.75,16.84
彰化縣,花壇鄉,南口村,747,369,378,16,763,1892,0,40.33,19.5
彰化縣,花壇鄉,中口村,294,129,165,3,297,721,0,41.19,17.89
彰化縣,花壇鄉,北口村,730,362,368,7,737,1803,0,40.88,20.08
彰化縣,花壇鄉,長沙村,1881,1000,881,27,1908,4928,0,38.72,20.29
彰化縣,花壇鄉,文德村,1138,560,578,10,1148,3092,0,37.13,18.11
彰化縣,花壇鄉,白沙村,1707,896,811,20,1727,4602,0,37.53,19.47
彰化縣,花壇鄉,岩竹村,519,207,312,4,523,1340,0,39.03,15.45
彰化縣,花壇鄉,橋頭村,1153,604,549,14,1167,3298,0,35.39,18.31
彰化縣,花壇鄉,灣雅村,310,177,133,2,312,890,0,35.06,19.89
彰化縣,花壇鄉,灣東村,339,158,181,3,342,932,0,36.7,16.95
彰化縣,花壇鄉,三春村,664,346,318,6,670,1906,0,35.15,18.15
彰化縣,花壇鄉,永春村,580,314,266,3,583,1888,0,30.88,16.63
彰化縣,花壇鄉,長春村,491,272,219,9,500,1605,0,31.15,16.95
彰化縣,花壇鄉,合計,14490,7265,7225,170,14660,38651,45018,37.93,18.8
彰化縣,芬園鄉,舊社村,587,283,304,9,596,1743,0,34.19,16.24
彰化縣,芬園鄉,大埔村,471,222,249,5,476,1387,0,34.32,16.01
彰化縣,芬園鄉,竹林村,677,336,341,7,684,1754,0,39.0,19.16
彰化縣,芬園鄉,社口村,858,395,463,13,871,2452,0,35.52,16.11
彰化縣,芬園鄉,茄荖村,892,380,512,10,902,2344,0,38.48,16.21
彰化縣,芬園鄉,嘉興村,660,356,304,7,667,1622,0,41.12,21.95
彰化縣,芬園鄉,芬園村,301,130,171,3,304,877,0,34.66,14.82
彰化縣,芬園鄉,縣庄村,412,166,246,5,417,1142,0,36.51,14.54
彰化縣,芬園鄉,圳墘村,218,88,130,5,223,647,0,34.47,13.6
彰化縣,芬園鄉,溪頭村,630,263,367,6,636,1646,0,38.64,15.98
彰化縣,芬園鄉,進芬村,346,169,177,3,349,965,0,36.17,17.51
彰化縣,芬園鄉,同安村,382,143,239,7,389,1139,0,34.15,12.55
彰化縣,芬園鄉,中崙村,256,101,155,7,263,854,0,30.8,11.83
彰化縣,芬園鄉,大竹村,324,105,219,5,329,966,0,34.06,10.87
彰化縣,芬園鄉,楓坑村,201,101,100,5,206,576,0,35.76,17.53
彰化縣,芬園鄉,合計,7215,3238,3977,97,7312,20114,22927,36.35,16.1
彰化縣,員林市,東和里,409,228,181,5,414,1051,0,39.39,21.69
彰化縣,員林市,民生里,1081,547,534,10,1091,2683,0,40.66,20.39
彰化縣,員林市,中正里,1305,677,628,11,1316,3068,0,42.89,22.07
彰化縣,員林市,仁美里,1096,555,541,11,1107,2540,0,43.58,21.85
彰化縣,員林市,新興里,336,152,184,3,339,695,0,48.78,21.87
彰化縣,員林市,和平里,1104,555,549,9,1113,2785,0,39.96,19.93
彰化縣,員林市,光明里,349,173,176,2,351,754,0,46.55,22.94
彰化縣,員林市,中山里,287,136,151,1,288,571,0,50.44,23.82
彰化縣,員林市,黎明里,681,331,350,8,689,1808,0,38.11,18.31
彰化縣,員林市,惠來里,2264,1058,1206,27,2291,5571,0,41.12,18.99
彰化縣,員林市,三義里,952,496,456,10,962,2460,0,39.11,20.16
彰化縣,員林市,新生里,1747,842,905,15,1762,4122,0,42.75,20.43
彰化縣,員林市,南平里,2118,1044,1074,18,2136,5313,0,40.2,19.65
彰化縣,員林市,南興里,1824,937,887,18,1842,4646,0,39.65,20.17
彰化縣,員林市,源潭里,574,235,339,4,578,1675,0,34.51,14.03
彰化縣,員林市,大埔里,739,349,390,12,751,2088,0,35.97,16.71
彰化縣,員林市,三條里,1058,509,549,12,1070,2693,0,39.73,18.9
彰化縣,員林市,三和里,2366,1206,1160,21,2387,6107,0,39.09,19.75
彰化縣,員林市,三橋里,1187,616,571,12,1199,2880,0,41.63,21.39
彰化縣,員林市,中央里,687,301,386,13,700,1929,0,36.29,15.6
彰化縣,員林市,溝皂里,1052,497,555,15,1067,2485,0,42.94,20.0
彰化縣,員林市,大饒里,1376,686,690,11,1387,3290,0,42.16,20.85
彰化縣,員林市,大明里,893,384,509,10,903,2363,0,38.21,16.25
彰化縣,員林市,萬年里,1527,819,708,12,1539,3631,0,42.39,22.56
彰化縣,員林市,崙雅里,876,463,413,8,884,2304,0,38.37,20.1
彰化縣,員林市,振興里,1025,560,465,2,1027,2698,0,38.07,20.76
彰化縣,員林市,林厝里,967,442,525,17,984,2788,0,35.29,15.85
彰化縣,員林市,出水里,582,211,371,7,589,1640,0,35.91,12.87
彰化縣,員林市,湖水里,429,160,269,6,435,1187,0,36.65,13.48
彰化縣,員林市,大峯里,279,161,118,2,281,713,0,39.41,22.58
彰化縣,員林市,鎮興里,714,337,377,6,720,1974,0,36.47,17.07
彰化縣,員林市,浮圳里,770,366,404,10,780,2175,0,35.86,16.83
彰化縣,員林市,西東里,713,285,428,10,723,1938,0,37.31,14.71
彰化縣,員林市,南東里,611,284,327,3,614,1738,0,35.33,16.34
彰化縣,員林市,中東里,606,314,292,7,613,1748,0,35.07,17.96
彰化縣,員林市,東北里,834,401,433,9,843,2262,0,37.27,17.73
彰化縣,員林市,三愛里,1239,620,619,13,1252,2953,0,42.4,21.0
彰化縣,員林市,三信里,988,547,441,8,996,2262,0,44.03,24.18
彰化縣,員林市,三多里,1108,525,583,7,1115,2449,0,45.53,21.44
彰化縣,員林市,仁愛里,564,281,283,2,566,1328,0,42.62,21.16
彰化縣,員林市,忠孝里,819,420,399,8,827,2178,0,37.97,19.28
彰化縣,員林市,合計,40136,19710,20426,395,40531,101543,123460,39.92,19.41
彰化縣,溪湖鎮,光平里,488,215,273,5,493,1156,0,42.65,18.6
彰化縣,溪湖鎮,平和里,295,147,148,1,296,623,0,47.51,23.6
彰化縣,溪湖鎮,太平里,644,344,300,2,646,1780,0,36.29,19.33
彰化縣,溪湖鎮,光華里,174,101,73,4,178,420,0,42.38,24.05
彰化縣,溪湖鎮,東寮里,1191,643,548,8,1199,3356,0,35.73,19.16
彰化縣,溪湖鎮,西寮里,841,441,400,12,853,2176,0,39.2,20.27
彰化縣,溪湖鎮,大突里,1179,663,516,7,1186,3446,0,34.42,19.24
彰化縣,溪湖鎮,北勢里,446,182,264,9,455,1421,0,32.02,12.81
彰化縣,溪湖鎮,汴頭里,992,465,527,14,1006,3018,0,33.33,15.41
彰化縣,溪湖鎮,大竹里,903,469,434,12,915,2433,0,37.61,19.28
彰化縣,溪湖鎮,湖西里,825,425,400,8,833,2297,0,36.26,18.5
彰化縣,溪湖鎮,田中里,286,114,172,4,290,814,0,35.63,14.0
彰化縣,溪湖鎮,河東里,610,279,331,2,612,1829,0,33.46,15.25
彰化縣,溪湖鎮,中山里,756,389,367,7,763,2278,0,33.49,17.08
彰化縣,溪湖鎮,中竹里,300,124,176,0,300,817,0,36.72,15.18
彰化縣,溪湖鎮,東溪里,458,174,284,2,460,1353,0,34.0,12.86
彰化縣,溪湖鎮,西溪里,702,336,366,6,708,1836,0,38.56,18.3
彰化縣,溪湖鎮,湖東里,1597,777,820,19,1616,4595,0,35.17,16.91
彰化縣,溪湖鎮,頂庄里,206,104,102,1,207,641,0,32.29,16.22
彰化縣,溪湖鎮,忠覺里,474,256,218,4,478,1250,0,38.24,20.48
彰化縣,溪湖鎮,湳底里,236,110,126,4,240,694,0,34.58,15.85
彰化縣,溪湖鎮,大庭里,444,234,210,5,449,1362,0,32.97,17.18
彰化縣,溪湖鎮,媽厝里,386,145,241,4,390,1250,0,31.2,11.6
彰化縣,溪湖鎮,西勢里,708,296,412,6,714,2168,0,32.93,13.65
彰化縣,溪湖鎮,番婆里,566,253,313,4,570,1713,0,33.27,14.77
彰化縣,溪湖鎮,合計,15707,7686,8021,150,15857,44726,54577,35.45,17.18
彰化縣,田中鎮,香山里,269,123,146,1,270,816,0,33.09,15.07
彰化縣,田中鎮,碧峰里,366,217,149,5,371,1037,0,35.78,20.93
彰化縣,田中鎮,東源里,277,138,139,5,282,748,0,37.7,18.45
彰化縣,田中鎮,復興里,533,288,245,8,541,1496,0,36.16,19.25
彰化縣,田中鎮,平和里,522,283,239,8,530,1448,0,36.6,19.54
彰化縣,田中鎮,頂潭里,463,212,251,7,470,1226,0,38.34,17.29
彰化縣,田中鎮,中潭里,644,279,365,4,648,1756,0,36.9,15.89
彰化縣,田中鎮,龍潭里,254,103,151,2,256,580,0,44.14,17.76
彰化縣,田中鎮,北路里,1304,684,620,13,1317,3269,0,40.29,20.92
彰化縣,田中鎮,西路里,926,430,496,10,936,2363,0,39.61,18.2
彰化縣,田中鎮,東路里,404,182,222,2,406,1041,0,39.0,17.48
彰化縣,田中鎮,南路里,451,190,261,3,454,1106,0,41.05,17.18
彰化縣,田中鎮,中路里,806,408,398,7,813,1942,0,41.86,21.01
彰化縣,田中鎮,新庄里,937,461,476,6,943,2399,0,39.31,19.22
彰化縣,田中鎮,三安里,572,204,368,4,576,1560,0,36.92,13.08
彰化縣,田中鎮,大崙里,443,209,234,5,448,1292,0,34.67,16.18
彰化縣,田中鎮,沙崙里,628,325,303,14,642,1814,0,35.39,17.92
彰化縣,田中鎮,新民里,1528,743,785,16,1544,4178,0,36.96,17.78
彰化縣,田中鎮,梅州里,432,189,243,11,443,1271,0,34.85,14.87
彰化縣,田中鎮,三民里,514,263,251,4,518,1561,0,33.18,16.85
彰化縣,田中鎮,三光里,324,137,187,5,329,913,0,36.04,15.01
彰化縣,田中鎮,大社里,326,129,197,5,331,866,0,38.22,14.9
彰化縣,田中鎮,合計,12923,6197,6726,145,13068,34682,40379,37.68,17.87
彰化縣,大村鄉,大村村,1258,619,639,12,1270,3428,0,37.05,18.06
彰化縣,大村鄉,茄苳村,583,274,309,1,584,1546,0,37.77,17.72
彰化縣,大村鄉,南勢村,524,229,295,4,528,1493,0,35.37,15.34
彰化縣,大村鄉,田洋村,434,221,213,6,440,1209,0,36.39,18.28
彰化縣,大村鄉,新興村,381,149,232,7,388,1172,0,33.11,12.71
彰化縣,大村鄉,過溝村,1585,814,771,17,1602,4186,0,38.27,19.45
彰化縣,大村鄉,美港村,755,378,377,8,763,2092,0,36.47,18.07
彰化縣,大村鄉,平和村,862,397,465,13,875,2569,0,34.06,15.45
彰化縣,大村鄉,貢旗村,577,268,309,7,584,1569,0,37.22,17.08
彰化縣,大村鄉,加錫村,533,242,291,8,541,1528,0,35.41,15.84
彰化縣,大村鄉,村上村,544,268,276,2,546,1420,0,38.45,18.87
彰化縣,大村鄉,大橋村,700,359,341,7,707,2033,0,34.78,17.66
彰化縣,大村鄉,大崙村,559,241,318,5,564,1624,0,34.73,14.84
彰化縣,大村鄉,擺塘村,973,450,523,11,984,2635,0,37.34,17.08
彰化縣,大村鄉,黃厝村,788,349,439,7,795,2428,0,32.74,14.37
彰化縣,大村鄉,福興村,756,300,456,8,764,2179,0,35.06,13.77
彰化縣,大村鄉,合計,11812,5558,6254,123,11935,33111,39085,36.05,16.79
彰化縣,埔鹽鄉,埔鹽村,668,350,318,10,678,1664,0,40.75,21.03
彰化縣,埔鹽鄉,埔南村,549,280,269,4,553,1536,0,36.0,18.23
彰化縣,埔鹽鄉,廍子村,452,257,195,7,459,1251,0,36.69,20.54
彰化縣,埔鹽鄉,出水村,334,191,143,7,341,889,0,38.36,21.48
彰化縣,埔鹽鄉,南港村,608,326,282,4,612,1750,0,34.97,18.63
彰化縣,埔鹽鄉,打廉村,329,152,177,5,334,939,0,35.57,16.19
彰化縣,埔鹽鄉,豐澤村,450,213,237,7,457,1306,0,34.99,16.31
彰化縣,埔鹽鄉,崑崙村,384,194,190,3,387,1086,0,35.64,17.86
彰化縣,埔鹽鄉,角樹村,273,161,112,3,276,656,0,42.07,24.54
彰化縣,埔鹽鄉,瓦磘村,420,208,212,6,426,1199,0,35.53,17.35
彰化縣,埔鹽鄉,好修村,555,305,250,3,558,1781,0,31.33,17.13
彰化縣,埔鹽鄉,西湖村,640,340,300,6,646,2059,0,31.37,16.51
彰化縣,埔鹽鄉,大有村,394,183,211,6,400,1194,0,33.5,15.33
彰化縣,埔鹽鄉,新興村,185,113,72,3,188,456,0,41.23,24.78
彰化縣,埔鹽鄉,永平村,375,210,165,4,379,1101,0,34.42,19.07
彰化縣,埔鹽鄉,永樂村,308,155,153,8,316,848,0,37.26,18.28
彰化縣,埔鹽鄉,石埤村,392,183,209,7,399,1437,0,27.77,12.73
彰化縣,埔鹽鄉,天盛村,255,154,101,5,260,838,0,31.03,18.38
彰化縣,埔鹽鄉,太平村,472,261,211,10,482,1538,0,31.34,16.97
彰化縣,埔鹽鄉,新水村,507,339,168,7,514,1523,0,33.75,22.26
彰化縣,埔鹽鄉,三省村,449,243,206,7,456,1368,0,33.33,17.76
彰化縣,埔鹽鄉,南新村,448,284,164,3,451,1314,0,34.32,21.61
彰化縣,埔鹽鄉,合計,9447,5102,4345,125,9572,27733,31833,34.51,18.4
彰化縣,埔心鄉,東門村,1363,619,744,9,1372,3555,0,38.59,17.41
彰化縣,埔心鄉,埔心村,462,184,278,5,467,1250,0,37.36,14.72
彰化縣,埔心鄉,義民村,615,310,305,3,618,1556,0,39.72,19.92
彰化縣,埔心鄉,油車村,447,224,223,8,455,1258,0,36.17,17.81
彰化縣,埔心鄉,瓦北村,658,259,399,3,661,1740,0,37.99,14.89
彰化縣,埔心鄉,瓦中村,766,329,437,6,772,1976,0,39.07,16.65
彰化縣,埔心鄉,瓦南村,560,229,331,6,566,1422,0,39.8,16.1
彰化縣,埔心鄉,太平村,658,298,360,3,661,1976,0,33.45,15.08
彰化縣,埔心鄉,經口村,885,373,512,14,899,2348,0,38.29,15.89
彰化縣,埔心鄉,大華村,227,95,132,2,229,658,0,34.8,14.44
彰化縣,埔心鄉,仁里村,435,195,240,8,443,1265,0,35.02,15.42
彰化縣,埔心鄉,舊舘村,574,248,326,3,577,1491,0,38.7,16.63
彰化縣,埔心鄉,南舘村,363,145,218,7,370,1065,0,34.74,13.62
彰化縣,埔心鄉,新舘村,337,159,178,4,341,963,0,35.41,16.51
彰化縣,埔心鄉,羅厝村,433,154,279,1,434,1305,0,33.26,11.8
彰化縣,埔心鄉,芎蕉村,664,256,408,7,671,1842,0,36.43,13.9
彰化縣,埔心鄉,二重村,521,212,309,10,531,1436,0,36.98,14.76
彰化縣,埔心鄉,梧鳳村,317,135,182,5,322,893,0,36.06,15.12
彰化縣,埔心鄉,埤霞村,251,116,135,1,252,736,0,34.24,15.76
彰化縣,埔心鄉,埤脚村,319,173,146,10,329,916,0,35.92,18.89
彰化縣,埔心鄉,合計,10855,4713,6142,115,10970,29651,34223,37.0,15.89
彰化縣,永靖鄉,永東村,326,180,146,3,329,761,0,43.23,23.65
彰化縣,永靖鄉,永西村,605,271,334,1,606,1503,0,40.32,18.03
彰化縣,永靖鄉,永南村,730,359,371,8,738,1800,0,41.0,19.94
彰化縣,永靖鄉,永北村,783,371,412,6,789,2147,0,36.75,17.28
彰化縣,永靖鄉,港西村,661,294,367,7,668,1704,0,39.2,17.25
彰化縣,永靖鄉,五福村,534,255,279,6,540,1438,0,37.55,17.73
彰化縣,永靖鄉,湳港村,380,118,262,8,388,1059,0,36.64,11.14
彰化縣,永靖鄉,新莊村,354,203,151,7,361,1065,0,33.9,19.06
彰化縣,永靖鄉,瑚璉村,974,470,504,15,989,2670,0,37.04,17.6
彰化縣,永靖鄉,五汴村,562,198,364,9,571,1368,0,41.74,14.47
彰化縣,永靖鄉,浮圳村,364,166,198,1,365,1220,0,29.92,13.61
彰化縣,永靖鄉,光雲村,552,224,328,9,561,1624,0,34.54,13.79
彰化縣,永靖鄉,東寧村,669,299,370,6,675,1908,0,35.38,15.67
彰化縣,永靖鄉,永興村,607,308,299,9,616,1558,0,39.54,19.77
彰化縣,永靖鄉,崙子村,514,230,284,7,521,1400,0,37.21,16.43
彰化縣,永靖鄉,獨鰲村,260,129,131,2,262,825,0,31.76,15.64
彰化縣,永靖鄉,敦厚村,246,112,134,0,246,710,0,34.65,15.77
彰化縣,永靖鄉,崙美村,305,111,194,4,309,736,0,41.98,15.08
彰化縣,永靖鄉,同安村,253,105,148,3,256,654,0,39.14,16.06
彰化縣,永靖鄉,同仁村,310,148,162,5,315,847,0,37.19,17.47
彰化縣,永靖鄉,湳墘村,293,136,157,6,299,809,0,36.96,16.81
彰化縣,永靖鄉,四芳村,241,130,111,5,246,637,0,38.62,20.41
彰化縣,永靖鄉,福興村,356,188,168,3,359,1075,0,33.4,17.49
彰化縣,永靖鄉,竹子村,504,163,341,6,510,1290,0,39.53,12.64
彰化縣,永靖鄉,合計,11383,5168,6215,136,11519,30808,36061,37.39,16.77
彰化縣,社頭鄉,社頭村,1039,421,618,5,1044,2749,0,37.98,15.31
彰化縣,社頭鄉,東興村,504,244,260,7,511,1460,0,35.0,16.71
彰化縣,社頭鄉,山湖村,426,154,272,3,429,1121,0,38.27,13.74
彰化縣,社頭鄉,廣興村,1575,648,927,15,1590,4439,0,35.82,14.6
彰化縣,社頭鄉,廣福村,343,138,205,4,347,914,0,37.96,15.1
彰化縣,社頭鄉,朝興村,424,193,231,5,429,1096,0,39.14,17.61
彰化縣,社頭鄉,仁雅村,1042,500,542,10,1052,2717,0,38.72,18.4
彰化縣,社頭鄉,橋頭村,761,328,433,9,770,2068,0,37.23,15.86
彰化縣,社頭鄉,仁和村,234,119,115,4,238,754,0,31.56,15.78
彰化縣,社頭鄉,崙雅村,335,162,173,4,339,905,0,37.46,17.9
彰化縣,社頭鄉,湳底村,565,227,338,9,574,1712,0,33.53,13.26
彰化縣,社頭鄉,泰安村,298,156,142,6,304,968,0,31.4,16.12
彰化縣,社頭鄉,美雅村,459,207,252,5,464,1252,0,37.06,16.53
彰化縣,社頭鄉,新厝村,545,240,305,6,551,1401,0,39.33,17.13
彰化縣,社頭鄉,平和村,360,167,193,2,362,961,0,37.67,17.38
彰化縣,社頭鄉,里仁村,376,187,189,3,379,980,0,38.67,19.08
彰化縣,社頭鄉,張厝村,458,207,251,13,471,1204,0,39.12,17.19
彰化縣,社頭鄉,龍井村,271,103,168,1,272,806,0,33.75,12.78
彰化縣,社頭鄉,舊社村,627,267,360,7,634,1581,0,40.1,16.89
彰化縣,社頭鄉,埤斗村,337,125,212,6,343,977,0,35.11,12.79
彰化縣,社頭鄉,湳雅村,512,201,311,4,516,1487,0,34.7,13.52
彰化縣,社頭鄉,松竹村,380,155,225,4,384,1028,0,37.35,15.08
彰化縣,社頭鄉,清水村,418,223,195,7,425,1260,0,33.73,17.7
彰化縣,社頭鄉,協和村,740,308,432,8,748,2148,0,34.82,14.34
彰化縣,社頭鄉,合計,13029,5680,7349,147,13176,35988,42279,36.61,15.78
彰化縣,二水鄉,合和村,311,143,168,0,311,821,0,37.88,17.42
彰化縣,二水鄉,上豊村,371,148,223,7,378,916,0,41.27,16.16
彰化縣,二水鄉,過圳村,238,115,123,3,241,610,0,39.51,18.85
彰化縣,二水鄉,五伯村,254,122,132,1,255,609,0,41.87,20.03
彰化縣,二水鄉,光化村,378,177,201,3,381,883,0,43.15,20.05
彰化縣,二水鄉,文化村,363,185,178,3,366,933,0,39.23,19.83
彰化縣,二水鄉,二水村,317,143,174,6,323,776,0,41.62,18.43
彰化縣,二水鄉,聖化村,194,117,77,6,200,438,0,45.66,26.71
彰化縣,二水鄉,裕民村,369,171,198,3,372,996,0,37.35,17.17
彰化縣,二水鄉,惠民村,336,142,194,4,340,801,0,42.45,17.73
彰化縣,二水鄉,大園村,265,94,171,2,267,776,0,34.41,12.11
彰化縣,二水鄉,修仁村,288,153,135,3,291,779,0,37.36,19.64
彰化縣,二水鄉,合興村,264,102,162,4,268,665,0,40.3,15.34
彰化縣,二水鄉,源泉村,233,117,116,6,239,597,0,40.03,19.6
彰化縣,二水鄉,倡和村,218,110,108,1,219,562,0,38.97,19.57
彰化縣,二水鄉,復興村,375,152,223,12,387,1000,0,38.7,15.2
彰化縣,二水鄉,十五村,266,111,155,5,271,665,0,40.75,16.69
彰化縣,二水鄉,合計,5040,2302,2738,69,5109,12827,14488,39.83,17.95
彰化縣,北斗鎮,光復里,684,325,359,3,687,1771,0,38.79,18.35
彰化縣,北斗鎮,新政里,300,156,144,4,304,770,0,39.48,20.26
彰化縣,北斗鎮,重慶里,227,80,147,0,227,535,0,42.43,14.95
彰化縣,北斗鎮,五權里,278,126,152,4,282,656,0,42.99,19.21
彰化縣,北斗鎮,七星里,521,217,304,3,524,1406,0,37.27,15.43
彰化縣,北斗鎮,居仁里,536,313,223,4,540,1257,0,42.96,24.9
彰化縣,北斗鎮,東光里,829,362,467,6,835,2278,0,36.65,15.89
彰化縣,北斗鎮,文昌里,1121,548,573,12,1133,3114,0,36.38,17.6
彰化縣,北斗鎮,中和里,411,184,227,4,415,1307,0,31.75,14.08
彰化縣,北斗鎮,西德里,1740,822,918,18,1758,4588,0,38.32,17.92
彰化縣,北斗鎮,西安里,551,279,272,5,556,1694,0,32.82,16.47
彰化縣,北斗鎮,中寮里,949,404,545,9,958,2702,0,35.46,14.95
彰化縣,北斗鎮,大道里,704,278,426,4,708,1904,0,37.18,14.6
彰化縣,北斗鎮,新生里,591,293,298,7,598,2028,0,29.49,14.45
彰化縣,北斗鎮,大新里,589,308,281,8,597,1791,0,33.33,17.2
彰化縣,北斗鎮,合計,10031,4695,5336,91,10122,27801,33351,36.41,16.89
彰化縣,二林鎮,東和里,675,311,364,8,683,2094,0,32.62,14.85
彰化縣,二林鎮,南光里,1113,636,477,14,1127,3227,0,34.92,19.71
彰化縣,二林鎮,西平里,485,250,235,4,489,1498,0,32.64,16.69
彰化縣,二林鎮,北平里,949,437,512,20,969,2966,0,32.67,14.73
彰化縣,二林鎮,中西里,440,266,174,12,452,1610,0,28.07,16.52
彰化縣,二林鎮,廣興里,382,197,185,11,393,1341,0,29.31,14.69
彰化縣,二林鎮,香田里,300,129,171,2,302,1010,0,29.9,12.77
彰化縣,二林鎮,外竹里,271,147,124,4,275,976,0,28.18,15.06
彰化縣,二林鎮,興華里,390,223,167,7,397,1145,0,34.67,19.48
彰化縣,二林鎮,東興里,518,281,237,9,527,1598,0,32.98,17.58
彰化縣,二林鎮,後厝里,1118,631,487,18,1136,3312,0,34.3,19.05
彰化縣,二林鎮,豐田里,743,379,364,5,748,2497,0,29.96,15.18
彰化縣,二林鎮,頂厝里,362,196,166,10,372,1309,0,28.42,14.97
彰化縣,二林鎮,趙甲里,467,254,213,14,481,1557,0,30.89,16.31
彰化縣,二林鎮,振興里,331,168,163,8,339,1180,0,28.73,14.24
彰化縣,二林鎮,萬興里,260,138,122,5,265,770,0,34.42,17.92
彰化縣,二林鎮,永興里,504,255,249,5,509,1485,0,34.28,17.17
彰化縣,二林鎮,西庄里,352,152,200,5,357,1259,0,28.36,12.07
彰化縣,二林鎮,梅芳里,334,171,163,6,340,1071,0,31.75,15.97
彰化縣,二林鎮,華崙里,1119,668,451,20,1139,3551,0,32.08,18.81
彰化縣,二林鎮,東勢里,297,146,151,6,303,958,0,31.63,15.24
彰化縣,二林鎮,萬合里,288,170,118,11,299,1107,0,27.01,15.36
彰化縣,二林鎮,大永里,247,120,127,3,250,886,0,28.22,13.54
彰化縣,二林鎮,原斗里,484,233,251,6,490,1220,0,40.16,19.1
彰化縣,二林鎮,西斗里,337,172,165,3,340,1041,0,32.66,16.52
彰化縣,二林鎮,東華里,361,144,217,6,367,967,0,37.95,14.89
彰化縣,二林鎮,復豐里,202,91,111,4,206,704,0,29.26,12.93
彰化縣,二林鎮,合計,13329,6965,6364,226,13555,42339,49337,32.02,16.45
彰化縣,田尾鄉,田尾村,490,233,257,10,500,1279,0,39.09,18.22
彰化縣,田尾鄉,豐田村,269,139,130,4,273,793,0,34.43,17.53
彰化縣,田尾鄉,饒平村,957,503,454,11,968,2570,0,37.67,19.57
彰化縣,田尾鄉,睦宜村,358,159,199,6,364,1054,0,34.54,15.09
彰化縣,田尾鄉,福田村,281,125,156,7,288,751,0,38.35,16.64
彰化縣,田尾鄉,新興村,415,173,242,7,422,1022,0,41.29,16.93
彰化縣,田尾鄉,北鎮村,372,182,190,3,375,1202,0,31.2,15.14
彰化縣,田尾鄉,南鎮村,227,89,138,0,227,613,0,37.03,14.52
彰化縣,田尾鄉,新生村,479,198,281,8,487,1329,0,36.64,14.9
彰化縣,田尾鄉,南曾村,457,185,272,7,464,1280,0,36.25,14.45
彰化縣,田尾鄉,北曾村,579,232,347,11,590,1535,0,38.44,15.11
彰化縣,田尾鄉,溪畔村,440,192,248,4,444,1216,0,36.51,15.79
彰化縣,田尾鄉,打簾村,668,307,361,10,678,1724,0,39.33,17.81
彰化縣,田尾鄉,柳鳳村,417,213,204,4,421,941,0,44.74,22.64
彰化縣,田尾鄉,陸豐村,297,140,157,6,303,870,0,34.83,16.09
彰化縣,田尾鄉,海豐村,455,203,252,3,458,1365,0,33.55,14.87
彰化縣,田尾鄉,仁里村,548,256,292,9,557,1594,0,34.94,16.06
彰化縣,田尾鄉,新厝村,93,41,52,1,94,258,0,36.43,15.89
彰化縣,田尾鄉,溪頂村,224,90,134,2,226,613,0,36.87,14.68
彰化縣,田尾鄉,正義村,344,166,178,2,346,875,0,39.54,18.97
彰化縣,田尾鄉,合計,8370,3826,4544,115,8485,22884,26569,37.08,16.72
彰化縣,埤頭鄉,和豊村,768,356,412,14,782,2433,0,32.14,14.63
彰化縣,埤頭鄉,興農村,578,271,307,6,584,1785,0,32.72,15.18
彰化縣,埤頭鄉,埤頭村,580,233,347,4,584,1565,0,37.32,14.89
彰化縣,埤頭鄉,豊崙村,641,381,260,15,656,2256,0,29.08,16.89
彰化縣,埤頭鄉,崙子村,411,199,212,0,411,1230,0,33.41,16.18
彰化縣,埤頭鄉,永豊村,519,223,296,12,531,1561,0,34.02,14.29
彰化縣,埤頭鄉,合興村,1176,641,535,9,1185,3254,0,36.42,19.7
彰化縣,埤頭鄉,平原村,671,343,328,15,686,2210,0,31.04,15.52
彰化縣,埤頭鄉,崙腳村,233,92,141,7,240,710,0,33.8,12.96
彰化縣,埤頭鄉,元埔村,206,87,119,0,206,558,0,36.92,15.59
彰化縣,埤頭鄉,芙朝村,491,255,236,6,497,1486,0,33.45,17.16
彰化縣,埤頭鄉,新庄村,337,102,235,4,341,1021,0,33.4,9.99
彰化縣,埤頭鄉,陸嘉村,246,91,155,4,250,807,0,30.98,11.28
彰化縣,埤頭鄉,竹圍村,355,129,226,5,360,1052,0,34.22,12.26
彰化縣,埤頭鄉,中和村,509,209,300,4,513,1457,0,35.21,14.34
彰化縣,埤頭鄉,庄內村,331,114,217,12,343,1056,0,32.48,10.8
彰化縣,埤頭鄉,大湖村,339,114,225,11,350,913,0,38.34,12.49
彰化縣,埤頭鄉,合計,8391,3840,4551,128,8519,25354,29860,33.6,15.15
彰化縣,芳苑鄉,芳苑村,248,84,164,9,257,928,0,27.69,9.05
彰化縣,芳苑鄉,芳中村,146,65,81,3,149,395,0,37.72,16.46
彰化縣,芳苑鄉,仁愛村,221,116,105,5,226,735,0,30.75,15.78
彰化縣,芳苑鄉,信義村,133,58,75,1,134,522,0,25.67,11.11
彰化縣,芳苑鄉,後寮村,229,122,107,5,234,949,0,24.66,12.86
彰化縣,芳苑鄉,三合村,671,296,375,10,681,2090,0,32.58,14.16
彰化縣,芳苑鄉,永興村,407,200,207,3,410,1329,0,30.85,15.05
彰化縣,芳苑鄉,五俊村,103,47,56,1,104,475,0,21.89,9.89
彰化縣,芳苑鄉,路上村,175,88,87,6,181,630,0,28.73,13.97
彰化縣,芳苑鄉,路平村,219,127,92,2,221,785,0,28.15,16.18
彰化縣,芳苑鄉,三成村,226,100,126,7,233,973,0,23.95,10.28
彰化縣,芳苑鄉,福榮村,181,77,104,3,184,575,0,32.0,13.39
彰化縣,芳苑鄉,頂廍村,172,74,98,2,174,557,0,31.24,13.29
彰化縣,芳苑鄉,新街村,196,68,128,6,202,769,0,26.27,8.84
彰化縣,芳苑鄉,王功村,639,193,446,11,650,2116,0,30.72,9.12
彰化縣,芳苑鄉,博愛村,245,65,180,3,248,673,0,36.85,9.66
彰化縣,芳苑鄉,和平村,211,88,123,4,215,727,0,29.57,12.1
彰化縣,芳苑鄉,民生村,213,68,145,3,216,665,0,32.48,10.23
彰化縣,芳苑鄉,興仁村,375,115,260,4,379,1278,0,29.66,9.0
彰化縣,芳苑鄉,新寶村,488,179,309,7,495,1656,0,29.89,10.81
彰化縣,芳苑鄉,草湖村,450,219,231,0,450,1420,0,31.69,15.42
彰化縣,芳苑鄉,文津村,235,114,121,2,237,1062,0,22.32,10.73
彰化縣,芳苑鄉,建平村,589,259,330,3,592,2059,0,28.75,12.58
彰化縣,芳苑鄉,崙腳村,214,109,105,8,222,762,0,29.13,14.3
彰化縣,芳苑鄉,新生村,328,142,186,11,339,1304,0,26.0,10.89
彰化縣,芳苑鄉,漢寶村,955,430,525,10,965,3159,0,30.55,13.61
彰化縣,芳苑鄉,合計,8269,3503,4766,129,8398,28593,32372,29.37,12.25
彰化縣,大城鄉,潭墘村,313,127,186,5,318,1065,0,29.86,11.92
彰化縣,大城鄉,上山村,314,183,131,7,321,1069,0,30.03,17.12
彰化縣,大城鄉,東城村,377,204,173,6,383,1296,0,29.55,15.74
彰化縣,大城鄉,西城村,221,124,97,5,226,798,0,28.32,15.54
彰化縣,大城鄉,大城村,337,189,148,4,341,929,0,36.71,20.34
彰化縣,大城鄉,菜寮村,227,139,88,4,231,1048,0,22.04,13.26
彰化縣,大城鄉,山腳村,314,160,154,4,318,1256,0,25.32,12.74
彰化縣,大城鄉,永和村,164,94,70,5,169,662,0,25.53,14.2
彰化縣,大城鄉,頂庄村,182,92,90,1,183,663,0,27.6,13.88
彰化縣,大城鄉,公館村,303,181,122,7,310,1045,0,29.67,17.32
彰化縣,大城鄉,臺西村,222,114,108,8,230,861,0,26.71,13.24
彰化縣,大城鄉,東港村,274,168,106,4,278,1164,0,23.88,14.43
彰化縣,大城鄉,西港村,239,152,87,5,244,867,0,28.14,17.53
彰化縣,大城鄉,豐美村,215,86,129,5,220,845,0,26.04,10.18
彰化縣,大城鄉,三豐村,110,63,47,5,115,626,0,18.37,10.06
彰化縣,大城鄉,合計,3812,2076,1736,75,3887,14194,15893,27.38,14.63
彰化縣,竹塘鄉,竹元村,384,195,189,6,390,1148,0,33.97,16.99
彰化縣,竹塘鄉,竹塘村,646,339,307,2,648,1936,0,33.47,17.51
彰化縣,竹塘鄉,小西村,228,113,115,9,237,699,0,33.91,16.17
彰化縣,竹塘鄉,民靖村,220,119,101,1,221,753,0,29.35,15.8
彰化縣,竹塘鄉,五庄村,463,147,316,8,471,1527,0,30.84,9.63
彰化縣,竹塘鄉,樹腳村,207,69,138,4,211,641,0,32.92,10.76
彰化縣,竹塘鄉,田頭村,326,145,181,2,328,1052,0,31.18,13.78
彰化縣,竹塘鄉,新廣村,349,136,213,3,352,1083,0,32.5,12.56
彰化縣,竹塘鄉,溪墘村,172,63,109,2,174,471,0,36.94,13.38
彰化縣,竹塘鄉,竹林村,237,108,129,1,238,785,0,30.32,13.76
彰化縣,竹塘鄉,土庫村,218,91,127,2,220,626,0,35.14,14.54
彰化縣,竹塘鄉,內新村,186,51,135,3,189,536,0,35.26,9.51
彰化縣,竹塘鄉,長安村,248,80,168,3,251,750,0,33.47,10.67
彰化縣,竹塘鄉,永安村,145,43,102,3,148,536,0,27.61,8.02
彰化縣,竹塘鄉,合計,4029,1699,2330,49,4078,12543,14669,32.51,13.55
彰化縣,溪州鄉,溪厝村,598,237,361,6,604,1828,0,33.04,12.96
彰化縣,溪州鄉,舊眉村,493,197,296,11,504,1430,0,35.24,13.78
彰化縣,溪州鄉,柑園村,298,154,144,4,302,1131,0,26.7,13.62
彰化縣,溪州鄉,水尾村,490,121,369,4,494,1499,0,32.96,8.07
彰化縣,溪州鄉,坑厝村,246,86,160,7,253,699,0,36.19,12.3
彰化縣,溪州鄉,圳寮村,464,197,267,5,469,1461,0,32.1,13.48
彰化縣,溪州鄉,潮洋村,250,109,141,4,254,813,0,31.24,13.41
彰化縣,溪州鄉,瓦厝村,364,121,243,0,364,839,0,43.38,14.42
彰化縣,溪州鄉,西畔村,574,212,362,11,585,1977,0,29.59,10.72
彰化縣,溪州鄉,張厝村,194,65,129,7,201,693,0,29.0,9.38
彰化縣,溪州鄉,溪州村,584,261,323,8,592,1516,0,39.05,17.22
彰化縣,溪州鄉,成功村,510,211,299,4,514,1799,0,28.57,11.73
彰化縣,溪州鄉,菜公村,252,98,154,5,257,831,0,30.93,11.79
彰化縣,溪州鄉,尾厝村,663,298,365,6,669,1827,0,36.62,16.31
彰化縣,溪州鄉,大庄村,546,169,377,13,559,1863,0,30.01,9.07
彰化縣,溪州鄉,三圳村,436,179,257,10,446,1255,0,35.54,14.26
彰化縣,溪州鄉,東州村,716,297,419,9,725,1915,0,37.86,15.51
彰化縣,溪州鄉,榮光村,282,147,135,5,287,850,0,33.76,17.29
彰化縣,溪州鄉,三條村,328,67,261,3,331,846,0,39.13,7.92
彰化縣,溪州鄉,合計,8288,3226,5062,122,8410,25072,28983,33.54,12.87
彰化縣,合計,合計,390290,184623,205667,4265,394555,1061571,1260388,37.17,17.39
南投縣,南投市,龍泉里,379,183,196,2,381,910,0,41.87,20.11
南投縣,南投市,康壽里,638,322,316,3,641,1370,0,46.79,23.5
南投縣,南投市,三民里,331,166,165,2,333,772,0,43.13,21.5
南投縣,南投市,仁和里,259,101,158,1,260,486,0,53.5,20.78
南投縣,南投市,南投里,262,116,146,1,263,574,0,45.82,20.21
南投縣,南投市,彰仁里,193,79,114,3,196,366,0,53.55,21.58
南投縣,南投市,崇文里,424,217,207,4,428,933,0,45.87,23.26
南投縣,南投市,漳興里,1091,529,562,6,1097,2566,0,42.75,20.62
南投縣,南投市,漳和里,2823,1516,1307,28,2851,7006,0,40.69,21.64
南投縣,南投市,軍功里,1711,907,804,14,1725,4577,0,37.69,19.82
南投縣,南投市,東山里,146,67,79,4,150,376,0,39.89,17.82
南投縣,南投市,平和里,2435,1312,1123,21,2456,6024,0,40.77,21.78
南投縣,南投市,振興里,851,362,489,10,861,2053,0,41.94,17.63
南投縣,南投市,千秋里,403,187,216,6,409,1008,0,40.58,18.55
南投縣,南投市,三興里,2209,1253,956,25,2234,5330,0,41.91,23.51
南投縣,南投市,三和里,1245,674,571,14,1259,2691,0,46.79,25.05
南投縣,南投市,嘉興里,794,319,475,5,799,2109,0,37.89,15.13
南投縣,南投市,嘉和里,1665,871,794,20,1685,4405,0,38.25,19.77
南投縣,南投市,福山里,675,346,329,10,685,1866,0,36.71,18.54
南投縣,南投市,永興里,254,116,138,7,261,779,0,33.5,14.89
南投縣,南投市,鳳鳴里,197,60,137,5,202,606,0,33.33,9.9
南投縣,南投市,鳳山里,340,114,226,5,345,1073,0,32.15,10.62
南投縣,南投市,平山里,2035,1057,978,17,2052,5387,0,38.09,19.62
南投縣,南投市,新興里,1779,923,856,16,1795,4997,0,35.92,18.47
南投縣,南投市,永豐里,1100,554,546,4,1104,2815,0,39.22,19.68
南投縣,南投市,福興里,1136,544,592,6,1142,3015,0,37.88,18.04
南投縣,南投市,營北里,3080,2086,994,25,3105,5877,0,52.83,35.49
南投縣,南投市,營南里,1076,629,447,8,1084,2381,0,45.53,26.42
南投縣,南投市,內興里,2958,1862,1096,25,2983,6642,0,44.91,28.03
南投縣,南投市,內新里,565,283,282,9,574,1402,0,40.94,20.19
南投縣,南投市,光華里,362,283,79,1,363,738,0,49.19,38.35
南投縣,南投市,光榮里,503,412,91,6,509,993,0,51.26,41.49
南投縣,南投市,光明里,470,390,80,0,470,908,0,51.76,42.95
南投縣,南投市,光輝里,286,178,108,4,290,514,0,56.42,34.63
南投縣,南投市,合計,34675,19018,15657,317,34992,83549,98736,41.88,22.76
南投縣,埔里鎮,東門里,1094,593,501,11,1105,2573,0,42.95,23.05
南投縣,埔里鎮,南門里,406,203,203,2,408,785,0,51.97,25.86
南投縣,埔里鎮,西門里,1102,596,506,6,1108,2927,0,37.85,20.36
南投縣,埔里鎮,北門里,831,497,334,8,839,2457,0,34.15,20.23
南投縣,埔里鎮,同聲里,800,444,356,17,817,2163,0,37.77,20.53
南投縣,埔里鎮,薰化里,474,268,206,1,475,997,0,47.64,26.88
南投縣,埔里鎮,清新里,1264,731,533,12,1276,3608,0,35.37,20.26
南投縣,埔里鎮,大城里,2122,1206,916,26,2148,5729,0,37.49,21.05
南投縣,埔里鎮,籃城里,400,177,223,4,404,931,0,43.39,19.01
南投縣,埔里鎮,枇杷里,2602,1556,1046,35,2637,7501,0,35.16,20.74
南投縣,埔里鎮,水頭里,1121,597,524,11,1132,3785,0,29.91,15.77
南投縣,埔里鎮,麒麟里,326,153,173,3,329,1019,0,32.29,15.01
南投縣,埔里鎮,珠格里,372,189,183,9,381,1106,0,34.45,17.09
南投縣,埔里鎮,溪南里,392,220,172,7,399,1116,0,35.75,19.71
南投縣,埔里鎮,桃米里,351,202,149,5,356,1007,0,35.35,20.06
南投縣,埔里鎮,成功里,111,59,52,0,111,298,0,37.25,19.8
南投縣,埔里鎮,南村里,411,228,183,4,415,1324,0,31.34,17.22
南投縣,埔里鎮,愛蘭里,491,290,201,5,496,1412,0,35.13,20.54
南投縣,埔里鎮,鐵山里,602,330,272,9,611,1701,0,35.92,19.4
南投縣,埔里鎮,房里里,457,265,192,2,459,1348,0,34.05,19.66
南投縣,埔里鎮,向善里,260,134,126,5,265,661,0,40.09,20.27
南投縣,埔里鎮,一新里,393,253,140,5,398,988,0,40.28,25.61
南投縣,埔里鎮,廣成里,362,198,164,4,366,1132,0,32.33,17.49
南投縣,埔里鎮,史港里,220,135,85,2,222,580,0,38.28,23.28
南投縣,埔里鎮,福興里,334,135,199,5,339,962,0,35.24,14.03
南投縣,埔里鎮,牛眠里,1008,477,531,11,1019,2818,0,36.16,16.93
南投縣,埔里鎮,大湳里,618,314,304,5,623,1661,0,37.51,18.9
南投縣,埔里鎮,蜈蚣里,866,469,397,9,875,2570,0,34.05,18.25
南投縣,埔里鎮,合成里,573,247,326,6,579,1597,0,36.26,15.47
南投縣,埔里鎮,北安里,1296,744,552,18,1314,3098,0,42.41,24.02
南投縣,埔里鎮,杷城里,1005,549,456,9,1014,2585,0,39.23,21.24
南投縣,埔里鎮,北梅里,1115,657,458,16,1131,3170,0,35.68,20.73
南投縣,埔里鎮,泰安里,855,505,350,9,864,2070,0,41.74,24.4
南投縣,埔里鎮,合計,24634,13621,11013,281,24915,67679,78732,36.81,20.13
南投縣,草屯鎮,玉峰里,902,499,403,9,911,2084,0,43.71,23.94
南投縣,草屯鎮,炎峰里,922,484,438,6,928,2059,0,45.07,23.51
南投縣,草屯鎮,和平里,505,244,261,7,512,1084,0,47.23,22.51
南投縣,草屯鎮,敦和里,2495,1342,1153,19,2514,6414,0,39.2,20.92
南投縣,草屯鎮,山腳里,3345,1975,1370,22,3367,7515,0,44.8,26.28
南投縣,草屯鎮,富寮里,2533,1257,1276,20,2553,6652,0,38.38,18.9
南投縣,草屯鎮,御史里,2393,1179,1214,22,2415,6108,0,39.54,19.3
南投縣,草屯鎮,新豐里,1592,793,799,27,1619,4032,0,40.15,19.67
南投縣,草屯鎮,碧峰里,1673,805,868,20,1693,4524,0,37.42,17.79
南投縣,草屯鎮,碧洲里,1039,594,445,10,1049,2446,0,42.89,24.28
南投縣,草屯鎮,復興里,1215,607,608,7,1222,2862,0,42.7,21.21
南投縣,草屯鎮,上林里,1428,800,628,8,1436,3175,0,45.23,25.2
南投縣,草屯鎮,新庄里,1449,773,676,10,1459,3702,0,39.41,20.88
南投縣,草屯鎮,北投里,1180,491,689,19,1199,2951,0,40.63,16.64
南投縣,草屯鎮,石川里,582,233,349,4,586,1502,0,39.01,15.51
南投縣,草屯鎮,加老里,941,398,543,3,944,2217,0,42.58,17.95
南投縣,草屯鎮,北勢里,727,329,398,8,735,1858,0,39.56,17.71
南投縣,草屯鎮,中原里,895,350,545,9,904,2029,0,44.55,17.25
南投縣,草屯鎮,南埔里,1555,712,843,5,1560,4072,0,38.31,17.49
南投縣,草屯鎮,土城里,596,342,254,8,604,1658,0,36.43,20.63
南投縣,草屯鎮,坪頂里,396,197,199,3,399,1017,0,39.23,19.37
南投縣,草屯鎮,雙冬里,691,338,353,14,705,2247,0,31.38,15.04
南投縣,草屯鎮,平林里,408,215,193,3,411,1070,0,38.41,20.09
南投縣,草屯鎮,中正里,309,161,148,3,312,664,0,46.99,24.25
南投縣,草屯鎮,中山里,1094,527,567,10,1104,2330,0,47.38,22.62
南投縣,草屯鎮,明正里,1558,832,726,13,1571,3714,0,42.3,22.4
南投縣,草屯鎮,新厝里,1429,833,596,10,1439,3215,0,44.76,25.91
南投縣,草屯鎮,合計,33852,17310,16542,299,34151,83201,97262,41.05,20.81
南投縣,竹山鎮,竹山里,846,431,415,10,856,1957,0,43.74,22.02
南投縣,竹山鎮,中正里,230,112,118,3,233,614,0,37.95,18.24
南投縣,竹山鎮,中山里,1678,836,842,22,1700,4553,0,37.34,18.36
南投縣,竹山鎮,雲林里,1331,703,628,9,1340,3463,0,38.69,20.3
南投縣,竹山鎮,硘磘里,643,313,330,9,652,1752,0,37.21,17.87
南投縣,竹山鎮,下坪里,459,239,220,13,472,1189,0,39.7,20.1
南投縣,竹山鎮,桂林里,1268,623,645,18,1286,3652,0,35.21,17.06
南投縣,竹山鎮,中和里,326,97,229,3,329,894,0,36.8,10.85
南投縣,竹山鎮,中崎里,449,225,224,6,455,1401,0,32.48,16.06
南投縣,竹山鎮,德興里,332,163,169,7,339,878,0,38.61,18.56
南投縣,竹山鎮,延平里,954,414,540,15,969,2802,0,34.58,14.78
南投縣,竹山鎮,延正里,534,247,287,9,543,1678,0,32.36,14.72
南投縣,竹山鎮,延山里,316,148,168,4,320,839,0,38.14,17.64
南投縣,竹山鎮,延和里,1714,830,884,18,1732,4860,0,35.64,17.08
南投縣,竹山鎮,山崇里,597,271,326,4,601,1818,0,33.06,14.91
南投縣,竹山鎮,社寮里,469,219,250,9,478,1312,0,36.43,16.69
南投縣,竹山鎮,中央里,380,179,201,4,384,1132,0,33.92,15.81
南投縣,竹山鎮,富州里,232,120,112,3,235,595,0,39.5,20.17
南投縣,竹山鎮,大鞍里,131,75,56,1,132,422,0,31.28,17.77
南投縣,竹山鎮,田子里,182,87,95,1,183,577,0,31.72,15.08
南投縣,竹山鎮,福興里,221,137,84,2,223,591,0,37.73,23.18
南投縣,竹山鎮,鯉魚里,214,109,105,2,216,733,0,29.47,14.87
南投縣,竹山鎮,瑞竹里,179,89,90,1,180,562,0,32.03,15.84
南投縣,竹山鎮,坪頂里,162,82,80,0,162,446,0,36.32,18.39
南投縣,竹山鎮,桶頭里,224,99,125,9,233,865,0,26.94,11.45
南投縣,竹山鎮,秀林里,264,121,143,2,266,674,0,39.47,17.95
南投縣,竹山鎮,延祥里,1323,645,678,8,1331,3551,0,37.48,18.16
南投縣,竹山鎮,竹圍里,828,425,403,11,839,2248,0,37.32,18.91
南投縣,竹山鎮,合計,16486,8039,8447,203,16689,46058,53033,36.23,17.45
南投縣,集集鎮,集集里,445,262,183,8,453,1076,0,42.1,24.35
南投縣,集集鎮,和平里,330,177,153,7,337,872,0,38.65,20.3
南投縣,集集鎮,林尾里,197,89,108,2,199,549,0,36.25,16.21
南投縣,集集鎮,田寮里,386,184,202,6,392,1141,0,34.36,16.13
南投縣,集集鎮,隘寮里,163,71,92,1,164,463,0,35.42,15.33
南投縣,集集鎮,玉映里,174,91,83,0,174,472,0,36.86,19.28
南投縣,集集鎮,吳厝里,340,198,142,6,346,877,0,39.45,22.58
南投縣,集集鎮,八張里,518,270,248,7,525,1415,0,37.1,19.08
南投縣,集集鎮,永昌里,350,163,187,7,357,943,0,37.86,17.29
南投縣,集集鎮,富山里,191,103,88,3,194,544,0,35.66,18.93
南投縣,集集鎮,廣明里,294,174,120,3,297,889,0,33.41,19.57
南投縣,集集鎮,合計,3388,1782,1606,50,3438,9241,10350,37.2,19.28
南投縣,名間鄉,南雅村,420,207,213,3,423,1008,0,41.96,20.54
南投縣,名間鄉,中正村,1320,621,699,14,1334,3391,0,39.34,18.31
南投縣,名間鄉,中山村,766,369,397,9,775,2202,0,35.2,16.76
南投縣,名間鄉,濁水村,609,282,327,5,614,1540,0,39.87,18.31
南投縣,名間鄉,炭寮村,319,129,190,3,322,978,0,32.92,13.19
南投縣,名間鄉,新民村,370,150,220,8,378,957,0,39.5,15.67
南投縣,名間鄉,新街村,1588,686,902,21,1609,4169,0,38.59,16.45
南投縣,名間鄉,東湖村,590,259,331,12,602,1625,0,37.05,15.94
南投縣,名間鄉,萬丹村,364,131,233,8,372,922,0,40.35,14.21
南投縣,名間鄉,田仔村,437,162,275,2,439,1233,0,35.6,13.14
南投縣,名間鄉,大庄村,706,230,476,18,724,1828,0,39.61,12.58
南投縣,名間鄉,廍下村,307,116,191,3,310,900,0,34.44,12.89
南投縣,名間鄉,大坑村,249,85,164,2,251,729,0,34.43,11.66
南投縣,名間鄉,竹圍村,341,130,211,7,348,911,0,38.2,14.27
南投縣,名間鄉,赤水村,453,183,270,7,460,1160,0,39.66,15.78
南投縣,名間鄉,三崙村,534,224,310,5,539,1538,0,35.05,14.56
南投縣,名間鄉,松山村,569,205,364,7,576,1468,0,39.24,13.96
南投縣,名間鄉,松柏村,416,167,249,10,426,1137,0,37.47,14.69
南投縣,名間鄉,埔中村,323,137,186,5,328,845,0,38.82,16.21
南投縣,名間鄉,崁腳村,319,194,125,2,321,874,0,36.73,22.2
南投縣,名間鄉,新厝村,297,153,144,6,303,739,0,41.0,20.7
南投縣,名間鄉,新光村,607,269,338,11,618,1737,0,35.58,15.49
南投縣,名間鄉,仁和村,331,193,138,5,336,867,0,38.75,22.26
南投縣,名間鄉,合計,12235,5282,6953,173,12408,32758,37230,37.88,16.12
南投縣,鹿谷鄉,鹿谷村,655,341,314,8,663,1813,0,36.57,18.81
南投縣,鹿谷鄉,初鄉村,491,267,224,7,498,1402,0,35.52,19.04
南投縣,鹿谷鄉,彰雅村,465,278,187,5,470,1294,0,36.32,21.48
南投縣,鹿谷鄉,廣興村,681,381,300,13,694,1909,0,36.35,19.96
南投縣,鹿谷鄉,內湖村,330,182,148,6,336,997,0,33.7,18.25
南投縣,鹿谷鄉,竹林村,465,250,215,5,470,1463,0,32.13,17.09
南投縣,鹿谷鄉,竹豐村,329,207,122,4,333,902,0,36.92,22.95
南投縣,鹿谷鄉,和雅村,221,150,71,4,225,620,0,36.29,24.19
南投縣,鹿谷鄉,鳳凰村,462,208,254,4,466,1309,0,35.6,15.89
南投縣,鹿谷鄉,永隆村,547,297,250,5,552,1562,0,35.34,19.01
南投縣,鹿谷鄉,秀峰村,214,86,128,6,220,747,0,29.45,11.51
南投縣,鹿谷鄉,清水村,254,112,142,3,257,689,0,37.3,16.26
南投縣,鹿谷鄉,瑞田村,197,77,120,4,201,710,0,28.31,10.85
南投縣,鹿谷鄉,合計,5311,2836,2475,74,5385,15417,16983,34.93,18.4
南投縣,中寮鄉,廣興村,258,90,168,4,262,773,0,33.89,11.64
南投縣,中寮鄉,崁頂村,169,88,81,5,174,470,0,37.02,18.72
南投縣,中寮鄉,八仙村,265,134,131,5,270,773,0,34.93,17.34
南投縣,中寮鄉,和興村,197,95,102,2,199,639,0,31.14,14.87
南投縣,中寮鄉,福盛村,218,110,108,5,223,683,0,32.65,16.11
南投縣,中寮鄉,永平村,547,285,262,6,553,1678,0,32.96,16.98
南投縣,中寮鄉,復興村,103,52,51,1,104,287,0,36.24,18.12
南投縣,中寮鄉,中寮村,215,122,93,4,219,624,0,35.1,19.55
南投縣,中寮鄉,廣福村,153,55,98,0,153,491,0,31.16,11.2
南投縣,中寮鄉,永福村,417,234,183,8,425,1319,0,32.22,17.74
南投縣,中寮鄉,義和村,369,163,206,4,373,1049,0,35.56,15.54
南投縣,中寮鄉,清水村,239,113,126,11,250,847,0,29.52,13.34
南投縣,中寮鄉,龍安村,236,82,154,4,240,666,0,36.04,12.31
南投縣,中寮鄉,龍岩村,222,111,111,1,223,637,0,35.01,17.43
南投縣,中寮鄉,永和村,171,90,81,2,173,499,0,34.67,18.04
南投縣,中寮鄉,內城村,164,81,83,1,165,454,0,36.34,17.84
南投縣,中寮鄉,永芳村,152,76,76,3,155,454,0,34.14,16.74
南投縣,中寮鄉,爽文村,176,88,88,1,177,477,0,37.11,18.45
南投縣,中寮鄉,合計,4271,2069,2202,67,4338,12820,14137,33.84,16.14
南投縣,魚池鄉,東池村,547,287,260,3,550,1550,0,35.48,18.52
南投縣,魚池鄉,魚池村,666,347,319,4,670,1908,0,35.12,18.19
南投縣,魚池鄉,中明村,307,142,165,4,311,994,0,31.29,14.29
南投縣,魚池鄉,新城村,451,210,241,4,455,1333,0,34.13,15.75
南投縣,魚池鄉,大林村,342,148,194,7,349,1061,0,32.89,13.95
南投縣,魚池鄉,東光村,332,157,175,3,335,1242,0,26.97,12.64
南投縣,魚池鄉,共和村,153,58,95,2,155,501,0,30.94,11.58
南投縣,魚池鄉,大雁村,205,107,98,2,207,625,0,33.12,17.12
南投縣,魚池鄉,五城村,232,123,109,3,235,718,0,32.73,17.13
南投縣,魚池鄉,水社村,301,195,106,1,302,823,0,36.7,23.69
南投縣,魚池鄉,頭社村,256,121,135,5,261,917,0,28.46,13.2
南投縣,魚池鄉,武登村,186,115,71,5,191,574,0,33.28,20.03
南投縣,魚池鄉,日月村,310,166,144,1,311,849,0,36.63,19.55
南投縣,魚池鄉,新城村、共和村,190,100,90,2,192,541,0,35.49,18.48
南投縣,魚池鄉,合計,4478,2276,2202,46,4524,13636,15251,33.18,16.69
南投縣,國姓鄉,國姓村,548,277,271,14,562,1641,0,34.25,16.88
南投縣,國姓鄉,石門村,553,334,219,7,560,1676,0,33.41,19.93
南投縣,國姓鄉,大旗村,185,91,94,1,186,641,0,29.02,14.2
南投縣,國姓鄉,北港村,524,253,271,8,532,1823,0,29.18,13.88
南投縣,國姓鄉,長流村,370,234,136,5,375,1346,0,27.86,17.38
南投縣,國姓鄉,長福村,217,125,92,1,218,688,0,31.69,18.17
南投縣,國姓鄉,福龜村,608,337,271,7,615,1766,0,34.82,19.08
南投縣,國姓鄉,乾溝村,248,129,119,8,256,789,0,32.45,16.35
南投縣,國姓鄉,柑林村,368,234,134,4,372,1117,0,33.3,20.95
南投縣,國姓鄉,北山村,493,239,254,16,509,1459,0,34.89,16.38
南投縣,國姓鄉,南港村,476,290,186,10,486,1547,0,31.42,18.75
南投縣,國姓鄉,大石村,208,124,84,2,210,691,0,30.39,17.95
南投縣,國姓鄉,長豐村,182,125,57,3,185,730,0,25.34,17.12
南投縣,國姓鄉,合計,4980,2792,2188,86,5066,15914,17685,31.83,17.54
南投縣,水里鄉,水里村,221,126,95,0,221,726,0,30.44,17.36
南投縣,水里鄉,農富村,187,87,100,0,187,420,0,44.52,20.71
南投縣,水里鄉,新城村,450,223,227,4,454,1475,0,30.78,15.12
南投縣,水里鄉,中央村,234,143,91,1,235,596,0,39.43,23.99
南投縣,水里鄉,城中村,343,207,136,2,345,839,0,41.12,24.67
南投縣,水里鄉,北埔村,368,203,165,2,370,1004,0,36.85,20.22
南投縣,水里鄉,鉅工村,365,202,163,2,367,922,0,39.8,21.91
南投縣,水里鄉,永豐村,435,227,208,7,442,1346,0,32.84,16.86
南投縣,水里鄉,頂崁村,376,195,181,5,381,1172,0,32.51,16.64
南投縣,水里鄉,車埕村,165,103,62,4,169,436,0,38.76,23.62
南投縣,水里鄉,新興村,155,107,48,3,158,621,0,25.44,17.23
南投縣,水里鄉,新山村,73,36,37,0,73,203,0,35.96,17.73
南投縣,水里鄉,郡坑村,127,79,48,1,128,318,0,40.25,24.84
南投縣,水里鄉,上安村,344,211,133,6,350,1065,0,32.86,19.81
南投縣,水里鄉,民和村,249,111,138,4,253,841,0,30.08,13.2
南投縣,水里鄉,永興村,125,48,77,2,127,313,0,40.58,15.34
南投縣,水里鄉,玉峰村,251,101,150,3,254,813,0,31.24,12.42
南投縣,水里鄉,興隆村,96,52,44,1,97,278,0,34.89,18.71
南投縣,水里鄉,南光村,515,278,237,2,517,1527,0,33.86,18.21
南投縣,水里鄉,合計,5079,2739,2340,49,5128,14915,16810,34.38,18.36
南投縣,信義鄉,人和村,228,173,55,4,232,1166,0,19.9,14.84
南投縣,信義鄉,地利村,252,203,49,6,258,920,0,28.04,22.07
南投縣,信義鄉,潭南村,123,107,16,2,125,558,0,22.4,19.18
南投縣,信義鄉,明德村,505,333,172,4,509,1469,0,34.65,22.67
南投縣,信義鄉,愛國村,140,82,58,0,140,481,0,29.11,17.05
南投縣,信義鄉,自強村,205,98,107,9,214,713,0,30.01,13.74
南投縣,信義鄉,羅娜村,341,251,90,1,342,1338,0,25.56,18.76
南投縣,信義鄉,望美村,325,195,130,5,330,1516,0,21.77,12.86
南投縣,信義鄉,同富村,411,215,196,6,417,1399,0,29.81,15.37
南投縣,信義鄉,神木村,160,96,64,5,165,629,0,26.23,15.26
南投縣,信義鄉,東埔村,218,149,69,2,220,988,0,22.27,15.08
南投縣,信義鄉,雙龍村,77,56,21,2,79,610,0,12.95,9.18
南投縣,信義鄉,新鄉村,149,113,36,2,151,587,0,25.72,19.25
南投縣,信義鄉,豐丘村,158,79,79,1,159,628,0,25.32,12.58
南投縣,信義鄉,合計,3292,2150,1142,49,3341,13002,15798,25.7,16.54
南投縣,仁愛鄉,法治村,168,133,35,3,171,801,0,21.35,16.6
南投縣,仁愛鄉,中正村,213,175,38,3,216,907,0,23.81,19.29
南投縣,仁愛鄉,互助村,355,311,44,3,358,1143,0,31.32,27.21
南投縣,仁愛鄉,新生村,163,150,13,0,163,398,0,40.95,37.69
南投縣,仁愛鄉,力行村,98,83,15,2,100,504,0,19.84,16.47
南投縣,仁愛鄉,發祥村,140,109,31,3,143,749,0,19.09,14.55
南投縣,仁愛鄉,親愛村,248,202,46,2,250,1118,0,22.36,18.07
南投縣,仁愛鄉,大同村,544,418,126,5,549,1616,0,33.97,25.87
南投縣,仁愛鄉,南豐村,376,288,88,5,381,1223,0,31.15,23.55
南投縣,仁愛鄉,春陽村,242,203,39,1,243,955,0,25.45,21.26
南投縣,仁愛鄉,精英村,166,134,32,1,167,647,0,25.81,20.71
南投縣,仁愛鄉,萬豐村,110,83,27,1,111,633,0,17.54,13.11
南投縣,仁愛鄉,榮興村,21,20,1,1,22,55,0,40.0,36.36
南投縣,仁愛鄉,翠華村,107,77,30,1,108,507,0,21.3,15.19
南投縣,仁愛鄉,都達村,111,98,13,2,113,627,0,18.02,15.63
南投縣,仁愛鄉,德鹿谷村,93,73,20,0,93,614,0,15.15,11.89
南投縣,仁愛鄉,合計,3155,2557,598,33,3188,12497,15736,25.51,20.46
南投縣,合計,合計,155836,82471,73365,1727,157563,420687,487743,37.45,19.6
雲林縣,斗六市,忠孝里,631,324,307,4,635,1390,0,45.68,23.31
雲林縣,斗六市,仁愛里,478,202,276,3,481,1065,0,45.16,18.97
雲林縣,斗六市,信義里,307,138,169,2,309,609,0,50.74,22.66
雲林縣,斗六市,四維里,276,128,148,5,281,599,0,46.91,21.37
雲林縣,斗六市,太平里,339,176,163,2,341,756,0,45.11,23.28
雲林縣,斗六市,中和里,339,137,202,4,343,767,0,44.72,17.86
雲林縣,斗六市,光興里,309,148,161,5,314,707,0,44.41,20.93
雲林縣,斗六市,三平里,1995,1086,909,14,2009,4843,0,41.48,22.42
雲林縣,斗六市,八德里,1241,625,616,25,1266,3154,0,40.14,19.82
雲林縣,斗六市,鎮北里,1161,623,538,13,1174,2723,0,43.11,22.88
雲林縣,斗六市,龍潭里,775,390,385,4,779,1734,0,44.93,22.49
雲林縣,斗六市,鎮南里,1505,820,685,11,1516,3444,0,44.02,23.81
雲林縣,斗六市,林頭里,1569,813,756,15,1584,4187,0,37.83,19.42
雲林縣,斗六市,重光里,824,355,469,3,827,2303,0,35.91,15.41
雲林縣,斗六市,溝埧里,302,164,138,4,306,657,0,46.58,24.96
雲林縣,斗六市,江厝里,806,350,456,7,813,2185,0,37.21,16.02
雲林縣,斗六市,三光里,210,87,123,3,213,538,0,39.59,16.17
雲林縣,斗六市,崙峯里,987,564,423,6,993,2450,0,40.53,23.02
雲林縣,斗六市,嘉東里,572,246,326,6,578,1451,0,39.83,16.95
雲林縣,斗六市,久安里,980,516,464,10,990,2391,0,41.41,21.58
雲林縣,斗六市,長平里,728,316,412,14,742,1873,0,39.62,16.87
雲林縣,斗六市,保庄里,2270,1121,1149,17,2287,5409,0,42.28,20.72
雲林縣,斗六市,虎溪里,1244,564,680,9,1253,3399,0,36.86,16.59
雲林縣,斗六市,梅林里,712,294,418,14,726,1849,0,39.26,15.9
雲林縣,斗六市,湖山里,412,167,245,6,418,1112,0,37.59,15.02
雲林縣,斗六市,榴中里,1677,757,920,27,1704,4461,0,38.2,16.97
雲林縣,斗六市,榴北里,375,150,225,5,380,1076,0,35.32,13.94
雲林縣,斗六市,榴南里,692,317,375,6,698,2144,0,32.56,14.79
雲林縣,斗六市,溪洲里,1186,578,608,10,1196,3219,0,37.15,17.96
雲林縣,斗六市,長安里,1110,469,641,12,1122,3070,0,36.55,15.28
雲林縣,斗六市,十三里,424,151,273,7,431,1106,0,38.97,13.65
雲林縣,斗六市,鎮東里,1026,571,455,6,1032,2279,0,45.28,25.05
雲林縣,斗六市,鎮西里,1433,709,724,13,1446,3722,0,38.85,19.05
雲林縣,斗六市,公正里,1154,614,540,17,1171,2734,0,42.83,22.46
雲林縣,斗六市,社口里,955,520,435,16,971,2247,0,43.21,23.14
雲林縣,斗六市,公誠里,860,458,402,7,867,2111,0,41.07,21.7
雲林縣,斗六市,明德里,1483,703,780,14,1497,3620,0,41.35,19.42
雲林縣,斗六市,成功里,1187,609,578,4,1191,2596,0,45.88,23.46
雲林縣,斗六市,文化里,962,514,448,8,970,2294,0,42.28,22.41
雲林縣,斗六市,正心里,820,404,416,7,827,1970,0,41.98,20.51
雲林縣,斗六市,合計,36316,17878,18438,365,36681,90244,108508,40.65,19.81
雲林縣,斗南鎮,東仁里,507,231,276,6,513,1125,0,45.6,20.53
雲林縣,斗南鎮,西岐里,886,450,436,7,893,2068,0,43.18,21.76
雲林縣,斗南鎮,南昌里,817,351,466,9,826,2193,0,37.67,16.01
雲林縣,斗南鎮,北銘里,614,307,307,4,618,1430,0,43.22,21.47
雲林縣,斗南鎮,中天里,499,219,280,2,501,1217,0,41.17,18.0
雲林縣,斗南鎮,舊社里,1015,437,578,6,1021,2651,0,38.51,16.48
雲林縣,斗南鎮,林子里,501,205,296,8,509,1321,0,38.53,15.52
雲林縣,斗南鎮,石龜里,314,120,194,7,321,738,0,43.5,16.26
雲林縣,斗南鎮,靖興里,282,130,152,4,286,860,0,33.26,15.12
雲林縣,斗南鎮,新南里,262,107,155,4,266,705,0,37.73,15.18
雲林縣,斗南鎮,阿丹里,386,157,229,7,393,1113,0,35.31,14.11
雲林縣,斗南鎮,將軍里,622,238,384,8,630,1683,0,37.43,14.14
雲林縣,斗南鎮,東明里,386,151,235,3,389,970,0,40.1,15.57
雲林縣,斗南鎮,新光里,1050,389,661,14,1064,2768,0,38.44,14.05
雲林縣,斗南鎮,田頭里,796,332,464,7,803,2175,0,36.92,15.26
雲林縣,斗南鎮,明昌里,1291,610,681,10,1301,3315,0,39.25,18.4
雲林縣,斗南鎮,大東里,321,143,178,4,325,854,0,38.06,16.74
雲林縣,斗南鎮,埤麻里,304,163,141,6,310,792,0,39.14,20.58
雲林縣,斗南鎮,西伯里,310,168,142,2,312,823,0,37.91,20.41
雲林縣,斗南鎮,新崙里,522,204,318,8,530,1470,0,36.05,13.88
雲林縣,斗南鎮,小東里,560,178,382,9,569,1433,0,39.71,12.42
雲林縣,斗南鎮,石溪里,327,120,207,10,337,851,0,39.6,14.1
雲林縣,斗南鎮,大同里,1135,570,565,10,1145,2831,0,40.45,20.13
雲林縣,斗南鎮,僑真里,834,392,442,7,841,2236,0,37.61,17.53
雲林縣,斗南鎮,合計,14541,6372,8169,162,14703,37622,43841,39.08,16.94
雲林縣,虎尾鎮,中山里,366,172,194,2,368,914,0,40.26,18.82
雲林縣,虎尾鎮,新興里,646,331,315,4,650,1655,0,39.27,20.0
雲林縣,虎尾鎮,東仁里,1020,516,504,8,1028,2525,0,40.71,20.44
雲林縣,虎尾鎮,公安里,1183,593,590,8,1191,2771,0,42.98,21.4
雲林縣,虎尾鎮,德興里,937,511,426,13,950,2473,0,38.41,20.66
雲林縣,虎尾鎮,西安里,1192,638,554,5,1197,3168,0,37.78,20.14
雲林縣,虎尾鎮,安慶里,612,325,287,5,617,1361,0,45.33,23.88
雲林縣,虎尾鎮,平和里,1622,847,775,10,1632,4499,0,36.27,18.83
雲林縣,虎尾鎮,興南里,870,434,436,8,878,2323,0,37.8,18.68
雲林縣,虎尾鎮,新吉里,1443,681,762,13,1456,3807,0,38.25,17.89
雲林縣,虎尾鎮,穎川里,776,387,389,5,781,2017,0,38.72,19.19
雲林縣,虎尾鎮,延平里,418,208,210,3,421,1123,0,37.49,18.52
雲林縣,虎尾鎮,三合里,477,238,239,5,482,1313,0,36.71,18.13
雲林縣,虎尾鎮,北溪里,298,147,151,5,303,828,0,36.59,17.75
雲林縣,虎尾鎮,墾地里,584,222,362,4,588,1952,0,30.12,11.37
雲林縣,虎尾鎮,西屯里,506,200,306,2,508,1478,0,34.37,13.53
雲林縣,虎尾鎮,芳草里,263,73,190,0,263,872,0,30.16,8.37
雲林縣,虎尾鎮,埒內里,932,364,568,6,938,2607,0,35.98,13.96
雲林縣,虎尾鎮,堀頭里,297,156,141,4,301,844,0,35.66,18.48
雲林縣,虎尾鎮,安溪里,576,227,349,15,591,1767,0,33.45,12.85
雲林縣,虎尾鎮,興中里,584,264,320,10,594,1633,0,36.37,16.17
雲林縣,虎尾鎮,廉使里,1195,467,728,10,1205,3437,0,35.06,13.59
雲林縣,虎尾鎮,惠來里,757,320,437,15,772,2304,0,33.51,13.89
雲林縣,虎尾鎮,頂溪里,825,320,505,12,837,2528,0,33.11,12.66
雲林縣,虎尾鎮,中溪里,484,197,287,3,487,1339,0,36.37,14.71
雲林縣,虎尾鎮,下溪里,549,256,293,5,554,1501,0,36.91,17.06
雲林縣,虎尾鎮,建國里,165,96,69,4,169,515,0,32.82,18.64
雲林縣,虎尾鎮,立仁里,1396,762,634,4,1400,3651,0,38.35,20.87
雲林縣,虎尾鎮,東屯里,378,167,211,4,382,1211,0,31.54,13.79
雲林縣,虎尾鎮,合計,21351,10119,11232,192,21543,58416,70772,36.88,17.32
雲林縣,西螺鎮,振興里,532,166,366,6,538,1509,0,35.65,11.0
雲林縣,西螺鎮,大園里,654,270,384,8,662,1720,0,38.49,15.7
雲林縣,西螺鎮,廣福里,755,342,413,3,758,2061,0,36.78,16.59
雲林縣,西螺鎮,正興里,1109,496,613,8,1117,2893,0,38.61,17.14
雲林縣,西螺鎮,永安里,149,53,96,2,151,325,0,46.46,16.31
雲林縣,西螺鎮,中和里,233,87,146,3,236,549,0,42.99,15.85
雲林縣,西螺鎮,福興里,224,91,133,2,226,568,0,39.79,16.02
雲林縣,西螺鎮,光華里,372,150,222,7,379,1004,0,37.75,14.94
雲林縣,西螺鎮,中興里,1070,412,658,4,1074,2870,0,37.42,14.36
雲林縣,西螺鎮,漢光里,1593,579,1014,17,1610,4547,0,35.41,12.73
雲林縣,西螺鎮,新安里,457,105,352,6,463,1277,0,36.26,8.22
雲林縣,西螺鎮,新豐里,527,132,395,6,533,1475,0,36.14,8.95
雲林縣,西螺鎮,詔安里,373,153,220,7,380,972,0,39.09,15.74
雲林縣,西螺鎮,河南里,344,116,228,4,348,1105,0,31.49,10.5
雲林縣,西螺鎮,安定里,553,157,396,4,557,1776,0,31.36,8.84
雲林縣,西螺鎮,福田里,503,125,378,11,514,1499,0,34.29,8.34
雲林縣,西螺鎮,大新里,561,176,385,7,568,1573,0,36.11,11.19
雲林縣,西螺鎮,埤頭里,321,81,240,5,326,872,0,37.39,9.29
雲林縣,西螺鎮,東興里,390,92,298,3,393,935,0,42.03,9.84
雲林縣,西螺鎮,廣興里,330,143,187,1,331,854,0,38.76,16.74
雲林縣,西螺鎮,鹿場里,529,148,381,3,532,1477,0,36.02,10.02
雲林縣,西螺鎮,頂湳里,382,110,272,7,389,963,0,40.39,11.42
雲林縣,西螺鎮,下湳里,243,143,100,3,246,809,0,30.41,17.68
雲林縣,西螺鎮,九隆里,277,84,193,3,280,727,0,38.51,11.55
雲林縣,西螺鎮,吳厝里,385,124,261,3,388,1287,0,30.15,9.63
雲林縣,西螺鎮,七座里,307,88,219,8,315,862,0,36.54,10.21
雲林縣,西螺鎮,公舘里,458,123,335,8,466,1346,0,34.62,9.14
雲林縣,西螺鎮,合計,13631,4746,8885,149,13780,37855,45246,36.4,12.54
雲林縣,土庫鎮,忠正里,317,136,181,3,320,765,0,41.83,17.78
雲林縣,土庫鎮,順天里,328,130,198,3,331,868,0,38.13,14.98
雲林縣,土庫鎮,宮北里,566,262,304,7,573,1345,0,42.6,19.48
雲林縣,土庫鎮,越港里,448,222,226,3,451,1052,0,42.87,21.1
雲林縣,土庫鎮,溪邊里,338,132,206,6,344,1083,0,31.76,12.19
雲林縣,土庫鎮,興新里,497,188,309,5,502,1401,0,35.83,13.42
雲林縣,土庫鎮,奮起里,400,165,235,10,410,1267,0,32.36,13.02
雲林縣,土庫鎮,埤腳里,422,177,245,3,425,1221,0,34.81,14.5
雲林縣,土庫鎮,大荖里,310,116,194,5,315,854,0,36.89,13.58
雲林縣,土庫鎮,石廟里,912,400,512,8,920,2844,0,32.35,14.06
雲林縣,土庫鎮,東平里,638,201,437,8,646,1845,0,35.01,10.89
雲林縣,土庫鎮,南平里,613,249,364,8,621,1750,0,35.49,14.23
雲林縣,土庫鎮,北平里,283,93,190,4,287,830,0,34.58,11.2
雲林縣,土庫鎮,西平里,575,196,379,7,582,1773,0,32.83,11.05
雲林縣,土庫鎮,後埔里,680,261,419,8,688,2272,0,30.28,11.49
雲林縣,土庫鎮,崙內里,440,171,269,6,446,1501,0,29.71,11.39
雲林縣,土庫鎮,新庄里,457,166,291,3,460,1425,0,32.28,11.65
雲林縣,土庫鎮,合計,8224,3265,4959,97,8321,24096,28137,34.53,13.55
雲林縣,北港鎮,東陽里,308,108,200,5,313,692,0,45.23,15.61
雲林縣,北港鎮,光民里,278,78,200,0,278,655,0,42.44,11.91
雲林縣,北港鎮,東華里,180,76,104,2,182,437,0,41.65,17.39
雲林縣,北港鎮,南安里,374,135,239,5,379,831,0,45.61,16.25
雲林縣,北港鎮,中和里,147,48,99,2,149,329,0,45.29,14.59
雲林縣,北港鎮,義民里,157,63,94,0,157,385,0,40.78,16.36
雲林縣,北港鎮,共榮里,152,40,112,2,154,355,0,43.38,11.27
雲林縣,北港鎮,西勢里,364,136,228,6,370,907,0,40.79,14.99
雲林縣,北港鎮,仁和里,200,76,124,2,202,469,0,43.07,16.2
雲林縣,北港鎮,賜福里,142,58,84,2,144,312,0,46.15,18.59
雲林縣,北港鎮,公舘里,202,79,123,4,206,525,0,39.24,15.05
雲林縣,北港鎮,大同里,435,154,281,5,440,1132,0,38.87,13.6
雲林縣,北港鎮,仁安里,204,87,117,3,207,425,0,48.71,20.47
雲林縣,北港鎮,華勝里,1915,740,1175,18,1933,4762,0,40.59,15.54
雲林縣,北港鎮,光復里,630,294,336,5,635,1679,0,37.82,17.51
雲林縣,北港鎮,新街里,2360,1014,1346,18,2378,6248,0,38.06,16.23
雲林縣,北港鎮,劉厝里,397,108,289,6,403,1122,0,35.92,9.63
雲林縣,北港鎮,府番里,232,106,126,3,235,794,0,29.6,13.35
雲林縣,北港鎮,草湖里,396,104,292,5,401,1344,0,29.84,7.74
雲林縣,北港鎮,溝皂里,381,120,261,7,388,1120,0,34.64,10.71
雲林縣,北港鎮,後溝里,337,96,241,6,343,969,0,35.4,9.91
雲林縣,北港鎮,番溝里,231,67,164,6,237,760,0,31.18,8.82
雲林縣,北港鎮,大北里,170,38,132,7,177,537,0,32.96,7.08
雲林縣,北港鎮,好收里,535,180,355,8,543,1571,0,34.56,11.46
雲林縣,北港鎮,樹腳里,1106,387,719,12,1118,2928,0,38.18,13.22
雲林縣,北港鎮,扶朝里,419,68,351,2,421,958,0,43.95,7.1
雲林縣,北港鎮,水埔里,153,41,112,0,153,470,0,32.55,8.72
雲林縣,北港鎮,新厝里,131,40,91,2,133,380,0,35.0,10.53
雲林縣,北港鎮,合計,12536,4541,7995,143,12679,33096,38748,38.31,13.72
雲林縣,古坑鄉,水碓村,429,184,245,7,436,1190,0,36.64,15.46
雲林縣,古坑鄉,田心村,418,221,197,3,421,1080,0,38.98,20.46
雲林縣,古坑鄉,高林村,397,148,249,7,404,1106,0,36.53,13.38
雲林縣,古坑鄉,荷苞村,494,222,272,5,499,1397,0,35.72,15.89
雲林縣,古坑鄉,東和村,1047,430,617,12,1059,3146,0,33.66,13.67
雲林縣,古坑鄉,新庄村,580,210,370,13,593,1472,0,40.29,14.27
雲林縣,古坑鄉,棋盤村,697,254,443,12,709,2048,0,34.62,12.4
雲林縣,古坑鄉,華山村,217,79,138,1,218,708,0,30.79,11.16
雲林縣,古坑鄉,華南村,105,29,76,0,105,278,0,37.77,10.43
雲林縣,古坑鄉,永光村,684,290,394,9,693,2109,0,32.86,13.75
雲林縣,古坑鄉,桂林村,342,99,243,2,344,1061,0,32.42,9.33
雲林縣,古坑鄉,崁腳村,358,176,182,8,366,1155,0,31.69,15.24
雲林縣,古坑鄉,樟湖村,100,43,57,5,105,429,0,24.48,10.02
雲林縣,古坑鄉,草嶺村,198,76,122,1,199,543,0,36.65,14.0
雲林縣,古坑鄉,永昌村,751,325,426,9,760,2065,0,36.8,15.74
雲林縣,古坑鄉,麻園村,329,107,222,6,335,761,0,44.02,14.06
雲林縣,古坑鄉,古坑村,780,371,409,8,788,2241,0,35.16,16.56
雲林縣,古坑鄉,朝陽村,763,362,401,13,776,2080,0,37.31,17.4
雲林縣,古坑鄉,西平村,582,251,331,2,584,1501,0,38.91,16.72
雲林縣,古坑鄉,湳仔村,248,115,133,3,251,672,0,37.35,17.11
雲林縣,古坑鄉,合計,9519,3992,5527,126,9645,27042,30632,35.67,14.76
雲林縣,大埤鄉,北和村,289,122,167,2,291,737,0,39.48,16.55
雲林縣,大埤鄉,南和村,801,301,500,16,817,2148,0,38.04,14.01
雲林縣,大埤鄉,大德村,351,155,196,4,355,959,0,37.02,16.16
雲林縣,大埤鄉,松竹村,326,85,241,4,330,908,0,36.34,9.36
雲林縣,大埤鄉,尚義村,661,237,424,15,676,1893,0,35.71,12.52
雲林縣,大埤鄉,嘉興村,684,292,392,7,691,1830,0,37.76,15.96
雲林縣,大埤鄉,豐田村,576,228,348,9,585,1532,0,38.19,14.88
雲林縣,大埤鄉,三結村,385,127,258,5,390,1179,0,33.08,10.77
雲林縣,大埤鄉,吉田村,239,72,167,4,243,716,0,33.94,10.06
雲林縣,大埤鄉,豐岡村,199,86,113,1,200,583,0,34.31,14.75
雲林縣,大埤鄉,聯美村,325,121,204,4,329,1045,0,31.48,11.58
雲林縣,大埤鄉,怡然村,273,106,167,3,276,743,0,37.15,14.27
雲林縣,大埤鄉,北鎮村,245,88,157,3,248,670,0,37.01,13.13
雲林縣,大埤鄉,興安村,238,75,163,1,239,669,0,35.72,11.21
雲林縣,大埤鄉,西鎮村,221,88,133,4,225,701,0,32.1,12.55
雲林縣,大埤鄉,合計,5813,2183,3630,82,5895,16313,18555,36.14,13.38
雲林縣,莿桐鄉,莿桐村,1675,640,1035,13,1688,4116,0,41.01,15.55
雲林縣,莿桐鄉,甘厝村,333,90,243,6,339,864,0,39.24,10.42
雲林縣,莿桐鄉,甘西村,592,173,419,4,596,1530,0,38.95,11.31
雲林縣,莿桐鄉,興桐村,501,183,318,6,507,1177,0,43.08,15.55
雲林縣,莿桐鄉,義和村,378,124,254,5,383,1068,0,35.86,11.61
雲林縣,莿桐鄉,埔子村,748,224,524,10,758,2015,0,37.62,11.12
雲林縣,莿桐鄉,大美村,1186,507,679,13,1199,3053,0,39.27,16.61
雲林縣,莿桐鄉,埔尾村,524,191,333,6,530,1250,0,42.4,15.28
雲林縣,莿桐鄉,饒平村,392,140,252,9,401,1135,0,35.33,12.33
雲林縣,莿桐鄉,興貴村,686,249,437,11,697,1882,0,37.04,13.23
雲林縣,莿桐鄉,四合村,630,253,377,5,635,1725,0,36.81,14.67
雲林縣,莿桐鄉,麻園村,498,193,305,10,508,1453,0,34.96,13.28
雲林縣,莿桐鄉,五華村,466,159,307,6,472,1313,0,35.95,12.11
雲林縣,莿桐鄉,六合村,676,210,466,12,688,1767,0,38.94,11.88
雲林縣,莿桐鄉,合計,9285,3336,5949,116,9401,24348,28143,38.61,13.7
雲林縣,林內鄉,林南村,358,171,187,6,364,1004,0,36.25,17.03
雲林縣,林內鄉,林中村,1295,574,721,18,1313,3548,0,37.01,16.18
雲林縣,林內鄉,林北村,761,295,466,12,773,2097,0,36.86,14.07
雲林縣,林內鄉,坪頂村,172,92,80,3,175,505,0,34.65,18.22
雲林縣,林內鄉,林茂村,287,131,156,3,290,802,0,36.16,16.33
雲林縣,林內鄉,九芎村,822,345,477,17,839,2594,0,32.34,13.3
雲林縣,林內鄉,湖本村,226,88,138,2,228,627,0,36.36,14.04
雲林縣,林內鄉,烏塗村,381,167,214,10,391,1115,0,35.07,14.98
雲林縣,林內鄉,烏麻村,345,187,158,4,349,1016,0,34.35,18.41
雲林縣,林內鄉,重興村,641,214,427,7,648,1798,0,36.04,11.9
雲林縣,林內鄉,合計,5288,2264,3024,82,5370,15106,17408,35.55,14.99
雲林縣,二崙鄉,崙東村,527,206,321,5,532,1442,0,36.89,14.29
雲林縣,二崙鄉,崙西村,625,243,382,8,633,1698,0,37.28,14.31
雲林縣,二崙鄉,來惠村,523,164,359,7,530,1596,0,33.21,10.28
雲林縣,二崙鄉,三和村,503,146,357,11,514,1474,0,34.87,9.91
雲林縣,二崙鄉,湳仔村,410,183,227,8,418,1126,0,37.12,16.25
雲林縣,二崙鄉,田尾村,650,209,441,1,651,1839,0,35.4,11.36
雲林縣,二崙鄉,定安村,301,88,213,6,307,861,0,35.66,10.22
雲林縣,二崙鄉,大華村,342,91,251,2,344,873,0,39.4,10.42
雲林縣,二崙鄉,義庄村,281,51,230,2,283,748,0,37.83,6.82
雲林縣,二崙鄉,楊賢村,454,113,341,9,463,1464,0,31.63,7.72
雲林縣,二崙鄉,港後村,606,163,443,19,625,1782,0,35.07,9.15
雲林縣,二崙鄉,大義村,273,77,196,3,276,821,0,33.62,9.38
雲林縣,二崙鄉,油車村,653,229,424,5,658,1719,0,38.28,13.32
雲林縣,二崙鄉,大庄村,408,126,282,7,415,1223,0,33.93,10.3
雲林縣,二崙鄉,庄西村,231,73,158,1,232,907,0,25.58,8.05
雲林縣,二崙鄉,大同村,279,77,202,4,283,824,0,34.34,9.34
雲林縣,二崙鄉,復興村,265,82,183,3,268,983,0,27.26,8.34
雲林縣,二崙鄉,永定村,561,170,391,3,564,1406,0,40.11,12.09
雲林縣,二崙鄉,合計,7892,2491,5401,104,7996,22786,25808,35.09,10.93
雲林縣,崙背鄉,東明村,420,176,244,4,424,1134,0,37.39,15.52
雲林縣,崙背鄉,西榮村,506,220,286,6,512,1437,0,35.63,15.31
雲林縣,崙背鄉,南陽村,832,379,453,4,836,2263,0,36.94,16.75
雲林縣,崙背鄉,崙前村,731,230,501,11,742,2078,0,35.71,11.07
雲林縣,崙背鄉,羅厝村,740,251,489,14,754,2042,0,36.92,12.29
雲林縣,崙背鄉,港尾村,423,114,309,5,428,1250,0,34.24,9.12
雲林縣,崙背鄉,阿勸村,593,256,337,5,598,2022,0,29.57,12.66
雲林縣,崙背鄉,五魁村,259,171,88,6,265,782,0,33.89,21.87
雲林縣,崙背鄉,大有村,437,184,253,9,446,1484,0,30.05,12.4
雲林縣,崙背鄉,豐榮村,500,185,315,8,508,1710,0,29.71,10.82
雲林縣,崙背鄉,草湖村,423,180,243,8,431,1413,0,30.5,12.74
雲林縣,崙背鄉,舊庄村,264,101,163,8,272,1102,0,24.68,9.17
雲林縣,崙背鄉,水尾村,443,122,321,5,448,1181,0,37.93,10.33
雲林縣,崙背鄉,枋南村,234,78,156,3,237,749,0,31.64,10.41
雲林縣,崙背鄉,合計,6805,2647,4158,96,6901,20647,23741,33.42,12.82
雲林縣,麥寮鄉,麥津村,1123,580,543,10,1133,4277,0,26.49,13.56
雲林縣,麥寮鄉,麥豐村,1934,1018,916,20,1954,7460,0,26.19,13.65
雲林縣,麥寮鄉,瓦磘村,517,191,326,6,523,1968,0,26.58,9.71
雲林縣,麥寮鄉,興華村,752,307,445,13,765,2867,0,26.68,10.71
雲林縣,麥寮鄉,崙後村,634,343,291,8,642,2721,0,23.59,12.61
雲林縣,麥寮鄉,後安村,661,383,278,7,668,3051,0,21.89,12.55
雲林縣,麥寮鄉,海豐村,506,245,261,8,514,2216,0,23.19,11.06
雲林縣,麥寮鄉,三盛村,517,215,302,5,522,2141,0,24.38,10.04
雲林縣,麥寮鄉,橋頭村,1003,462,541,18,1021,4026,0,25.36,11.48
雲林縣,麥寮鄉,新吉村,302,129,173,3,305,1156,0,26.38,11.16
雲林縣,麥寮鄉,施厝村,928,385,543,19,947,3617,0,26.18,10.64
雲林縣,麥寮鄉,雷厝村,544,262,282,12,556,2222,0,25.02,11.79
雲林縣,麥寮鄉,中興村,369,180,189,2,371,1548,0,23.97,11.63
雲林縣,麥寮鄉,合計,9790,4700,5090,131,9921,39270,48001,25.26,11.97
雲林縣,東勢鄉,東南村,557,290,267,8,565,1442,0,39.18,20.11
雲林縣,東勢鄉,東北村,383,181,202,5,388,1155,0,33.59,15.67
雲林縣,東勢鄉,嘉隆村,437,180,257,6,443,1536,0,28.84,11.72
雲林縣,東勢鄉,復興村,199,90,109,1,200,511,0,39.14,17.61
雲林縣,東勢鄉,月眉村,341,118,223,2,343,1160,0,29.57,10.17
雲林縣,東勢鄉,程海村,181,77,104,3,184,532,0,34.59,14.47
雲林縣,東勢鄉,龍潭村,266,74,192,5,271,778,0,34.83,9.51
雲林縣,東勢鄉,安南村,211,86,125,3,214,812,0,26.35,10.59
雲林縣,東勢鄉,昌南村,278,116,162,5,283,825,0,34.3,14.06
雲林縣,東勢鄉,同安村,555,265,290,12,567,1857,0,30.53,14.27
雲林縣,東勢鄉,新坤村,313,141,172,2,315,1015,0,31.03,13.89
雲林縣,東勢鄉,四美村,290,130,160,4,294,989,0,29.73,13.14
雲林縣,東勢鄉,合計,4011,1748,2263,56,4067,12612,13963,32.25,13.86
雲林縣,褒忠鄉,中民村,704,297,407,2,706,1848,0,38.2,16.07
雲林縣,褒忠鄉,埔姜村,525,234,291,5,530,1415,0,37.46,16.54
雲林縣,褒忠鄉,中勝村,517,212,305,7,524,1455,0,36.01,14.57
雲林縣,褒忠鄉,新湖村,432,142,290,13,445,1158,0,38.43,12.26
雲林縣,褒忠鄉,馬鳴村,505,183,322,10,515,1437,0,35.84,12.73
雲林縣,褒忠鄉,有才村,295,107,188,4,299,806,0,37.1,13.28
雲林縣,褒忠鄉,田洋村,282,112,170,0,282,774,0,36.43,14.47
雲林縣,褒忠鄉,龍岩村,390,175,215,4,394,1187,0,33.19,14.74
雲林縣,褒忠鄉,潮厝村,307,119,188,8,315,853,0,36.93,13.95
雲林縣,褒忠鄉,合計,3957,1581,2376,53,4010,10933,12368,36.68,14.46
雲林縣,臺西鄉,台西村,415,239,176,7,422,1177,0,35.85,20.31
雲林縣,臺西鄉,海北村,320,173,147,7,327,1060,0,30.85,16.32
雲林縣,臺西鄉,海南村,311,165,146,6,317,1093,0,29.0,15.1
雲林縣,臺西鄉,海口村,492,274,218,9,501,1980,0,25.3,13.84
雲林縣,臺西鄉,溪頂村,361,159,202,10,371,1449,0,25.6,10.97
雲林縣,臺西鄉,牛厝村,452,192,260,15,467,1828,0,25.55,10.5
雲林縣,臺西鄉,泉州村,157,72,85,3,160,592,0,27.03,12.16
雲林縣,臺西鄉,光華村,220,104,116,4,224,672,0,33.33,15.48
雲林縣,臺西鄉,五榔村,140,37,103,3,143,450,0,31.78,8.22
雲林縣,臺西鄉,山寮村,211,125,86,2,213,811,0,26.26,15.41
雲林縣,臺西鄉,富琦村,381,194,187,9,390,1466,0,26.6,13.23
雲林縣,臺西鄉,永豐村,370,179,191,3,373,1332,0,28.0,13.44
雲林縣,臺西鄉,和豐村,766,358,408,12,778,2935,0,26.51,12.2
雲林縣,臺西鄉,蚊港村,435,246,189,3,438,1741,0,25.16,14.13
雲林縣,臺西鄉,五港村,460,240,220,9,469,1781,0,26.33,13.48
雲林縣,臺西鄉,合計,5491,2757,2734,102,5593,20367,22792,27.46,13.54
雲林縣,元長鄉,長南村,1025,382,643,5,1030,3218,0,32.01,11.87
雲林縣,元長鄉,長北村,490,166,324,5,495,1454,0,34.04,11.42
雲林縣,元長鄉,子茂村,408,139,269,6,414,1308,0,31.65,10.63
雲林縣,元長鄉,後湖村,229,78,151,6,235,705,0,33.33,11.06
雲林縣,元長鄉,山內村,289,116,173,5,294,936,0,31.41,12.39
雲林縣,元長鄉,合和村,297,97,200,5,302,1030,0,29.32,9.42
雲林縣,元長鄉,五塊村,285,140,145,7,292,890,0,32.81,15.73
雲林縣,元長鄉,潭西村,258,61,197,8,266,715,0,37.2,8.53
雲林縣,元長鄉,潭東村,176,85,91,3,179,570,0,31.4,14.91
雲林縣,元長鄉,客厝村,220,105,115,2,222,836,0,26.56,12.56
雲林縣,元長鄉,卓運村,137,27,110,3,140,351,0,39.89,7.69
雲林縣,元長鄉,頂寮村,295,94,201,2,297,1112,0,26.71,8.45
雲林縣,元長鄉,下寮村,436,167,269,10,446,1457,0,30.61,11.46
雲林縣,元長鄉,龍岩村,314,76,238,3,317,958,0,33.09,7.93
雲林縣,元長鄉,西莊村,249,87,162,4,253,813,0,31.12,10.7
雲林縣,元長鄉,鹿北村,311,157,154,0,311,1127,0,27.6,13.93
雲林縣,元長鄉,鹿南村,265,99,166,3,268,816,0,32.84,12.13
雲林縣,元長鄉,瓦磘村,413,132,281,4,417,1472,0,28.33,8.97
雲林縣,元長鄉,內寮村,172,51,121,1,173,578,0,29.93,8.82
雲林縣,元長鄉,崙仔村,198,83,115,2,200,803,0,24.91,10.34
雲林縣,元長鄉,新吉村,227,95,132,1,228,686,0,33.24,13.85
雲林縣,元長鄉,合計,6694,2437,4257,85,6779,21835,24426,31.05,11.16
雲林縣,四湖鄉,四湖村,584,265,319,5,589,1728,0,34.09,15.34
雲林縣,四湖鄉,新庄村,185,67,118,1,186,626,0,29.71,10.7
雲林縣,四湖鄉,溪底村,259,105,154,0,259,902,0,28.71,11.64
雲林縣,四湖鄉,鹿場村,258,89,169,5,263,883,0,29.78,10.08
雲林縣,四湖鄉,湖西村,750,389,361,14,764,2201,0,34.71,17.67
雲林縣,四湖鄉,施湖村,294,138,156,0,294,1152,0,25.52,11.98
雲林縣,四湖鄉,湖寮村,188,75,113,3,191,712,0,26.83,10.53
雲林縣,四湖鄉,蔡厝村,210,91,119,3,213,828,0,25.72,10.99
雲林縣,四湖鄉,飛沙村,227,103,124,0,227,846,0,26.83,12.17
雲林縣,四湖鄉,三姓村,85,32,53,1,86,352,0,24.43,9.09
雲林縣,四湖鄉,內湖村,186,56,130,6,192,743,0,25.84,7.54
雲林縣,四湖鄉,羊調村,221,99,122,6,227,898,0,25.28,11.02
雲林縣,四湖鄉,崙北村,381,159,222,3,384,1669,0,23.01,9.53
雲林縣,四湖鄉,崙南村,177,82,95,3,180,782,0,23.02,10.49
雲林縣,四湖鄉,廣溝村,136,65,71,2,138,683,0,20.2,9.52
雲林縣,四湖鄉,萡子村,242,72,170,2,244,878,0,27.79,8.2
雲林縣,四湖鄉,林厝村,280,102,178,4,284,1016,0,27.95,10.04
雲林縣,四湖鄉,林東村,214,97,117,11,225,958,0,23.49,10.13
雲林縣,四湖鄉,溪尾村,165,86,79,4,169,724,0,23.34,11.88
雲林縣,四湖鄉,飛東村,158,50,108,2,160,533,0,30.02,9.38
雲林縣,四湖鄉,萡東村,272,56,216,3,275,1007,0,27.31,5.56
雲林縣,四湖鄉,合計,5472,2278,3194,78,5550,20121,22100,27.58,11.32
雲林縣,口湖鄉,湖東村,379,160,219,4,383,1198,0,31.97,13.36
雲林縣,口湖鄉,口湖村,350,149,201,5,355,1068,0,33.24,13.95
雲林縣,口湖鄉,頂湖村,167,72,95,0,167,614,0,27.2,11.73
雲林縣,口湖鄉,埔北村,261,75,186,4,265,851,0,31.14,8.81
雲林縣,口湖鄉,埔南村,252,76,176,6,258,694,0,37.18,10.95
雲林縣,口湖鄉,謝厝村,346,83,263,7,353,973,0,36.28,8.53
雲林縣,口湖鄉,蚵寮村,401,98,303,14,415,1405,0,29.54,6.98
雲林縣,口湖鄉,下崙村,544,174,370,10,554,2020,0,27.43,8.61
雲林縣,口湖鄉,崙中村,402,126,276,9,411,1473,0,27.9,8.55
雲林縣,口湖鄉,崙東村,397,144,253,7,404,1410,0,28.65,10.21
雲林縣,口湖鄉,青蚶村,142,34,108,2,144,511,0,28.18,6.65
雲林縣,口湖鄉,港東村,427,149,278,7,434,1493,0,29.07,9.98
雲林縣,口湖鄉,港西村,253,87,166,7,260,806,0,32.26,10.79
雲林縣,口湖鄉,台子村,635,85,550,11,646,1888,0,34.22,4.5
雲林縣,口湖鄉,成龍村,283,102,181,4,287,896,0,32.03,11.38
雲林縣,口湖鄉,湖口村,298,71,227,4,302,980,0,30.82,7.24
雲林縣,口湖鄉,水井村,325,124,201,12,337,925,0,36.43,13.41
雲林縣,口湖鄉,後厝村,231,74,157,1,232,686,0,33.82,10.79
雲林縣,口湖鄉,梧南村,660,190,470,8,668,1773,0,37.68,10.72
雲林縣,口湖鄉,梧北村,482,99,383,7,489,1154,0,42.37,8.58
雲林縣,口湖鄉,過港村,180,64,116,9,189,595,0,31.76,10.76
雲林縣,口湖鄉,合計,7415,2236,5179,138,7553,23413,26186,32.26,9.55
雲林縣,水林鄉,水北村,649,219,430,9,658,2131,0,30.88,10.28
雲林縣,水林鄉,水南村,720,237,483,10,730,1971,0,37.04,12.02
雲林縣,水林鄉,海埔村,354,84,270,7,361,969,0,37.25,8.67
雲林縣,水林鄉,土厝村,403,87,316,10,413,1149,0,35.94,7.57
雲林縣,水林鄉,春埔村,318,93,225,3,321,944,0,34.0,9.85
雲林縣,水林鄉,西井村,196,84,112,3,199,598,0,33.28,14.05
雲林縣,水林鄉,車港村,182,63,119,4,186,597,0,31.16,10.55
雲林縣,水林鄉,蘇秦村,300,75,225,3,303,943,0,32.13,7.95
雲林縣,水林鄉,灣東村,175,78,97,7,182,603,0,30.18,12.94
雲林縣,水林鄉,灣西村,287,109,178,4,291,905,0,32.15,12.04
雲林縣,水林鄉,萬興村,212,52,160,2,214,680,0,31.47,7.65
雲林縣,水林鄉,尖山村,202,49,153,2,204,627,0,32.54,7.81
雲林縣,水林鄉,大山村,362,94,268,5,367,1006,0,36.48,9.34
雲林縣,水林鄉,大溝村,342,93,249,5,347,967,0,35.88,9.62
雲林縣,水林鄉,順興村,265,69,196,6,271,803,0,33.75,8.59
雲林縣,水林鄉,蕃薯村,321,89,232,4,325,927,0,35.06,9.6
雲林縣,水林鄉,山腳村,246,59,187,5,251,776,0,32.35,7.6
雲林縣,水林鄉,松北村,290,113,177,1,291,989,0,29.42,11.43
雲林縣,水林鄉,松中村,185,40,145,4,189,484,0,39.05,8.26
雲林縣,水林鄉,松西村,196,38,158,4,200,647,0,30.91,5.87
雲林縣,水林鄉,瓊埔村,225,38,187,4,229,655,0,34.96,5.8
雲林縣,水林鄉,塭底村,190,37,153,3,193,653,0,29.56,5.67
雲林縣,水林鄉,後寮村,226,71,155,5,231,653,0,35.38,10.87
雲林縣,水林鄉,溪墘村,247,84,163,10,257,765,0,33.59,10.98
雲林縣,水林鄉,合計,7093,2055,5038,120,7213,21442,23934,33.64,9.58
雲林縣,合計,合計,201124,83626,117498,2477,203601,577564,673309,35.25,14.48
嘉義縣,太保市,太保里,872,393,479,9,881,2315,0,38.06,16.98
嘉義縣,太保市,後庄里,189,41,148,1,190,466,0,40.77,8.8
嘉義縣,太保市,前潭里,618,195,423,4,622,1453,0,42.81,13.42
嘉義縣,太保市,後潭里,729,271,458,7,736,1685,0,43.68,16.08
嘉義縣,太保市,梅埔里,470,174,296,11,481,1133,0,42.45,15.36
嘉義縣,太保市,春珠里,381,119,262,4,385,1105,0,34.84,10.77
嘉義縣,太保市,崙頂里,330,127,203,3,333,817,0,40.76,15.54
嘉義縣,太保市,東勢里,766,323,443,7,773,1799,0,42.97,17.95
嘉義縣,太保市,新埤里,488,143,345,9,497,1244,0,39.95,11.5
嘉義縣,太保市,舊埤里,909,483,426,7,916,2556,0,35.84,18.9
嘉義縣,太保市,田尾里,292,100,192,2,294,724,0,40.61,13.81
嘉義縣,太保市,港尾里,219,80,139,2,221,547,0,40.4,14.63
嘉義縣,太保市,過溝里,1396,478,918,9,1405,3489,0,40.27,13.7
嘉義縣,太保市,麻寮里,1677,597,1080,16,1693,4625,0,36.61,12.91
嘉義縣,太保市,南新里,712,210,502,4,716,1819,0,39.36,11.54
嘉義縣,太保市,北新里,1114,386,728,13,1127,3112,0,36.21,12.4
嘉義縣,太保市,埤鄉里,272,105,167,2,274,679,0,40.35,15.46
嘉義縣,太保市,安仁里,1041,481,560,5,1046,2639,0,39.64,18.23
嘉義縣,太保市,合計,12475,4706,7769,115,12590,32207,38651,39.09,14.61
嘉義縣,朴子市,安福里,716,338,378,11,727,1887,0,38.53,17.91
嘉義縣,朴子市,平和里,946,420,526,6,952,2322,0,41.0,18.09
嘉義縣,朴子市,內厝里,482,176,306,2,484,1092,0,44.32,16.12
嘉義縣,朴子市,開元里,177,59,118,2,179,377,0,47.48,15.65
嘉義縣,朴子市,順天里,259,102,157,4,263,610,0,43.11,16.72
嘉義縣,朴子市,中正里,293,120,173,5,298,618,0,48.22,19.42
嘉義縣,朴子市,博厚里,326,121,205,2,328,819,0,40.05,14.77
嘉義縣,朴子市,文化里,704,290,414,5,709,1676,0,42.3,17.3
嘉義縣,朴子市,永和里,934,304,630,9,943,2498,0,37.75,12.17
嘉義縣,朴子市,竹圍里,1736,756,980,11,1747,4243,0,41.17,17.82
嘉義縣,朴子市,新寮里,240,78,162,1,241,669,0,36.02,11.66
嘉義縣,朴子市,双溪里,189,61,128,3,192,608,0,31.58,10.03
嘉義縣,朴子市,溪口里,271,89,182,4,275,768,0,35.81,11.59
嘉義縣,朴子市,德興里,410,91,319,4,414,1015,0,40.79,8.97
嘉義縣,朴子市,仁和里,670,265,405,6,676,1769,0,38.21,14.98
嘉義縣,朴子市,大鄉里,1107,394,713,16,1123,3190,0,35.2,12.35
嘉義縣,朴子市,大葛里,1083,435,648,12,1095,2926,0,37.42,14.87
嘉義縣,朴子市,佳禾里,248,84,164,4,252,742,0,33.96,11.32
嘉義縣,朴子市,竹村里,410,150,260,6,416,1040,0,40.0,14.42
嘉義縣,朴子市,崁前里,325,104,221,9,334,870,0,38.39,11.95
嘉義縣,朴子市,順安里,110,31,79,5,115,246,0,46.75,12.6
嘉義縣,朴子市,崁後里,271,79,192,4,275,709,0,38.79,11.14
嘉義縣,朴子市,德家里,261,72,189,5,266,767,0,34.68,9.39
嘉義縣,朴子市,新庄里,268,114,154,5,273,678,0,40.27,16.81
嘉義縣,朴子市,梅華里,416,84,332,6,422,1019,0,41.41,8.24
嘉義縣,朴子市,松華里,423,93,330,6,429,1190,0,36.05,7.82
嘉義縣,朴子市,南竹里,197,31,166,2,199,486,0,40.95,6.38
嘉義縣,朴子市,合計,13472,4941,8531,155,13627,34834,41439,39.12,14.18
嘉義縣,布袋鎮,岱江里,230,114,116,3,233,593,0,39.29,19.22
嘉義縣,布袋鎮,九龍里,144,66,78,3,147,356,0,41.29,18.54
嘉義縣,布袋鎮,岑海里,792,353,439,10,802,2143,0,37.42,16.47
嘉義縣,布袋鎮,興中里,384,161,223,5,389,1064,0,36.56,15.13
嘉義縣,布袋鎮,光復里,681,303,378,9,690,1593,0,43.31,19.02
嘉義縣,布袋鎮,見龍里,302,107,195,0,302,860,0,35.12,12.44
嘉義縣,布袋鎮,新厝里,197,92,105,8,205,683,0,30.01,13.47
嘉義縣,布袋鎮,龍江里,229,101,128,3,232,742,0,31.27,13.61
嘉義縣,布袋鎮,新岑里,389,116,273,12,401,920,0,43.59,12.61
嘉義縣,布袋鎮,新民里,382,138,244,3,385,1287,0,29.91,10.72
嘉義縣,布袋鎮,復興里,759,266,493,6,765,2276,0,33.61,11.69
嘉義縣,布袋鎮,好美里,332,106,226,8,340,1106,0,30.74,9.58
嘉義縣,布袋鎮,永安里,361,165,196,8,369,1090,0,33.85,15.14
嘉義縣,布袋鎮,東港里,685,228,457,11,696,1861,0,37.4,12.25
嘉義縣,布袋鎮,江山里,105,49,56,1,106,281,0,37.72,17.44
嘉義縣,布袋鎮,菜舖里,138,56,82,5,143,385,0,37.14,14.55
嘉義縣,布袋鎮,考試里,126,41,85,1,127,288,0,44.1,14.24
嘉義縣,布袋鎮,振寮里,240,127,113,2,242,713,0,33.94,17.81
嘉義縣,布袋鎮,西安里,420,154,266,6,426,1117,0,38.14,13.79
嘉義縣,布袋鎮,東安里,539,153,386,7,546,1286,0,42.46,11.9
嘉義縣,布袋鎮,中安里,472,132,340,4,476,1350,0,35.26,9.78
嘉義縣,布袋鎮,樹林里,194,65,129,5,199,518,0,38.42,12.55
嘉義縣,布袋鎮,貴舍里,237,57,180,2,239,632,0,37.82,9.02
嘉義縣,布袋鎮,合計,8338,3150,5188,122,8460,23144,25692,36.55,13.61
嘉義縣,大林鎮,東林里,216,79,137,1,217,467,0,46.47,16.92
嘉義縣,大林鎮,西林里,814,326,488,4,818,1816,0,45.04,17.95
嘉義縣,大林鎮,吉林里,384,173,211,3,387,885,0,43.73,19.55
嘉義縣,大林鎮,平林里,2376,1045,1331,19,2395,5889,0,40.67,17.74
嘉義縣,大林鎮,明華里,477,167,310,9,486,1127,0,43.12,14.82
嘉義縣,大林鎮,明和里,655,306,349,10,665,1783,0,37.3,17.16
嘉義縣,大林鎮,排路里,268,65,203,1,269,595,0,45.21,10.92
嘉義縣,大林鎮,西結里,260,58,202,2,262,703,0,37.27,8.25
嘉義縣,大林鎮,湖北里,264,82,182,5,269,612,0,43.95,13.4
嘉義縣,大林鎮,大糖里,74,41,33,1,75,184,0,40.76,22.28
嘉義縣,大林鎮,大美里,550,242,308,7,557,1563,0,35.64,15.48
嘉義縣,大林鎮,過溪里,523,193,330,9,532,1405,0,37.86,13.74
嘉義縣,大林鎮,中坑里,525,195,330,9,534,1327,0,40.24,14.69
嘉義縣,大林鎮,上林里,317,133,184,6,323,793,0,40.73,16.77
嘉義縣,大林鎮,中林里,643,190,453,9,652,1546,0,42.17,12.29
嘉義縣,大林鎮,三和里,733,310,423,7,740,2009,0,36.83,15.43
嘉義縣,大林鎮,溝背里,346,126,220,4,350,905,0,38.67,13.92
嘉義縣,大林鎮,義和里,254,123,131,4,258,656,0,39.33,18.75
嘉義縣,大林鎮,內林里,271,117,154,6,277,644,0,43.01,18.17
嘉義縣,大林鎮,三角里,295,132,163,1,296,817,0,36.23,16.16
嘉義縣,大林鎮,三村里,341,146,195,3,344,820,0,41.95,17.8
嘉義縣,大林鎮,合計,10586,4249,6337,120,10706,26546,30237,40.33,16.01
嘉義縣,民雄鄉,東榮村,939,416,523,5,944,2300,0,41.04,18.09
嘉義縣,民雄鄉,中樂村,676,313,363,7,683,1528,0,44.7,20.48
嘉義縣,民雄鄉,西安村,1395,537,858,13,1408,3338,0,42.18,16.09
嘉義縣,民雄鄉,寮頂村,872,321,551,11,883,2158,0,40.92,14.87
嘉義縣,民雄鄉,福權村,677,217,460,8,685,1567,0,43.71,13.85
嘉義縣,民雄鄉,東湖村,643,256,387,6,649,1827,0,35.52,14.01
嘉義縣,民雄鄉,頂崙村,567,223,344,6,573,1469,0,39.01,15.18
嘉義縣,民雄鄉,菁埔村,690,164,526,9,699,1708,0,40.93,9.6
嘉義縣,民雄鄉,中和村,365,153,212,4,369,962,0,38.36,15.9
嘉義縣,民雄鄉,平和村,349,119,230,4,353,817,0,43.21,14.57
嘉義縣,民雄鄉,西昌村,345,99,246,4,349,821,0,42.51,12.06
嘉義縣,民雄鄉,豊收村,835,359,476,9,844,2163,0,39.02,16.6
嘉義縣,民雄鄉,三興村,600,252,348,8,608,1346,0,45.17,18.72
嘉義縣,民雄鄉,東興村,207,75,132,2,209,523,0,39.96,14.34
嘉義縣,民雄鄉,鎮北村,454,179,275,16,470,1154,0,40.73,15.51
嘉義縣,民雄鄉,興中村,671,247,424,2,673,1837,0,36.64,13.45
嘉義縣,民雄鄉,興南村,933,372,561,10,943,2740,0,34.42,13.58
嘉義縣,民雄鄉,福興村,853,305,548,5,858,1995,0,43.01,15.29
嘉義縣,民雄鄉,文隆村,992,431,561,13,1005,2450,0,41.02,17.59
嘉義縣,民雄鄉,山中村,1381,470,911,17,1398,3513,0,39.8,13.38
嘉義縣,民雄鄉,中央村,514,154,360,6,520,1281,0,40.59,12.02
嘉義縣,民雄鄉,北斗村,1933,770,1163,16,1949,5279,0,36.92,14.59
嘉義縣,民雄鄉,双福村,955,439,516,9,964,2449,0,39.36,17.93
嘉義縣,民雄鄉,大崎村,884,365,519,9,893,2361,0,37.82,15.46
嘉義縣,民雄鄉,秀林村,1029,305,724,16,1045,2602,0,40.16,11.72
嘉義縣,民雄鄉,松山村,590,213,377,6,596,1690,0,35.27,12.6
嘉義縣,民雄鄉,金興村,1134,448,686,11,1145,2956,0,38.73,15.16
嘉義縣,民雄鄉,福樂村,2571,1041,1530,18,2589,6649,0,38.94,15.66
嘉義縣,民雄鄉,合計,24054,9243,14811,250,24304,61483,71044,39.53,15.03
嘉義縣,溪口鄉,溪東村,512,189,323,6,518,1277,0,40.56,14.8
嘉義縣,溪口鄉,溪西村,291,103,188,4,295,653,0,45.18,15.77
嘉義縣,溪口鄉,溪北村,233,71,162,3,236,636,0,37.11,11.16
嘉義縣,溪口鄉,游東村,394,97,297,5,399,952,0,41.91,10.19
嘉義縣,溪口鄉,游西村,260,52,208,3,263,656,0,40.09,7.93
嘉義縣,溪口鄉,柴林村,281,73,208,3,284,758,0,37.47,9.63
嘉義縣,溪口鄉,林腳村,260,60,200,4,264,803,0,32.88,7.47
嘉義縣,溪口鄉,美南村,362,86,276,11,373,1113,0,33.51,7.73
嘉義縣,溪口鄉,美北村,330,100,230,5,335,971,0,34.5,10.3
嘉義縣,溪口鄉,本厝村,368,123,245,5,373,921,0,40.5,13.36
嘉義縣,溪口鄉,柳溝村,501,158,343,6,507,1264,0,40.11,12.5
嘉義縣,溪口鄉,疊溪村,393,115,278,5,398,1013,0,39.29,11.35
嘉義縣,溪口鄉,妙崙村,241,76,165,4,245,680,0,36.03,11.18
嘉義縣,溪口鄉,坪頂村,359,100,259,3,362,878,0,41.23,11.39
嘉義縣,溪口鄉,合計,4785,1403,3382,67,4852,12575,13890,38.58,11.16
嘉義縣,新港鄉,宮前村,983,417,566,9,992,2204,0,45.01,18.92
嘉義縣,新港鄉,宮後村,653,215,438,7,660,1541,0,42.83,13.95
嘉義縣,新港鄉,大興村,586,204,382,5,591,1424,0,41.5,14.33
嘉義縣,新港鄉,福德村,632,235,397,10,642,1618,0,39.68,14.52
嘉義縣,新港鄉,古民村,528,107,421,9,537,1375,0,39.05,7.78
嘉義縣,新港鄉,中庄村,641,162,479,12,653,1582,0,41.28,10.24
嘉義縣,新港鄉,大潭村,631,164,467,7,638,1618,0,39.43,10.14
嘉義縣,新港鄉,西庄村,378,131,247,6,384,931,0,41.25,14.07
嘉義縣,新港鄉,埤子村,215,49,166,2,217,549,0,39.53,8.93
嘉義縣,新港鄉,南崙村,357,45,312,10,367,886,0,41.42,5.08
嘉義縣,新港鄉,北崙村,168,27,141,4,172,465,0,36.99,5.81
嘉義縣,新港鄉,海瀛村,195,59,136,2,197,486,0,40.53,12.14
嘉義縣,新港鄉,月眉村,751,177,574,12,763,1627,0,46.9,10.88
嘉義縣,新港鄉,月潭村,588,140,448,5,593,1538,0,38.56,9.1
嘉義縣,新港鄉,溪北村,509,132,377,5,514,1308,0,39.3,10.09
嘉義縣,新港鄉,三間村,554,212,342,7,561,1492,0,37.6,14.21
嘉義縣,新港鄉,中洋村,405,156,249,6,411,1023,0,40.18,15.25
嘉義縣,新港鄉,菜公村,372,125,247,5,377,947,0,39.81,13.2
嘉義縣,新港鄉,安和村,354,83,271,8,362,985,0,36.75,8.43
嘉義縣,新港鄉,潭大村,428,132,296,5,433,1118,0,38.73,11.81
嘉義縣,新港鄉,南港村,384,111,273,1,385,1017,0,37.86,10.91
嘉義縣,新港鄉,板頭村,206,65,141,3,209,548,0,38.14,11.86
嘉義縣,新港鄉,共和村,328,88,240,2,330,838,0,39.38,10.5
嘉義縣,新港鄉,合計,10846,3236,7610,142,10988,27120,30952,40.52,11.93
嘉義縣,六腳鄉,蒜頭村,439,176,263,1,440,1127,0,39.04,15.62
嘉義縣,六腳鄉,蒜東村,273,99,174,3,276,788,0,35.03,12.56
嘉義縣,六腳鄉,蒜南村,321,97,224,4,325,829,0,39.2,11.7
嘉義縣,六腳鄉,工廠村,99,59,40,1,100,211,0,47.39,27.96
嘉義縣,六腳鄉,灣南村,426,142,284,4,430,1153,0,37.29,12.32
嘉義縣,六腳鄉,灣北村,366,159,207,7,373,1165,0,32.02,13.65
嘉義縣,六腳鄉,雙涵村,327,86,241,8,335,861,0,38.91,9.99
嘉義縣,六腳鄉,塗師村,241,64,177,10,251,615,0,40.81,10.41
嘉義縣,六腳鄉,三義村,262,63,199,3,265,725,0,36.55,8.69
嘉義縣,六腳鄉,港美村,263,39,224,7,270,677,0,39.88,5.76
嘉義縣,六腳鄉,豐美村,396,101,295,3,399,996,0,40.06,10.14
嘉義縣,六腳鄉,六斗村,308,99,209,4,312,905,0,34.48,10.94
嘉義縣,六腳鄉,崙陽村,354,103,251,8,362,1019,0,35.53,10.11
嘉義縣,六腳鄉,蘇厝村,484,138,346,6,490,1433,0,34.19,9.63
嘉義縣,六腳鄉,竹本村,203,53,150,1,204,594,0,34.34,8.92
嘉義縣,六腳鄉,永賢村,146,30,116,4,150,467,0,32.12,6.42
嘉義縣,六腳鄉,魚寮村,212,61,151,3,215,611,0,35.19,9.98
嘉義縣,六腳鄉,潭墘村,292,98,194,2,294,838,0,35.08,11.69
嘉義縣,六腳鄉,正義村,595,146,449,7,602,1392,0,43.25,10.49
嘉義縣,六腳鄉,溪厝村,219,63,156,2,221,578,0,38.24,10.9
嘉義縣,六腳鄉,六腳村,269,107,162,2,271,734,0,36.92,14.58
嘉義縣,六腳鄉,六南村,171,59,112,3,174,521,0,33.4,11.32
嘉義縣,六腳鄉,崩山村,238,78,160,1,239,627,0,38.12,12.44
嘉義縣,六腳鄉,古林村,264,52,212,2,266,659,0,40.36,7.89
嘉義縣,六腳鄉,更寮村,194,55,139,1,195,563,0,34.64,9.77
嘉義縣,六腳鄉,合計,7362,2227,5135,97,7459,20088,21914,37.13,11.09
嘉義縣,東石鄉,東石村,669,226,443,13,682,1898,0,35.93,11.91
嘉義縣,東石鄉,猿樹村,300,105,195,6,306,922,0,33.19,11.39
嘉義縣,東石鄉,型厝村,417,155,262,6,423,1320,0,32.05,11.74
嘉義縣,東石鄉,塭港村,540,225,315,8,548,1622,0,33.79,13.87
嘉義縣,東石鄉,三家村,325,118,207,8,333,1120,0,29.73,10.54
嘉義縣,東石鄉,永屯村,208,89,119,4,212,701,0,30.24,12.7
嘉義縣,東石鄉,海埔村,136,52,84,8,144,388,0,37.11,13.4
嘉義縣,東石鄉,龍港村,297,156,141,6,303,839,0,36.11,18.59
嘉義縣,東石鄉,副瀨村,315,103,212,9,324,857,0,37.81,12.02
嘉義縣,東石鄉,下揖村,253,77,176,6,259,714,0,36.27,10.78
嘉義縣,東石鄉,頂揖村,142,54,88,2,144,368,0,39.13,14.67
嘉義縣,東石鄉,溪下村,262,105,157,2,264,957,0,27.59,10.97
嘉義縣,東石鄉,港墘村,467,164,303,11,478,1185,0,40.34,13.84
嘉義縣,東石鄉,蔦松村,274,93,181,5,279,821,0,33.98,11.33
嘉義縣,東石鄉,圍潭村,220,78,142,1,221,650,0,34.0,12.0
嘉義縣,東石鄉,洲仔村,246,81,165,6,252,795,0,31.7,10.19
嘉義縣,東石鄉,東崙村,230,86,144,5,235,670,0,35.07,12.84
嘉義縣,東石鄉,西崙村,411,142,269,6,417,1074,0,38.83,13.22
嘉義縣,東石鄉,塭仔村,331,70,261,4,335,893,0,37.51,7.84
嘉義縣,東石鄉,網寮村,374,153,221,2,376,1167,0,32.22,13.11
嘉義縣,東石鄉,掌潭村,325,130,195,2,327,757,0,43.2,17.17
嘉義縣,東石鄉,港口村,85,32,53,1,86,284,0,30.28,11.27
嘉義縣,東石鄉,鰲鼓村,414,132,282,6,420,1233,0,34.06,10.71
嘉義縣,東石鄉,合計,7241,2626,4615,127,7368,21235,23594,34.7,12.37
嘉義縣,義竹鄉,岸腳村,260,87,173,6,266,663,0,40.12,13.12
嘉義縣,義竹鄉,義竹村,605,194,411,9,614,1416,0,43.36,13.7
嘉義縣,義竹鄉,六桂村,453,196,257,7,460,1125,0,40.89,17.42
嘉義縣,義竹鄉,仁里村,354,158,196,4,358,829,0,43.18,19.06
嘉義縣,義竹鄉,傳芳村,280,101,179,7,287,749,0,38.32,13.48
嘉義縣,義竹鄉,頭竹村,464,143,321,11,475,1195,0,39.75,11.97
嘉義縣,義竹鄉,五厝村,148,53,95,1,149,368,0,40.49,14.4
嘉義縣,義竹鄉,中平村,171,77,94,6,177,412,0,42.96,18.69
嘉義縣,義竹鄉,埤前村,321,122,199,8,329,721,0,45.63,16.92
嘉義縣,義竹鄉,平溪村,173,58,115,1,174,422,0,41.23,13.74
嘉義縣,義竹鄉,後鎮村,183,82,101,5,188,417,0,45.08,19.66
嘉義縣,義竹鄉,北華村,247,95,152,5,252,591,0,42.64,16.07
嘉義縣,義竹鄉,新店村,479,182,297,6,485,1447,0,33.52,12.58
嘉義縣,義竹鄉,東過村,241,91,150,4,245,826,0,29.66,11.02
嘉義縣,義竹鄉,西過村,260,74,186,5,265,777,0,34.11,9.52
嘉義縣,義竹鄉,官和村,287,57,230,10,297,796,0,37.31,7.16
嘉義縣,義竹鄉,官順村,147,52,95,3,150,422,0,35.55,12.32
嘉義縣,義竹鄉,新富村,182,93,89,8,190,520,0,36.54,17.88
嘉義縣,義竹鄉,東光村,292,89,203,3,295,724,0,40.75,12.29
嘉義縣,義竹鄉,東榮村,151,51,100,1,152,363,0,41.87,14.05
嘉義縣,義竹鄉,龍蛟村,199,69,130,2,201,554,0,36.28,12.45
嘉義縣,義竹鄉,溪洲村,295,79,216,4,299,636,0,47.01,12.42
嘉義縣,義竹鄉,合計,6192,2203,3989,116,6308,15973,17439,39.49,13.79
嘉義縣,鹿草鄉,後寮村,178,44,134,2,180,512,0,35.16,8.59
嘉義縣,鹿草鄉,鹿東村,218,59,159,2,220,540,0,40.74,10.93
嘉義縣,鹿草鄉,鹿草村,462,154,308,4,466,1289,0,36.15,11.95
嘉義縣,鹿草鄉,西井村,475,190,285,9,484,1319,0,36.69,14.4
嘉義縣,鹿草鄉,豊稠村,180,82,98,0,180,736,0,24.46,11.14
嘉義縣,鹿草鄉,重寮村,396,112,284,3,399,1002,0,39.82,11.18
嘉義縣,鹿草鄉,施家村,156,42,114,5,161,427,0,37.7,9.84
嘉義縣,鹿草鄉,下潭村,327,72,255,6,333,799,0,41.68,9.01
嘉義縣,鹿草鄉,光潭村,383,89,294,4,387,982,0,39.41,9.06
嘉義縣,鹿草鄉,碧潭村,330,132,198,5,335,937,0,35.75,14.09
嘉義縣,鹿草鄉,松竹村,295,119,176,5,300,927,0,32.36,12.84
嘉義縣,鹿草鄉,竹山村,343,87,256,7,350,895,0,39.11,9.72
嘉義縣,鹿草鄉,後堀村,436,149,287,7,443,1126,0,39.34,13.23
嘉義縣,鹿草鄉,三角村,576,174,402,9,585,1379,0,42.42,12.62
嘉義縣,鹿草鄉,下麻村,277,112,165,3,280,599,0,46.74,18.7
嘉義縣,鹿草鄉,合計,5032,1617,3415,71,5103,13469,14778,37.89,12.01
嘉義縣,水上鄉,水上村,1626,671,955,16,1642,4025,0,40.8,16.67
嘉義縣,水上鄉,水頭村,1053,468,585,8,1061,2466,0,43.03,18.98
嘉義縣,水上鄉,大堀村,777,225,552,8,785,1615,0,48.61,13.93
嘉義縣,水上鄉,大崙村,786,264,522,8,794,2073,0,38.3,12.74
嘉義縣,水上鄉,塗溝村,344,98,246,4,348,782,0,44.5,12.53
嘉義縣,水上鄉,粗溪村,610,270,340,7,617,1540,0,40.06,17.53
嘉義縣,水上鄉,下寮村,748,303,445,6,754,1867,0,40.39,16.23
嘉義縣,水上鄉,三和村,678,309,369,7,685,1779,0,38.5,17.37
嘉義縣,水上鄉,回歸村,182,86,96,2,184,427,0,43.09,20.14
嘉義縣,水上鄉,三鎮村,241,139,102,4,245,614,0,39.9,22.64
嘉義縣,水上鄉,靖和村,214,91,123,0,214,384,0,55.73,23.7
嘉義縣,水上鄉,南和村,519,174,345,4,523,1345,0,38.88,12.94
嘉義縣,水上鄉,龍德村,835,233,602,8,843,1915,0,44.02,12.17
嘉義縣,水上鄉,溪洲村,425,151,274,7,432,1028,0,42.02,14.69
嘉義縣,水上鄉,柳林村,713,264,449,13,726,2028,0,35.8,13.02
嘉義縣,水上鄉,柳鄉村,794,264,530,11,805,1983,0,40.6,13.31
嘉義縣,水上鄉,柳新村,685,313,372,6,691,1782,0,38.78,17.56
嘉義縣,水上鄉,寬士村,1648,621,1027,20,1668,4357,0,38.28,14.25
嘉義縣,水上鄉,民生村,1208,501,707,13,1221,2967,0,41.15,16.89
嘉義縣,水上鄉,忠和村,711,308,403,8,719,1853,0,38.8,16.62
嘉義縣,水上鄉,中庄村,644,257,387,6,650,1779,0,36.54,14.45
嘉義縣,水上鄉,南鄉村,338,125,213,1,339,910,0,37.25,13.74
嘉義縣,水上鄉,三界村,380,135,245,5,385,971,0,39.65,13.9
嘉義縣,水上鄉,國姓村,425,130,295,6,431,1239,0,34.79,10.49
嘉義縣,水上鄉,內溪村,434,171,263,2,436,1179,0,36.98,14.5
嘉義縣,水上鄉,義興村,306,117,189,4,310,792,0,39.14,14.77
嘉義縣,水上鄉,合計,17324,6688,10636,184,17508,43700,48786,40.06,15.3
嘉義縣,中埔鄉,中埔村,612,232,380,9,621,1790,0,34.69,12.96
嘉義縣,中埔鄉,塩舘村,372,144,228,3,375,935,0,40.11,15.4
嘉義縣,中埔鄉,龍門村,322,124,198,4,326,787,0,41.42,15.76
嘉義縣,中埔鄉,裕民村,342,84,258,4,346,862,0,40.14,9.74
嘉義縣,中埔鄉,金蘭村,460,185,275,8,468,1500,0,31.2,12.33
嘉義縣,中埔鄉,富收村,1059,398,661,9,1068,2900,0,36.83,13.72
嘉義縣,中埔鄉,和睦村,1234,476,758,15,1249,3322,0,37.6,14.33
嘉義縣,中埔鄉,和美村,2664,1116,1548,19,2683,7020,0,38.22,15.9
嘉義縣,中埔鄉,和興村,2025,782,1243,27,2052,5652,0,36.31,13.84
嘉義縣,中埔鄉,隆興村,646,252,394,5,651,1825,0,35.67,13.81
嘉義縣,中埔鄉,義仁村,514,153,361,6,520,1490,0,34.9,10.27
嘉義縣,中埔鄉,社口村,716,271,445,7,723,2097,0,34.48,12.92
嘉義縣,中埔鄉,灣潭村,321,112,209,2,323,1020,0,31.67,10.98
嘉義縣,中埔鄉,石硦村,411,155,256,9,420,1122,0,37.43,13.81
嘉義縣,中埔鄉,頂埔村,342,101,241,6,348,932,0,37.34,10.84
嘉義縣,中埔鄉,同仁村,657,217,440,8,665,1851,0,35.93,11.72
嘉義縣,中埔鄉,瑞豐村,224,97,127,3,227,723,0,31.4,13.42
嘉義縣,中埔鄉,沄水村,339,118,221,6,345,966,0,35.71,12.22
嘉義縣,中埔鄉,三層村,196,58,138,1,197,634,0,31.07,9.15
嘉義縣,中埔鄉,深坑村,259,106,153,3,262,714,0,36.69,14.85
嘉義縣,中埔鄉,東興村,155,68,87,1,156,356,0,43.82,19.1
嘉義縣,中埔鄉,中崙村,102,48,54,4,106,291,0,36.43,16.49
嘉義縣,中埔鄉,合計,13972,5297,8675,159,14131,38789,43935,36.43,13.66
嘉義縣,竹崎鄉,竹崎村,967,398,569,4,971,2455,0,39.55,16.21
嘉義縣,竹崎鄉,和平村,728,253,475,9,737,2167,0,34.01,11.68
嘉義縣,竹崎鄉,坑頭村,234,91,143,2,236,750,0,31.47,12.13
嘉義縣,竹崎鄉,沙坑村,307,76,231,7,314,813,0,38.62,9.35
嘉義縣,竹崎鄉,獅埜村,502,154,348,8,510,1212,0,42.08,12.71
嘉義縣,竹崎鄉,義和村,295,111,184,4,299,603,0,49.59,18.41
嘉義縣,竹崎鄉,義仁村,308,104,204,2,310,1025,0,30.24,10.15
嘉義縣,竹崎鄉,灣橋村,1986,882,1104,21,2007,5214,0,38.49,16.92
嘉義縣,竹崎鄉,鹿滿村,550,192,358,3,553,1401,0,39.47,13.7
嘉義縣,竹崎鄉,紫雲村,468,197,271,7,475,1362,0,34.88,14.46
嘉義縣,竹崎鄉,內埔村,617,218,399,13,630,1562,0,40.33,13.96
嘉義縣,竹崎鄉,昇平村,489,165,324,1,490,1738,0,28.19,9.49
嘉義縣,竹崎鄉,白杞村,175,72,103,5,180,611,0,29.46,11.78
嘉義縣,竹崎鄉,桃源村,310,123,187,2,312,998,0,31.26,12.32
嘉義縣,竹崎鄉,塘興村,298,138,160,3,301,851,0,35.37,16.22
嘉義縣,竹崎鄉,義隆村,213,80,133,5,218,624,0,34.94,12.82
嘉義縣,竹崎鄉,龍山村,603,184,419,13,616,1756,0,35.08,10.48
嘉義縣,竹崎鄉,文峯村,219,82,137,5,224,626,0,35.78,13.1
嘉義縣,竹崎鄉,金獅村,157,63,94,0,157,416,0,37.74,15.14
嘉義縣,竹崎鄉,復金村,633,219,414,9,642,1845,0,34.8,11.87
嘉義縣,竹崎鄉,緞繻村,272,125,147,1,273,903,0,30.23,13.84
嘉義縣,竹崎鄉,仁壽村,66,15,51,0,66,238,0,27.73,6.3
嘉義縣,竹崎鄉,中和村,241,87,154,1,242,766,0,31.59,11.36
嘉義縣,竹崎鄉,光華村,206,99,107,4,210,681,0,30.84,14.54
嘉義縣,竹崎鄉,合計,10844,4128,6716,129,10973,30617,34503,35.84,13.48
嘉義縣,梅山鄉,梅東村,805,311,494,11,816,2182,0,37.4,14.25
嘉義縣,梅山鄉,梅南村,352,167,185,4,356,869,0,40.97,19.22
嘉義縣,梅山鄉,過山村,194,64,130,2,196,540,0,36.3,11.85
嘉義縣,梅山鄉,梅北村,1541,610,931,23,1564,4337,0,36.06,14.07
嘉義縣,梅山鄉,圳南村,147,57,90,2,149,393,0,37.91,14.5
嘉義縣,梅山鄉,永興村,182,77,105,1,183,500,0,36.6,15.4
嘉義縣,梅山鄉,半天村,108,39,69,2,110,355,0,30.99,10.99
嘉義縣,梅山鄉,圳北村,181,73,108,4,185,579,0,31.95,12.61
嘉義縣,梅山鄉,大南村,556,216,340,7,563,1618,0,34.8,13.35
嘉義縣,梅山鄉,双溪村,205,78,127,5,210,548,0,38.32,14.23
嘉義縣,梅山鄉,安靖村,225,90,135,1,226,814,0,27.76,11.06
嘉義縣,梅山鄉,太平村,139,65,74,1,140,488,0,28.69,13.32
嘉義縣,梅山鄉,碧湖村,83,38,45,1,84,275,0,30.55,13.82
嘉義縣,梅山鄉,太興村,153,88,65,0,153,414,0,36.96,21.26
嘉義縣,梅山鄉,瑞峯村,206,109,97,7,213,703,0,30.3,15.5
嘉義縣,梅山鄉,瑞里村,182,114,68,2,184,610,0,30.16,18.69
嘉義縣,梅山鄉,太和村,237,92,145,5,242,929,0,26.05,9.9
嘉義縣,梅山鄉,龍眼村,124,31,93,2,126,400,0,31.5,7.75
嘉義縣,梅山鄉,合計,5620,2319,3301,80,5700,16554,18481,34.43,14.01
嘉義縣,番路鄉,江西村,437,226,211,7,444,1143,0,38.85,19.77
嘉義縣,番路鄉,內甕村,168,78,90,1,169,440,0,38.41,17.73
嘉義縣,番路鄉,新福村,410,159,251,3,413,1282,0,32.22,12.4
嘉義縣,番路鄉,下坑村,671,288,383,4,675,1748,0,38.62,16.48
嘉義縣,番路鄉,番路村,294,118,176,5,299,835,0,35.81,14.13
嘉義縣,番路鄉,民和村,312,141,171,2,314,849,0,36.98,16.61
嘉義縣,番路鄉,觸口村,409,175,234,4,413,1220,0,33.85,14.34
嘉義縣,番路鄉,大湖村,157,56,101,3,160,596,0,26.85,9.4
嘉義縣,番路鄉,公田村,251,117,134,0,251,956,0,26.26,12.24
嘉義縣,番路鄉,公興村,147,58,89,1,148,498,0,29.72,11.65
嘉義縣,番路鄉,草山村,97,63,34,2,99,364,0,27.2,17.31
嘉義縣,番路鄉,合計,3353,1479,1874,32,3385,9931,11097,34.09,14.89
嘉義縣,大埔鄉,大埔村,353,135,218,4,357,1448,0,24.65,9.32
嘉義縣,大埔鄉,和平村,170,60,110,4,174,650,0,26.77,9.23
嘉義縣,大埔鄉,永樂村,116,62,54,2,118,420,0,28.1,14.76
嘉義縣,大埔鄉,茄苳村,184,80,104,4,188,923,0,20.37,8.67
嘉義縣,大埔鄉,西興村,175,88,87,2,177,567,0,31.22,15.52
嘉義縣,大埔鄉,合計,998,425,573,16,1014,4008,4553,25.3,10.6
嘉義縣,阿里山鄉,中山村,111,61,50,1,112,367,0,30.52,16.62
嘉義縣,阿里山鄉,中正村,63,45,18,2,65,184,0,35.33,24.46
嘉義縣,阿里山鄉,香林村,42,28,14,0,42,142,0,29.58,19.72
嘉義縣,阿里山鄉,十字村,83,50,33,0,83,316,0,26.27,15.82
嘉義縣,阿里山鄉,來吉村,128,95,33,2,130,292,0,44.52,32.53
嘉義縣,阿里山鄉,豐山村,82,51,31,1,83,303,0,27.39,16.83
嘉義縣,阿里山鄉,達邦村,247,195,52,4,251,819,0,30.65,23.81
嘉義縣,阿里山鄉,樂野村,299,177,122,8,307,939,0,32.69,18.85
嘉義縣,阿里山鄉,里佳村,86,65,21,0,86,244,0,35.25,26.64
嘉義縣,阿里山鄉,山美村,130,98,32,1,131,472,0,27.75,20.76
嘉義縣,阿里山鄉,新美村,93,68,25,1,94,289,0,32.53,23.53
嘉義縣,阿里山鄉,茶山村,82,35,47,0,82,254,0,32.28,13.78
嘉義縣,阿里山鄉,合計,1446,968,478,20,1466,4621,5455,31.72,20.95
嘉義縣,合計,合計,163940,60905,103035,2002,165942,436894,496440,37.98,13.94
屏東縣,屏東市,維新里,1136,408,728,16,1152,2604,0,44.24,15.67
屏東縣,屏東市,橋南里,601,264,337,2,603,1528,0,39.46,17.28
屏東縣,屏東市,橋北里,393,173,220,7,400,843,0,47.45,20.52
屏東縣,屏東市,長春里,822,373,449,6,828,1836,0,45.1,20.32
屏東縣,屏東市,豐榮里,1207,533,674,9,1216,2467,0,49.29,21.61
屏東縣,屏東市,豐源里,1642,860,782,12,1654,3454,0,47.89,24.9
屏東縣,屏東市,豐田里,1717,789,928,9,1726,3905,0,44.2,20.2
屏東縣,屏東市,大連里,4211,2177,2034,26,4237,9028,0,46.93,24.11
屏東縣,屏東市,湖西里,674,198,476,6,680,1482,0,45.88,13.36
屏東縣,屏東市,湖南里,438,128,310,2,440,1032,0,42.64,12.4
屏東縣,屏東市,歸心里,474,116,358,6,480,1115,0,43.05,10.4
屏東縣,屏東市,瑞光里,3127,1498,1629,27,3154,7115,0,44.33,21.05
屏東縣,屏東市,新生里,2268,946,1322,21,2289,5421,0,42.22,17.45
屏東縣,屏東市,頂宅里,238,70,168,3,241,510,0,47.25,13.73
屏東縣,屏東市,厚生里,1238,420,818,12,1250,2821,0,44.31,14.89
屏東縣,屏東市,擇仁里,358,123,235,4,362,796,0,45.48,15.45
屏東縣,屏東市,建國里,405,183,222,8,413,900,0,45.89,20.33
屏東縣,屏東市,一心里,560,285,275,1,561,1173,0,47.83,24.3
屏東縣,屏東市,萬年里,301,100,201,0,301,678,0,44.4,14.75
屏東縣,屏東市,義勇里,556,315,241,8,564,1104,0,51.09,28.53
屏東縣,屏東市,光華里,273,99,174,4,277,655,0,42.29,15.11
屏東縣,屏東市,永安里,2904,1205,1699,27,2931,6960,0,42.11,17.31
屏東縣,屏東市,新興里,983,348,635,13,996,2467,0,40.37,14.11
屏東縣,屏東市,公館里,669,194,475,10,679,1488,0,45.63,13.04
屏東縣,屏東市,龍華里,925,304,621,14,939,2203,0,42.62,13.8
屏東縣,屏東市,玉成里,621,106,515,6,627,1481,0,42.34,7.16
屏東縣,屏東市,頂柳里,463,337,126,6,469,1083,0,43.31,31.12
屏東縣,屏東市,大湖里,714,252,462,5,719,1791,0,40.15,14.07
屏東縣,屏東市,安鎮里,838,287,551,15,853,1995,0,42.76,14.39
屏東縣,屏東市,永光里,447,161,286,7,454,1004,0,45.22,16.04
屏東縣,屏東市,大洲里,520,123,397,10,530,1166,0,45.45,10.55
屏東縣,屏東市,大武里,3398,1532,1866,51,3449,8068,0,42.75,18.99
屏東縣,屏東市,前進里,1213,425,788,11,1224,2872,0,42.62,14.8
屏東縣,屏東市,清溪里,1679,758,921,10,1689,4077,0,41.43,18.59
屏東縣,屏東市,長安里,836,286,550,8,844,1956,0,43.15,14.62
屏東縣,屏東市,斯文里,758,407,351,3,761,1637,0,46.49,24.86
屏東縣,屏東市,華山里,2001,1036,965,19,2020,4657,0,43.38,22.25
屏東縣,屏東市,興樂里,339,164,175,4,343,730,0,46.99,22.47
屏東縣,屏東市,明正里,263,125,138,2,265,652,0,40.64,19.17
屏東縣,屏東市,太平里,302,129,173,3,305,626,0,48.72,20.61
屏東縣,屏東市,中正里,1971,1020,951,18,1989,4603,0,43.21,22.16
屏東縣,屏東市,勝利里,2021,1076,945,20,2041,5471,0,37.31,19.67
屏東縣,屏東市,永城里,770,361,409,13,783,1912,0,40.95,18.88
屏東縣,屏東市,溝美里,985,444,541,12,997,2231,0,44.69,19.9
屏東縣,屏東市,北勢里,1088,481,607,8,1096,2284,0,47.99,21.06
屏東縣,屏東市,北興里,2562,1265,1297,18,2580,6059,0,42.58,20.88
屏東縣,屏東市,仁愛里,1017,465,552,11,1028,2149,0,47.84,21.64
屏東縣,屏東市,廣興里,873,382,491,10,883,2058,0,42.91,18.56
屏東縣,屏東市,崇蘭里,5175,2892,2283,39,5214,12298,0,42.4,23.52
屏東縣,屏東市,空翔里,801,523,278,8,809,1655,0,48.88,31.6
屏東縣,屏東市,潭墘里,4545,2642,1903,31,4576,11543,0,39.64,22.89
屏東縣,屏東市,三山里,571,186,385,7,578,1324,0,43.66,14.05
屏東縣,屏東市,海豐里,371,103,268,4,375,849,0,44.17,12.13
屏東縣,屏東市,仁義里,424,133,291,14,438,1089,0,40.22,12.21
屏東縣,屏東市,和興里,420,127,293,8,428,941,0,45.48,13.5
屏東縣,屏東市,信和里,686,170,516,6,692,1560,0,44.36,10.9
屏東縣,屏東市,崇武里,1254,923,331,11,1265,2890,0,43.77,31.94
屏東縣,屏東市,武廟里、大同里、端正里,537,172,365,2,539,1053,0,51.19,16.33
屏東縣,屏東市,文明里、泰安里,289,154,135,7,296,675,0,43.85,22.81
屏東縣,屏東市,光榮里、民權里,633,267,366,4,637,1310,0,48.63,20.38
屏東縣,屏東市,大埔里、必信里,555,207,348,6,561,1240,0,45.24,16.69
屏東縣,屏東市,崇智里、崇禮里,304,97,207,3,307,654,0,46.94,14.83
屏東縣,屏東市,楠樹里、扶風里、慶春里,600,201,399,7,607,1166,0,52.06,17.24
屏東縣,屏東市,安樂里、平和里,487,198,289,2,489,1039,0,47.06,19.06
屏東縣,屏東市,金泉里、勝豐里,505,169,336,10,515,1018,0,50.59,16.6
屏東縣,屏東市,凌雲里、鵬程里,216,124,92,3,219,525,0,41.71,23.62
屏東縣,屏東市,永順里、永昌里,237,102,135,4,241,520,0,46.35,19.62
屏東縣,屏東市,合計,72409,33121,39288,699,73108,167496,196653,43.65,19.77
屏東縣,潮州鎮,潮州里,224,118,106,2,226,505,0,44.75,23.37
屏東縣,潮州鎮,同榮里,300,102,198,2,302,582,0,51.89,17.53
屏東縣,潮州鎮,新榮里,547,217,330,8,555,1227,0,45.23,17.69
屏東縣,潮州鎮,新生里,414,155,259,3,417,983,0,42.42,15.77
屏東縣,潮州鎮,光華里,1750,751,999,7,1757,4770,0,36.83,15.74
屏東縣,潮州鎮,彭城里,377,107,270,1,378,859,0,44.0,12.46
屏東縣,潮州鎮,三星里,2290,985,1305,17,2307,5434,0,42.45,18.13
屏東縣,潮州鎮,三共里,2764,1197,1567,21,2785,6463,0,43.09,18.52
屏東縣,潮州鎮,三和里,881,377,504,5,886,2106,0,42.07,17.9
屏東縣,潮州鎮,五魁里,549,208,341,6,555,1387,0,40.01,15.0
屏東縣,潮州鎮,蓬萊里,928,325,603,4,932,2401,0,38.82,13.54
屏東縣,潮州鎮,八爺里,918,364,554,10,928,2381,0,38.98,15.29
屏東縣,潮州鎮,永春里,2663,1118,1545,23,2686,7120,0,37.72,15.7
屏東縣,潮州鎮,富春里,449,186,263,6,455,1172,0,38.82,15.87
屏東縣,潮州鎮,光春里,554,207,347,7,561,1413,0,39.7,14.65
屏東縣,潮州鎮,興美里,309,104,205,5,314,881,0,35.64,11.8
屏東縣,潮州鎮,檨子里,169,57,112,0,169,468,0,36.11,12.18
屏東縣,潮州鎮,九塊里,622,172,450,12,634,1633,0,38.82,10.53
屏東縣,潮州鎮,泗林里,696,252,444,6,702,1615,0,43.47,15.6
屏東縣,潮州鎮,四春里,683,203,480,12,695,1694,0,41.03,11.98
屏東縣,潮州鎮,崙東里,610,175,435,6,616,1535,0,40.13,11.4
屏東縣,潮州鎮,合計,18697,7380,11317,163,18860,46629,53851,40.45,15.83
屏東縣,東港鎮,新勝里,949,291,658,8,957,1975,0,48.46,14.73
屏東縣,東港鎮,東和里,243,96,147,0,243,631,0,38.51,15.21
屏東縣,東港鎮,朝安里,595,163,432,8,603,1575,0,38.29,10.35
屏東縣,東港鎮,八德里,332,113,219,1,333,734,0,45.37,15.4
屏東縣,東港鎮,東隆里,436,144,292,5,441,1192,0,37.0,12.08
屏東縣,東港鎮,豐漁里,240,74,166,2,242,559,0,43.29,13.24
屏東縣,東港鎮,盛漁里,493,122,371,2,495,1329,0,37.25,9.18
屏東縣,東港鎮,興漁里,703,169,534,7,710,1804,0,39.36,9.37
屏東縣,東港鎮,鎮海里,1046,246,800,6,1052,2840,0,37.04,8.66
屏東縣,東港鎮,嘉蓮里,666,189,477,2,668,1680,0,39.76,11.25
屏東縣,東港鎮,南平里,531,199,332,5,536,1562,0,34.31,12.74
屏東縣,東港鎮,船頭里,2096,725,1371,20,2116,5363,0,39.46,13.52
屏東縣,東港鎮,下廍里,789,163,626,15,804,1937,0,41.51,8.42
屏東縣,東港鎮,大潭里,597,179,418,3,600,1532,0,39.16,11.68
屏東縣,東港鎮,興東里,3478,1282,2196,28,3506,9392,0,37.33,13.65
屏東縣,東港鎮,興農里,550,190,360,4,554,1324,0,41.84,14.35
屏東縣,東港鎮,興和里,419,89,330,8,427,1049,0,40.71,8.48
屏東縣,東港鎮,共和里,287,200,87,3,290,664,0,43.67,30.12
屏東縣,東港鎮,頂新里、頂中里,379,132,247,3,382,852,0,44.84,15.49
屏東縣,東港鎮,興台里、中興里,487,196,291,5,492,1133,0,43.42,17.3
屏東縣,東港鎮,合計,15316,4962,10354,135,15451,39127,46590,39.49,12.68
屏東縣,恆春鎮,城南里,295,160,135,2,297,896,0,33.15,17.86
屏東縣,恆春鎮,城北里,710,340,370,4,714,2205,0,32.38,15.42
屏東縣,恆春鎮,城西里,320,170,150,8,328,1109,0,29.58,15.33
屏東縣,恆春鎮,山腳里,1195,617,578,10,1205,4194,0,28.73,14.71
屏東縣,恆春鎮,網紗里,893,419,474,13,906,3117,0,29.07,13.44
屏東縣,恆春鎮,仁壽里,229,91,138,1,230,856,0,26.87,10.63
屏東縣,恆春鎮,茄湖里,168,62,106,5,173,504,0,34.33,12.3
屏東縣,恆春鎮,頭溝里,164,60,104,3,167,473,0,35.31,12.68
屏東縣,恆春鎮,四溝里,272,106,166,6,278,1021,0,27.23,10.38
屏東縣,恆春鎮,德和里,247,99,148,7,254,928,0,27.37,10.67
屏東縣,恆春鎮,龍水里,285,134,151,0,285,1079,0,26.41,12.42
屏東縣,恆春鎮,山海里,485,146,339,5,490,1560,0,31.41,9.36
屏東縣,恆春鎮,大光里,532,269,263,9,541,2199,0,24.6,12.23
屏東縣,恆春鎮,水泉里,320,105,215,4,324,1388,0,23.34,7.56
屏東縣,恆春鎮,南灣里,483,254,229,1,484,1686,0,28.71,15.07
屏東縣,恆春鎮,墾丁里,457,201,256,7,464,1205,0,38.51,16.68
屏東縣,恆春鎮,鵝鑾里,334,163,171,5,339,1082,0,31.33,15.06
屏東縣,恆春鎮,合計,7389,3396,3993,90,7479,25502,30236,29.33,13.32
屏東縣,萬丹鄉,萬安村,245,75,170,1,246,587,0,41.91,12.78
屏東縣,萬丹鄉,萬惠村,362,127,235,1,363,817,0,44.43,15.54
屏東縣,萬丹鄉,萬全村,1462,516,946,15,1477,3322,0,44.46,15.53
屏東縣,萬丹鄉,萬後村,239,78,161,2,241,711,0,33.9,10.97
屏東縣,萬丹鄉,萬生村,605,242,363,12,617,1403,0,43.98,17.25
屏東縣,萬丹鄉,寶厝村,858,352,506,9,867,2249,0,38.55,15.65
屏東縣,萬丹鄉,四維村,829,270,559,4,833,2047,0,40.69,13.19
屏東縣,萬丹鄉,竹林村,694,214,480,9,703,1671,0,42.07,12.81
屏東縣,萬丹鄉,廣安村,1019,324,695,8,1027,2276,0,45.12,14.24
屏東縣,萬丹鄉,田厝村,443,115,328,4,447,973,0,45.94,11.82
屏東縣,萬丹鄉,崙頂村,715,204,511,7,722,1835,0,39.35,11.12
屏東縣,萬丹鄉,厦北村,685,191,494,7,692,1593,0,43.44,11.99
屏東縣,萬丹鄉,厦南村,565,186,379,6,571,1407,0,40.58,13.22
屏東縣,萬丹鄉,上村村,364,97,267,4,368,822,0,44.77,11.8
屏東縣,萬丹鄉,加興村,540,117,423,7,547,1248,0,43.83,9.38
屏東縣,萬丹鄉,社口村,556,194,362,12,568,1471,0,38.61,13.19
屏東縣,萬丹鄉,磚寮村,417,130,287,7,424,943,0,44.96,13.79
屏東縣,萬丹鄉,社皮村,841,256,585,7,848,1968,0,43.09,13.01
屏東縣,萬丹鄉,社上村,711,213,498,10,721,1666,0,43.28,12.79
屏東縣,萬丹鄉,社中村,713,192,521,11,724,1692,0,42.79,11.35
屏東縣,萬丹鄉,水泉村,770,280,490,8,778,1694,0,45.93,16.53
屏東縣,萬丹鄉,新庄村,871,338,533,7,878,2075,0,42.31,16.29
屏東縣,萬丹鄉,香社村,625,210,415,5,630,1508,0,41.78,13.93
屏東縣,萬丹鄉,後村村,450,131,319,4,454,977,0,46.47,13.41
屏東縣,萬丹鄉,新鐘村,728,332,396,5,733,2019,0,36.31,16.44
屏東縣,萬丹鄉,灣內村,529,139,390,5,534,1343,0,39.76,10.35
屏東縣,萬丹鄉,興全村,474,160,314,7,481,1145,0,42.01,13.97
屏東縣,萬丹鄉,興安村,354,96,258,2,356,828,0,43.0,11.59
屏東縣,萬丹鄉,水仙村,232,93,139,3,235,546,0,43.04,17.03
屏東縣,萬丹鄉,甘棠村,131,50,81,3,134,394,0,34.01,12.69
屏東縣,萬丹鄉,合計,18027,5922,12105,192,18219,43230,49955,42.14,13.7
屏東縣,長治鄉,進興村,1107,493,614,13,1120,2655,0,42.18,18.57
屏東縣,長治鄉,新潭村,1509,686,823,11,1520,3605,0,42.16,19.03
屏東縣,長治鄉,潭頭村,889,369,520,5,894,1921,0,46.54,19.21
屏東縣,長治鄉,香楊村,1169,483,686,7,1176,2628,0,44.75,18.38
屏東縣,長治鄉,長興村,478,214,264,1,479,1056,0,45.36,20.27
屏東縣,長治鄉,德成村,407,160,247,3,410,859,0,47.73,18.63
屏東縣,長治鄉,德協村,471,157,314,1,472,1045,0,45.17,15.02
屏東縣,長治鄉,復興村,664,235,429,10,674,1475,0,45.69,15.93
屏東縣,長治鄉,崙上村,702,296,406,3,705,1639,0,43.01,18.06
屏東縣,長治鄉,德榮村,523,152,371,7,530,1144,0,46.33,13.29
屏東縣,長治鄉,德和村,269,73,196,4,273,743,0,36.74,9.83
屏東縣,長治鄉,繁華村,922,229,693,8,930,2349,0,39.59,9.75
屏東縣,長治鄉,繁昌村,666,191,475,11,677,1719,0,39.38,11.11
屏東縣,長治鄉,繁榮村,481,152,329,9,490,1404,0,34.9,10.83
屏東縣,長治鄉,繁隆村,399,147,252,6,405,1127,0,35.94,13.04
屏東縣,長治鄉,榮華村,304,183,121,2,306,710,0,43.1,25.77
屏東縣,長治鄉,合計,10960,4220,6740,101,11061,26079,29381,42.41,16.18
屏東縣,麟洛鄉,新田村,1003,328,675,10,1013,2127,0,47.63,15.42
屏東縣,麟洛鄉,麟頂村,436,159,277,3,439,925,0,47.46,17.19
屏東縣,麟洛鄉,麟蹄村,738,254,484,6,744,1484,0,50.13,17.12
屏東縣,麟洛鄉,麟趾村,1176,398,778,14,1190,2480,0,47.98,16.05
屏東縣,麟洛鄉,田中村,558,168,390,2,560,1156,0,48.44,14.53
屏東縣,麟洛鄉,田心村,420,162,258,1,421,846,0,49.76,19.15
屏東縣,麟洛鄉,田道村,347,111,236,4,351,671,0,52.31,16.54
屏東縣,麟洛鄉,合計,4678,1580,3098,40,4718,9689,10711,48.69,16.31
屏東縣,九如鄉,九清村,596,156,440,7,603,1438,0,41.93,10.85
屏東縣,九如鄉,九塊村,589,155,434,3,592,1353,0,43.75,11.46
屏東縣,九如鄉,九明村,792,190,602,7,799,1675,0,47.7,11.34
屏東縣,九如鄉,玉水村,511,142,369,9,520,1222,0,42.55,11.62
屏東縣,九如鄉,大坵村,473,145,328,5,478,1155,0,41.39,12.55
屏東縣,九如鄉,三塊村,612,152,460,3,615,1563,0,39.35,9.72
屏東縣,九如鄉,後庄村,800,163,637,20,820,1747,0,46.94,9.33
屏東縣,九如鄉,耆老村,537,139,398,8,545,1257,0,43.36,11.06
屏東縣,九如鄉,洽興村,616,181,435,9,625,1454,0,42.98,12.45
屏東縣,九如鄉,東寧村,2009,618,1391,12,2021,4613,0,43.81,13.4
屏東縣,九如鄉,玉泉村,709,240,469,7,716,1586,0,45.15,15.13
屏東縣,九如鄉,合計,8244,2281,5963,90,8334,19063,21784,43.72,11.97
屏東縣,里港鄉,玉田村,1308,400,908,12,1320,3156,0,41.83,12.67
屏東縣,里港鄉,大平村,473,165,308,8,481,1106,0,43.49,14.92
屏東縣,里港鄉,永春村,342,93,249,2,344,840,0,40.95,11.07
屏東縣,里港鄉,春林村,577,185,392,5,582,1323,0,43.99,13.98
屏東縣,里港鄉,過江村,822,240,582,5,827,1992,0,41.52,12.05
屏東縣,里港鄉,鐵店村,599,176,423,4,603,1418,0,42.52,12.41
屏東縣,里港鄉,塔樓村,637,173,464,8,645,1522,0,42.38,11.37
屏東縣,里港鄉,潮厝村,594,154,440,7,601,1564,0,38.43,9.85
屏東縣,里港鄉,茄苳村,655,160,495,11,666,1502,0,44.34,10.65
屏東縣,里港鄉,載興村,992,226,766,10,1002,2297,0,43.62,9.84
屏東縣,里港鄉,土庫村,845,370,475,10,855,1980,0,43.18,18.69
屏東縣,里港鄉,三廍村,722,245,477,14,736,1815,0,40.55,13.5
屏東縣,里港鄉,中和村,350,128,222,3,353,956,0,36.92,13.39
屏東縣,里港鄉,瀰力村,257,60,197,7,264,514,0,51.36,11.67
屏東縣,里港鄉,合計,9173,2775,6398,106,9279,21985,25657,42.21,12.62
屏東縣,鹽埔鄉,新圍村,1074,322,752,22,1096,3077,0,35.62,10.46
屏東縣,鹽埔鄉,高朗村,904,279,625,10,914,2767,0,33.03,10.08
屏東縣,鹽埔鄉,鹽北村,580,259,321,9,589,1800,0,32.72,14.39
屏東縣,鹽埔鄉,鹽中村,784,359,425,9,793,2311,0,34.31,15.53
屏東縣,鹽埔鄉,鹽南村,555,258,297,11,566,1683,0,33.63,15.33
屏東縣,鹽埔鄉,仕絨村,352,187,165,4,356,1022,0,34.83,18.3
屏東縣,鹽埔鄉,振興村,608,229,379,10,618,1803,0,34.28,12.7
屏東縣,鹽埔鄉,永隆村,213,63,150,3,216,537,0,40.22,11.73
屏東縣,鹽埔鄉,久愛村,345,146,199,6,351,908,0,38.66,16.08
屏東縣,鹽埔鄉,洛陽村,640,247,393,8,648,1606,0,40.35,15.38
屏東縣,鹽埔鄉,新二村,1245,523,722,14,1259,3450,0,36.49,15.16
屏東縣,鹽埔鄉,彭厝村,381,156,225,5,386,957,0,40.33,16.3
屏東縣,鹽埔鄉,合計,7681,3028,4653,111,7792,21921,24795,35.55,13.81
屏東縣,高樹鄉,高樹村,960,230,730,9,969,2093,0,46.3,10.99
屏東縣,高樹鄉,長榮村,536,121,415,9,545,1236,0,44.09,9.79
屏東縣,高樹鄉,東興村,330,70,260,2,332,707,0,46.96,9.9
屏東縣,高樹鄉,東振村,239,57,182,6,245,578,0,42.39,9.86
屏東縣,高樹鄉,源泉村,440,117,323,5,445,995,0,44.72,11.76
屏東縣,高樹鄉,建興村,437,91,346,11,448,1135,0,39.47,8.02
屏東縣,高樹鄉,大埔村,253,68,185,2,255,592,0,43.07,11.49
屏東縣,高樹鄉,菜寮村,310,53,257,5,315,727,0,43.33,7.29
屏東縣,高樹鄉,司馬村,212,68,144,5,217,618,0,35.11,11.0
屏東縣,高樹鄉,舊寮村,482,129,353,2,484,1183,0,40.91,10.9
屏東縣,高樹鄉,新豐村,505,132,373,9,514,1416,0,36.3,9.32
屏東縣,高樹鄉,泰山村,656,197,459,10,666,1828,0,36.43,10.78
屏東縣,高樹鄉,南華村,462,131,331,12,474,1231,0,38.51,10.64
屏東縣,高樹鄉,廣福村,437,119,318,5,442,1041,0,42.46,11.43
屏東縣,高樹鄉,廣興村,359,110,249,6,365,1085,0,33.64,10.14
屏東縣,高樹鄉,舊庄村,396,99,297,5,401,988,0,40.59,10.02
屏東縣,高樹鄉,田子村,411,102,309,8,419,1054,0,39.75,9.68
屏東縣,高樹鄉,鹽樹村,538,148,390,5,543,1172,0,46.33,12.63
屏東縣,高樹鄉,新南村,545,141,404,9,554,1483,0,37.36,9.51
屏東縣,高樹鄉,合計,8508,2183,6325,125,8633,21162,23583,40.79,10.32
屏東縣,萬巒鄉,萬巒村,507,141,366,5,512,1171,0,43.72,12.04
屏東縣,萬巒鄉,萬全村,312,99,213,2,314,715,0,43.92,13.85
屏東縣,萬巒鄉,萬和村,767,241,526,7,774,1663,0,46.54,14.49
屏東縣,萬巒鄉,鹿寮村,407,114,293,3,410,885,0,46.33,12.88
屏東縣,萬巒鄉,硫黃村,273,67,206,3,276,530,0,52.08,12.64
屏東縣,萬巒鄉,泗溝村,485,178,307,7,492,1083,0,45.43,16.44
屏東縣,萬巒鄉,五溝村,477,158,319,6,483,990,0,48.79,15.96
屏東縣,萬巒鄉,成德村,580,195,385,7,587,1392,0,42.17,14.01
屏東縣,萬巒鄉,萬金村,785,204,581,10,795,1976,0,40.23,10.32
屏東縣,萬巒鄉,赤山村,563,195,368,8,571,1657,0,34.46,11.77
屏東縣,萬巒鄉,佳佐村,622,138,484,6,628,1673,0,37.54,8.25
屏東縣,萬巒鄉,佳和村,530,190,340,2,532,1374,0,38.72,13.83
屏東縣,萬巒鄉,新厝村,475,106,369,11,486,1233,0,39.42,8.6
屏東縣,萬巒鄉,新置村,423,148,275,9,432,1162,0,37.18,12.74
屏東縣,萬巒鄉,合計,7206,2174,5032,86,7292,17504,20028,41.66,12.42
屏東縣,內埔鄉,內埔村,1623,649,974,10,1633,3943,0,41.42,16.46
屏東縣,內埔鄉,內田村,1287,474,813,10,1297,3127,0,41.48,15.16
屏東縣,內埔鄉,興南村,596,210,386,8,604,1261,0,47.9,16.65
屏東縣,內埔鄉,義亭村,247,79,168,2,249,565,0,44.07,13.98
屏東縣,內埔鄉,美和村,926,341,585,10,936,2169,0,43.15,15.72
屏東縣,內埔鄉,和興村,1142,454,688,3,1145,2795,0,40.97,16.24
屏東縣,內埔鄉,東寧村,1879,693,1186,14,1893,4356,0,43.46,15.91
屏東縣,內埔鄉,豐田村,1248,447,801,12,1260,3045,0,41.38,14.68
屏東縣,內埔鄉,振豐村,767,259,508,2,769,1580,0,48.67,16.39
屏東縣,內埔鄉,富田村,827,220,607,6,833,1847,0,45.1,11.91
屏東縣,內埔鄉,竹圍村,796,256,540,10,806,1835,0,43.92,13.95
屏東縣,內埔鄉,東勢村,1191,349,842,15,1206,2856,0,42.23,12.22
屏東縣,內埔鄉,東片村,479,140,339,7,486,920,0,52.83,15.22
屏東縣,內埔鄉,上樹村,497,146,351,7,504,1079,0,46.71,13.53
屏東縣,內埔鄉,老埤村,753,228,525,8,761,2282,0,33.35,9.99
屏東縣,內埔鄉,中林村,554,126,428,5,559,1517,0,36.85,8.31
屏東縣,內埔鄉,龍泉村,885,396,489,11,896,2397,0,37.38,16.52
屏東縣,內埔鄉,龍潭村,768,400,368,9,777,2350,0,33.06,17.02
屏東縣,內埔鄉,建興村,362,139,223,6,368,782,0,47.06,17.77
屏東縣,內埔鄉,大新村,702,270,432,10,712,1726,0,41.25,15.64
屏東縣,內埔鄉,黎明村,838,233,605,16,854,2405,0,35.51,9.69
屏東縣,內埔鄉,隘寮村,411,144,267,8,419,1260,0,33.25,11.43
屏東縣,內埔鄉,水門村,330,143,187,5,335,795,0,42.14,17.99
屏東縣,內埔鄉,合計,19108,6796,12312,194,19302,46892,52910,41.16,14.49
屏東縣,竹田鄉,竹田村,662,232,430,3,665,1447,0,45.96,16.03
屏東縣,竹田鄉,竹南村,408,106,302,6,414,868,0,47.7,12.21
屏東縣,竹田鄉,糶糴村,334,113,221,4,338,676,0,50.0,16.72
屏東縣,竹田鄉,履豐村,277,88,189,4,281,577,0,48.7,15.25
屏東縣,竹田鄉,頭崙村,574,167,407,3,577,1289,0,44.76,12.96
屏東縣,竹田鄉,二崙村,473,154,319,4,477,969,0,49.23,15.89
屏東縣,竹田鄉,美崙村,314,114,200,4,318,621,0,51.21,18.36
屏東縣,竹田鄉,南勢村,252,73,179,2,254,459,0,55.34,15.9
屏東縣,竹田鄉,西勢村,1097,400,697,10,1107,2368,0,46.75,16.89
屏東縣,竹田鄉,福田村,238,77,161,3,241,477,0,50.52,16.14
屏東縣,竹田鄉,永豐村,352,125,227,1,353,881,0,40.07,14.19
屏東縣,竹田鄉,六巷村,360,117,243,6,366,796,0,45.98,14.7
屏東縣,竹田鄉,泗洲村,429,159,270,9,438,1099,0,39.85,14.47
屏東縣,竹田鄉,大湖村,501,154,347,3,504,1186,0,42.5,12.98
屏東縣,竹田鄉,鳳明村,459,197,262,7,466,1180,0,39.49,16.69
屏東縣,竹田鄉,合計,6730,2276,4454,69,6799,14893,16409,45.65,15.28
屏東縣,新埤鄉,新埤村,830,372,458,9,839,1959,0,42.83,18.99
屏東縣,新埤鄉,建功村,529,197,332,5,534,1030,0,51.84,19.13
屏東縣,新埤鄉,打鐵村,379,162,217,13,392,860,0,45.58,18.84
屏東縣,新埤鄉,南豐村,341,107,234,3,344,734,0,46.87,14.58
屏東縣,新埤鄉,萬隆村,566,243,323,6,572,1713,0,33.39,14.19
屏東縣,新埤鄉,箕湖村,357,124,233,11,368,1100,0,33.45,11.27
屏東縣,新埤鄉,餉潭村,365,95,270,7,372,1253,0,29.69,7.58
屏東縣,新埤鄉,合計,3367,1300,2067,54,3421,8649,9464,39.55,15.03
屏東縣,枋寮鄉,枋寮村,461,221,240,5,466,1196,0,38.96,18.48
屏東縣,枋寮鄉,新龍村,323,183,140,4,327,865,0,37.8,21.16
屏東縣,枋寮鄉,保生村,352,110,242,4,356,906,0,39.29,12.14
屏東縣,枋寮鄉,中寮村,249,76,173,4,253,573,0,44.15,13.26
屏東縣,枋寮鄉,安樂村,614,208,406,7,621,1578,0,39.35,13.18
屏東縣,枋寮鄉,隆山村,1530,453,1077,20,1550,4151,0,37.34,10.91
屏東縣,枋寮鄉,天時村,801,259,542,8,809,1866,0,43.35,13.88
屏東縣,枋寮鄉,地利村,653,244,409,1,654,1416,0,46.19,17.23
屏東縣,枋寮鄉,人和村,827,308,519,9,836,2027,0,41.24,15.19
屏東縣,枋寮鄉,內寮村,250,64,186,3,253,695,0,36.4,9.21
屏東縣,枋寮鄉,新開村,235,90,145,2,237,874,0,27.12,10.3
屏東縣,枋寮鄉,太源村,290,127,163,2,292,927,0,31.5,13.7
屏東縣,枋寮鄉,玉泉村,120,57,63,2,122,428,0,28.5,13.32
屏東縣,枋寮鄉,東海村,1014,426,588,16,1030,2680,0,38.43,15.9
屏東縣,枋寮鄉,大庄村,233,79,154,2,235,604,0,38.91,13.08
屏東縣,枋寮鄉,合計,7952,2905,5047,89,8041,20786,23466,38.68,13.98
屏東縣,新園鄉,瓦磘村,669,162,507,9,678,1629,0,41.62,9.94
屏東縣,新園鄉,仙吉村,911,272,639,8,919,2479,0,37.07,10.97
屏東縣,新園鄉,田洋村,818,216,602,10,828,2135,0,38.78,10.12
屏東縣,新園鄉,港墘村,306,109,197,2,308,807,0,38.17,13.51
屏東縣,新園鄉,內庄村,362,122,240,1,363,820,0,44.27,14.88
屏東縣,新園鄉,新東村,826,299,527,13,839,2294,0,36.57,13.03
屏東縣,新園鄉,新園村,878,314,564,11,889,2190,0,40.59,14.34
屏東縣,新園鄉,烏龍村,501,143,358,8,509,1194,0,42.63,11.98
屏東縣,新園鄉,興龍村,901,217,684,7,908,2092,0,43.4,10.37
屏東縣,新園鄉,中洲村,640,110,530,12,652,1553,0,41.98,7.08
屏東縣,新園鄉,南龍村,566,136,430,10,576,1368,0,42.11,9.94
屏東縣,新園鄉,港西村,797,254,543,10,807,2061,0,39.16,12.32
屏東縣,新園鄉,五房村,1055,340,715,15,1070,2733,0,39.15,12.44
屏東縣,新園鄉,鹽埔村,1611,373,1238,21,1632,4335,0,37.65,8.6
屏東縣,新園鄉,共和村,775,152,623,13,788,2284,0,34.5,6.65
屏東縣,新園鄉,合計,11616,3219,8397,150,11766,29974,33639,39.25,10.74
屏東縣,崁頂鄉,崁頂村,843,295,548,9,852,2220,0,38.38,13.29
屏東縣,崁頂鄉,園寮村,794,304,490,8,802,1996,0,40.18,15.23
屏東縣,崁頂鄉,圍內村,492,172,320,5,497,1200,0,41.42,14.33
屏東縣,崁頂鄉,力社村,504,136,368,9,513,1272,0,40.33,10.69
屏東縣,崁頂鄉,洲子村,369,112,257,4,373,1046,0,35.66,10.71
屏東縣,崁頂鄉,北勢村,609,189,420,6,615,1466,0,41.95,12.89
屏東縣,崁頂鄉,越溪村,356,117,239,2,358,905,0,39.56,12.93
屏東縣,崁頂鄉,港東村,721,179,542,8,729,1834,0,39.75,9.76
屏東縣,崁頂鄉,合計,4688,1504,3184,51,4739,11939,15223,39.69,12.6
屏東縣,林邊鄉,林邊村,623,191,432,7,630,1392,0,45.26,13.72
屏東縣,林邊鄉,光林村,622,187,435,7,629,1509,0,41.68,12.39
屏東縣,林邊鄉,仁和村,690,211,479,10,700,1603,0,43.67,13.16
屏東縣,林邊鄉,中林村,321,121,200,5,326,690,0,47.25,17.54
屏東縣,林邊鄉,永樂村,1375,415,960,15,1390,3098,0,44.87,13.4
屏東縣,林邊鄉,水利村,641,241,400,13,654,1761,0,37.14,13.69
屏東縣,林邊鄉,崎峯村,433,150,283,5,438,1241,0,35.29,12.09
屏東縣,林邊鄉,田厝村,353,106,247,2,355,895,0,39.66,11.84
屏東縣,林邊鄉,竹林村,759,213,546,9,768,1885,0,40.74,11.3
屏東縣,林邊鄉,鎮安村,463,144,319,7,470,1086,0,43.28,13.26
屏東縣,林邊鄉,合計,6280,1979,4301,80,6360,15160,17145,41.95,13.05
屏東縣,南州鄉,溪洲村,691,229,462,4,695,1652,0,42.07,13.86
屏東縣,南州鄉,溪南村,395,140,255,4,399,908,0,43.94,15.42
屏東縣,南州鄉,仁里村,221,86,135,2,223,487,0,45.79,17.66
屏東縣,南州鄉,溪北村,310,182,128,1,311,673,0,46.21,27.04
屏東縣,南州鄉,七塊村,366,126,240,3,369,1011,0,36.5,12.46
屏東縣,南州鄉,萬華村,362,133,229,6,368,965,0,38.13,13.78
屏東縣,南州鄉,米崙村,455,165,290,5,460,1028,0,44.75,16.05
屏東縣,南州鄉,壽元村,424,70,354,7,431,1050,0,41.05,6.67
屏東縣,南州鄉,同安村,422,96,326,4,426,965,0,44.15,9.95
屏東縣,南州鄉,南安村,237,60,177,3,240,515,0,46.6,11.65
屏東縣,南州鄉,合計,3883,1287,2596,39,3922,9254,10249,42.38,13.91
屏東縣,佳冬鄉,佳冬村,586,210,376,4,590,1467,0,40.22,14.31
屏東縣,佳冬鄉,六根村,540,193,347,8,548,1302,0,42.09,14.82
屏東縣,佳冬鄉,賴家村,344,96,248,1,345,733,0,47.07,13.1
屏東縣,佳冬鄉,萬建村,692,235,457,4,696,1793,0,38.82,13.11
屏東縣,佳冬鄉,石光村,800,205,595,9,809,1922,0,42.09,10.67
屏東縣,佳冬鄉,玉光村,791,193,598,15,806,2056,0,39.2,9.39
屏東縣,佳冬鄉,昌隆村,401,118,283,9,410,936,0,43.8,12.61
屏東縣,佳冬鄉,豐隆村,270,86,184,7,277,674,0,41.1,12.76
屏東縣,佳冬鄉,大同村,448,119,329,6,454,1138,0,39.89,10.46
屏東縣,佳冬鄉,羌園村,413,99,314,6,419,1061,0,39.49,9.33
屏東縣,佳冬鄉,燄溫村,356,124,232,4,360,1072,0,33.58,11.57
屏東縣,佳冬鄉,塭豐村,777,317,460,6,783,2355,0,33.25,13.46
屏東縣,佳冬鄉,合計,6418,1995,4423,79,6497,16509,18414,39.35,12.08
屏東縣,琉球鄉,本福村,500,243,257,4,504,2066,0,24.39,11.76
屏東縣,琉球鄉,中福村,271,133,138,3,274,1247,0,21.97,10.67
屏東縣,琉球鄉,漁福村,225,159,66,1,226,975,0,23.18,16.31
屏東縣,琉球鄉,大福村,291,175,116,2,293,1617,0,18.12,10.82
屏東縣,琉球鄉,南福村,193,104,89,1,194,1117,0,17.37,9.31
屏東縣,琉球鄉,天福村,197,108,89,1,198,1101,0,17.98,9.81
屏東縣,琉球鄉,上福村,260,147,113,2,262,1622,0,16.15,9.06
屏東縣,琉球鄉,杉福村,168,84,84,5,173,850,0,20.35,9.88
屏東縣,琉球鄉,合計,2105,1153,952,19,2124,10595,12095,20.05,10.88
屏東縣,車城鄉,福興村,484,215,269,8,492,1315,0,37.41,16.35
屏東縣,車城鄉,福安村,225,58,167,2,227,534,0,42.51,10.86
屏東縣,車城鄉,田中村,158,60,98,0,158,610,0,25.9,9.84
屏東縣,車城鄉,海口村,201,87,114,7,208,717,0,29.01,12.13
屏東縣,車城鄉,統埔村,111,43,68,0,111,370,0,30.0,11.62
屏東縣,車城鄉,溫泉村,269,109,160,4,273,837,0,32.62,13.02
屏東縣,車城鄉,保力村,351,145,206,9,360,1197,0,30.08,12.11
屏東縣,車城鄉,新街村,148,36,112,0,148,418,0,35.41,8.61
屏東縣,車城鄉,埔墘村,111,55,56,1,112,412,0,27.18,13.35
屏東縣,車城鄉,射寮村,152,74,78,2,154,481,0,32.02,15.38
屏東縣,車城鄉,後灣村,155,67,88,3,158,399,0,39.6,16.79
屏東縣,車城鄉,合計,2365,949,1416,36,2401,7290,8221,32.94,13.02
屏東縣,滿州鄉,滿州村,419,199,220,8,427,1429,0,29.88,13.93
屏東縣,滿州鄉,里德村,118,61,57,2,120,392,0,30.61,15.56
屏東縣,滿州鄉,永靖村,370,168,202,4,374,1208,0,30.96,13.91
屏東縣,滿州鄉,港口村,391,135,256,4,395,1223,0,32.3,11.04
屏東縣,滿州鄉,响林村,148,51,97,0,148,526,0,28.14,9.7
屏東縣,滿州鄉,長樂村,267,137,130,5,272,1255,0,21.67,10.92
屏東縣,滿州鄉,九棚村,90,41,49,0,90,348,0,25.86,11.78
屏東縣,滿州鄉,港仔村,97,46,51,1,98,305,0,32.13,15.08
屏東縣,滿州鄉,合計,1900,838,1062,24,1924,6686,7397,28.78,12.53
屏東縣,枋山鄉,枋山村,353,170,183,8,361,966,0,37.37,17.6
屏東縣,枋山鄉,加祿村,691,224,467,11,702,1872,0,37.5,11.97
屏東縣,枋山鄉,楓港村,291,70,221,3,294,962,0,30.56,7.28
屏東縣,枋山鄉,善餘村,248,76,172,3,251,837,0,29.99,9.08
屏東縣,枋山鄉,合計,1583,540,1043,25,1608,4637,5145,34.68,11.65
屏東縣,三地門鄉,三地村,556,432,124,10,566,1460,0,38.77,29.59
屏東縣,三地門鄉,達來村,95,59,36,1,96,341,0,28.15,17.3
屏東縣,三地門鄉,德文村,87,56,31,1,88,566,0,15.55,9.89
屏東縣,三地門鄉,大社村,175,146,29,3,178,639,0,27.86,22.85
屏東縣,三地門鄉,賽嘉村,218,158,60,3,221,725,0,30.48,21.79
屏東縣,三地門鄉,口社村,188,137,51,5,193,550,0,35.09,24.91
屏東縣,三地門鄉,馬兒村,100,66,34,1,101,341,0,29.62,19.35
屏東縣,三地門鄉,安坡村,154,112,42,4,158,468,0,33.76,23.93
屏東縣,三地門鄉,青山村,199,163,36,5,204,694,0,29.39,23.49
屏東縣,三地門鄉,青葉村,167,132,35,1,168,617,0,27.23,21.39
屏東縣,三地門鄉,合計,1939,1461,478,34,1973,6401,7691,30.82,22.82
屏東縣,霧臺鄉,霧台村,348,233,115,3,351,1089,0,32.23,21.4
屏東縣,霧臺鄉,阿禮村,105,87,18,2,107,297,0,36.03,29.29
屏東縣,霧臺鄉,吉露村,72,56,16,0,72,183,0,39.34,30.6
屏東縣,霧臺鄉,大武村,65,40,25,3,68,441,0,15.42,9.07
屏東縣,霧臺鄉,佳暮村,148,126,22,3,151,356,0,42.42,35.39
屏東縣,霧臺鄉,好茶村,185,110,75,2,187,476,0,39.29,23.11
屏東縣,霧臺鄉,合計,923,652,271,13,936,2842,3230,32.93,22.94
屏東縣,瑪家鄉,瑪家村,161,115,46,1,162,443,0,36.57,25.96
屏東縣,瑪家鄉,北葉村,311,237,74,2,313,771,0,40.6,30.74
屏東縣,瑪家鄉,凉山村,282,220,62,1,283,1041,0,27.19,21.13
屏東縣,瑪家鄉,佳義村,308,206,102,2,310,887,0,34.95,23.22
屏東縣,瑪家鄉,排灣村,135,109,26,0,135,419,0,32.22,26.01
屏東縣,瑪家鄉,三和村,782,625,157,7,789,2049,0,38.51,30.5
屏東縣,瑪家鄉,合計,1979,1512,467,13,1992,5610,6706,35.51,26.95
屏東縣,泰武鄉,佳平村,324,268,56,3,327,844,0,38.74,31.75
屏東縣,泰武鄉,武潭村,335,258,77,8,343,950,0,36.11,27.16
屏東縣,泰武鄉,平和村,212,117,95,1,213,610,0,34.92,19.18
屏東縣,泰武鄉,佳興村,115,93,22,3,118,408,0,28.92,22.79
屏東縣,泰武鄉,泰武村,207,176,31,4,211,772,0,27.33,22.8
屏東縣,泰武鄉,萬安村,255,224,31,0,255,748,0,34.09,29.95
屏東縣,泰武鄉,合計,1448,1136,312,19,1467,4332,5365,33.86,26.22
屏東縣,來義鄉,來義村,257,209,48,1,258,909,0,28.38,22.99
屏東縣,來義鄉,義林村,195,149,46,2,197,586,0,33.62,25.43
屏東縣,來義鄉,丹林村,260,222,38,2,262,709,0,36.95,31.31
屏東縣,來義鄉,古樓村,405,338,67,5,410,1112,0,36.87,30.4
屏東縣,來義鄉,文樂村,299,243,56,0,299,840,0,35.6,28.93
屏東縣,來義鄉,望嘉村,350,309,41,0,350,864,0,40.51,35.76
屏東縣,來義鄉,南和村,411,333,78,7,418,1197,0,34.92,27.82
屏東縣,來義鄉,合計,2177,1803,374,17,2194,6217,7400,35.29,29.0
屏東縣,春日鄉,春日村,191,147,44,2,193,923,0,20.91,15.93
屏東縣,春日鄉,古華村,185,138,47,4,189,685,0,27.59,20.15
屏東縣,春日鄉,士文村,56,38,18,5,61,311,0,19.61,12.22
屏東縣,春日鄉,七佳村,281,218,63,6,287,940,0,30.53,23.19
屏東縣,春日鄉,歸崇村,171,131,40,6,177,647,0,27.36,20.25
屏東縣,春日鄉,力里村,126,91,35,6,132,469,0,28.14,19.4
屏東縣,春日鄉,合計,1010,763,247,29,1039,3975,4912,26.14,19.19
屏東縣,獅子鄉,楓林村,221,172,49,5,226,702,0,32.19,24.5
屏東縣,獅子鄉,丹路村,201,168,33,6,207,759,0,27.27,22.13
屏東縣,獅子鄉,草埔村,214,183,31,3,217,626,0,34.66,29.23
屏東縣,獅子鄉,內文村,73,58,15,0,73,229,0,31.88,25.33
屏東縣,獅子鄉,竹坑村,95,72,23,3,98,293,0,33.45,24.57
屏東縣,獅子鄉,獅子村,146,119,27,1,147,490,0,30.0,24.29
屏東縣,獅子鄉,內獅村,219,179,40,6,225,624,0,36.06,28.69
屏東縣,獅子鄉,南世村,114,93,21,1,115,369,0,31.17,25.2
屏東縣,獅子鄉,合計,1283,1044,239,25,1308,4092,4805,31.96,25.51
屏東縣,牡丹鄉,石門村,500,395,105,6,506,1579,0,32.05,25.02
屏東縣,牡丹鄉,牡丹村,224,193,31,5,229,645,0,35.5,29.92
屏東縣,牡丹鄉,東源村,145,124,21,5,150,435,0,34.48,28.51
屏東縣,牡丹鄉,旭海村,128,95,33,2,130,359,0,36.21,26.46
屏東縣,牡丹鄉,高士村,151,118,33,1,152,567,0,26.81,20.81
屏東縣,牡丹鄉,四林村,105,71,34,3,108,549,0,19.67,12.93
屏東縣,牡丹鄉,合計,1253,996,257,22,1275,4134,4860,30.84,24.09
屏東縣,合計,合計,278295,109130,169165,3019,281314,700254,807970,40.17,15.58
宜蘭縣,宜蘭市,神農里,1053,489,564,10,1063,2534,0,41.95,19.3
宜蘭縣,宜蘭市,民權里,594,297,297,7,601,1744,0,34.46,17.03
宜蘭縣,宜蘭市,進士里,926,397,529,6,932,2115,0,44.07,18.77
宜蘭縣,宜蘭市,南橋里,521,208,313,8,529,1269,0,41.69,16.39
宜蘭縣,宜蘭市,建業里,848,311,537,3,851,1962,0,43.37,15.85
宜蘭縣,宜蘭市,南津里,876,432,444,14,890,2131,0,41.76,20.27
宜蘭縣,宜蘭市,凱旋里,520,183,337,6,526,1298,0,40.52,14.1
宜蘭縣,宜蘭市,黎明里,715,274,441,10,725,1846,0,39.27,14.84
宜蘭縣,宜蘭市,東村里,845,357,488,7,852,2200,0,38.73,16.23
宜蘭縣,宜蘭市,延平里,1189,508,681,14,1203,3263,0,36.87,15.57
宜蘭縣,宜蘭市,七張里,531,181,350,9,540,1459,0,37.01,12.41
宜蘭縣,宜蘭市,慈安里,606,273,333,5,611,1801,0,33.93,15.16
宜蘭縣,宜蘭市,新民里,650,224,426,9,659,1464,0,45.01,15.3
宜蘭縣,宜蘭市,東門里,401,128,273,1,402,951,0,42.27,13.46
宜蘭縣,宜蘭市,小東里,633,243,390,8,641,1595,0,40.19,15.24
宜蘭縣,宜蘭市,菜園里,524,243,281,3,527,1334,0,39.51,18.22
宜蘭縣,宜蘭市,孝廉里,449,150,299,1,450,1122,0,40.11,13.37
宜蘭縣,宜蘭市,新生里,942,321,621,11,953,2678,0,35.59,11.99
宜蘭縣,宜蘭市,茭白里,768,305,463,7,775,2080,0,37.26,14.66
宜蘭縣,宜蘭市,北津里,827,273,554,8,835,2200,0,37.95,12.41
宜蘭縣,宜蘭市,梅洲里,1157,389,768,6,1163,3159,0,36.82,12.31
宜蘭縣,宜蘭市,北門里,488,165,323,4,492,1112,0,44.24,14.84
宜蘭縣,宜蘭市,中山里,346,137,209,4,350,902,0,38.8,15.19
宜蘭縣,宜蘭市,西門里,739,242,497,6,745,1736,0,42.91,13.94
宜蘭縣,宜蘭市,南門里,553,224,329,4,557,1330,0,41.88,16.84
宜蘭縣,宜蘭市,負郭里,1179,458,721,10,1189,2908,0,40.89,15.75
宜蘭縣,宜蘭市,民族里,935,431,504,14,949,2157,0,44.0,19.98
宜蘭縣,宜蘭市,建軍里,647,295,352,7,654,1576,0,41.5,18.72
宜蘭縣,宜蘭市,思源里,1767,882,885,10,1777,4247,0,41.84,20.77
宜蘭縣,宜蘭市,文化里,1230,562,668,6,1236,2966,0,41.67,18.95
宜蘭縣,宜蘭市,復興里,1084,561,523,5,1089,2613,0,41.68,21.47
宜蘭縣,宜蘭市,成功里,1151,482,669,9,1160,3044,0,38.11,15.83
宜蘭縣,宜蘭市,新東里,1169,524,645,14,1183,3099,0,38.17,16.91
宜蘭縣,宜蘭市,七結里,1098,535,563,4,1102,2533,0,43.51,21.12
宜蘭縣,宜蘭市,泰山里,657,318,339,3,660,1969,0,33.52,16.15
宜蘭縣,宜蘭市,大新里,305,127,178,2,307,770,0,39.87,16.49
宜蘭縣,宜蘭市,中興里,1014,428,586,7,1021,2844,0,35.9,15.05
宜蘭縣,宜蘭市,擺厘里,1231,530,701,8,1239,2875,0,43.1,18.43
宜蘭縣,宜蘭市,合計,31168,13087,18081,270,31438,78886,95269,39.85,16.59
宜蘭縣,羅東鎮,大新里,618,221,397,7,625,1532,0,40.8,14.43
宜蘭縣,羅東鎮,東安里,1294,450,844,12,1306,3501,0,37.3,12.85
宜蘭縣,羅東鎮,新群里,1051,321,730,8,1059,2687,0,39.41,11.95
宜蘭縣,羅東鎮,羅莊里,1191,481,710,6,1197,3002,0,39.87,16.02
宜蘭縣,羅東鎮,南昌里,873,336,537,7,880,2352,0,37.41,14.29
宜蘭縣,羅東鎮,南豪里,549,205,344,8,557,1294,0,43.04,15.84
宜蘭縣,羅東鎮,成功里,631,239,392,2,633,1501,0,42.17,15.92
宜蘭縣,羅東鎮,仁德里,488,195,293,2,490,1123,0,43.63,17.36
宜蘭縣,羅東鎮,漢民里,1423,560,863,8,1431,3579,0,39.98,15.65
宜蘭縣,羅東鎮,西安里,1077,395,682,15,1092,2799,0,39.01,14.11
宜蘭縣,羅東鎮,北成里,1094,385,709,9,1103,2795,0,39.46,13.77
宜蘭縣,羅東鎮,賢文里,1389,560,829,13,1402,3502,0,40.03,15.99
宜蘭縣,羅東鎮,公正里,1126,429,697,12,1138,2641,0,43.09,16.24
宜蘭縣,羅東鎮,集祥里,370,135,235,4,374,1099,0,34.03,12.28
宜蘭縣,羅東鎮,信義里,1225,484,741,11,1236,2919,0,42.34,16.58
宜蘭縣,羅東鎮,竹林里,1161,395,766,13,1174,2844,0,41.28,13.89
宜蘭縣,羅東鎮,仁愛里,1484,520,964,12,1496,3570,0,41.9,14.57
宜蘭縣,羅東鎮,樹林里,1556,641,915,11,1567,3337,0,46.96,19.21
宜蘭縣,羅東鎮,國華里,1769,693,1076,16,1785,4280,0,41.71,16.19
宜蘭縣,羅東鎮,維揚里,1240,478,762,9,1249,2960,0,42.2,16.15
宜蘭縣,羅東鎮,開明里,567,191,376,9,576,1355,0,42.51,14.1
宜蘭縣,羅東鎮,中山里,531,152,379,8,539,1343,0,40.13,11.32
宜蘭縣,羅東鎮,仁和里,383,123,260,2,385,978,0,39.37,12.58
宜蘭縣,羅東鎮,合計,23090,8589,14501,204,23294,56993,71097,40.87,15.07
宜蘭縣,蘇澳鎮,龍德里,1197,381,816,22,1219,3347,0,36.42,11.38
宜蘭縣,蘇澳鎮,頂寮里,382,110,272,3,385,1020,0,37.75,10.78
宜蘭縣,蘇澳鎮,永榮里,1379,478,901,14,1393,3753,0,37.12,12.74
宜蘭縣,蘇澳鎮,存仁里,346,92,254,6,352,861,0,40.88,10.69
宜蘭縣,蘇澳鎮,港邊里,498,170,328,8,506,1218,0,41.54,13.96
宜蘭縣,蘇澳鎮,隘丁里,1151,385,766,11,1162,3062,0,37.95,12.57
宜蘭縣,蘇澳鎮,新城里,576,192,384,9,585,1452,0,40.29,13.22
宜蘭縣,蘇澳鎮,聖湖里,795,381,414,8,803,2219,0,36.19,17.17
宜蘭縣,蘇澳鎮,蘇西里,889,353,536,6,895,2348,0,38.12,15.03
宜蘭縣,蘇澳鎮,蘇北里,375,179,196,8,383,953,0,40.19,18.78
宜蘭縣,蘇澳鎮,蘇南里,216,88,128,1,217,437,0,49.66,20.14
宜蘭縣,蘇澳鎮,蘇東里,165,75,90,2,167,499,0,33.47,15.03
宜蘭縣,蘇澳鎮,長安里,183,65,118,2,185,521,0,35.51,12.48
宜蘭縣,蘇澳鎮,永光里,184,88,96,1,185,431,0,42.92,20.42
宜蘭縣,蘇澳鎮,永春里,193,74,119,1,194,573,0,33.86,12.91
宜蘭縣,蘇澳鎮,永樂里,153,61,92,0,153,439,0,34.85,13.9
宜蘭縣,蘇澳鎮,南安里,332,134,198,2,334,909,0,36.74,14.74
宜蘭縣,蘇澳鎮,南正里,333,95,238,2,335,893,0,37.51,10.64
宜蘭縣,蘇澳鎮,南成里,328,109,219,9,337,1052,0,32.03,10.36
宜蘭縣,蘇澳鎮,南興里,424,184,240,14,438,1414,0,30.98,13.01
宜蘭縣,蘇澳鎮,南寧里,343,138,205,8,351,1011,0,34.72,13.65
宜蘭縣,蘇澳鎮,南建里,402,121,281,6,408,1165,0,35.02,10.39
宜蘭縣,蘇澳鎮,東澳里,89,38,51,2,91,330,0,27.58,11.52
宜蘭縣,蘇澳鎮,南強里,222,62,160,4,226,691,0,32.71,8.97
宜蘭縣,蘇澳鎮,朝陽里,215,53,162,1,216,584,0,36.99,9.08
宜蘭縣,蘇澳鎮,聖愛里,920,351,569,5,925,2734,0,33.83,12.84
宜蘭縣,蘇澳鎮,合計,12290,4457,7833,155,12445,33916,38592,36.69,13.14
宜蘭縣,頭城鎮,石城里,81,22,59,0,81,304,0,26.64,7.24
宜蘭縣,頭城鎮,大里里,190,77,113,6,196,676,0,28.99,11.39
宜蘭縣,頭城鎮,大溪里,263,78,185,4,267,874,0,30.55,8.92
宜蘭縣,頭城鎮,合興里,86,31,55,0,86,345,0,24.93,8.99
宜蘭縣,頭城鎮,更新里,351,134,217,11,362,1352,0,26.78,9.91
宜蘭縣,頭城鎮,外澳里,243,101,142,0,243,862,0,28.19,11.72
宜蘭縣,頭城鎮,港口里,215,77,138,2,217,678,0,32.01,11.36
宜蘭縣,頭城鎮,武營里,565,276,289,8,573,1576,0,36.36,17.51
宜蘭縣,頭城鎮,大坑里,475,187,288,7,482,1356,0,35.55,13.79
宜蘭縣,頭城鎮,城東里,302,150,152,5,307,710,0,43.24,21.13
宜蘭縣,頭城鎮,城北里,198,111,87,2,200,488,0,40.98,22.75
宜蘭縣,頭城鎮,城西里,195,91,104,0,195,533,0,36.59,17.07
宜蘭縣,頭城鎮,城南里,265,121,144,2,267,645,0,41.4,18.76
宜蘭縣,頭城鎮,竹安里,575,233,342,7,582,2076,0,28.03,11.22
宜蘭縣,頭城鎮,新建里,700,310,390,8,708,2044,0,34.64,15.17
宜蘭縣,頭城鎮,拔雅里,716,294,422,10,726,2076,0,34.97,14.16
宜蘭縣,頭城鎮,福成里,295,119,176,4,299,931,0,32.12,12.78
宜蘭縣,頭城鎮,金面里,596,275,321,2,598,1711,0,34.95,16.07
宜蘭縣,頭城鎮,金盈里,225,102,123,2,227,692,0,32.8,14.74
宜蘭縣,頭城鎮,頂埔里,487,200,287,6,493,1301,0,37.89,15.37
宜蘭縣,頭城鎮,下埔里,307,105,202,4,311,909,0,34.21,11.55
宜蘭縣,頭城鎮,中崙里,312,128,184,1,313,1008,0,31.05,12.7
宜蘭縣,頭城鎮,二城里,339,132,207,7,346,1090,0,31.74,12.11
宜蘭縣,頭城鎮,龜山里,227,89,138,3,230,705,0,32.62,12.62
宜蘭縣,頭城鎮,合計,8208,3443,4765,101,8309,24942,28673,33.31,13.8
宜蘭縣,礁溪鄉,白雲村,527,195,332,6,533,1601,0,33.29,12.18
宜蘭縣,礁溪鄉,玉石村,706,297,409,7,713,1954,0,36.49,15.2
宜蘭縣,礁溪鄉,德陽村,1492,721,771,15,1507,3987,0,37.8,18.08
宜蘭縣,礁溪鄉,大忠村,922,408,514,12,934,2517,0,37.11,16.21
宜蘭縣,礁溪鄉,大義村,228,82,146,4,232,620,0,37.42,13.23
宜蘭縣,礁溪鄉,六結村,570,248,322,12,582,1372,0,42.42,18.08
宜蘭縣,礁溪鄉,二龍村,447,132,315,1,448,1198,0,37.4,11.02
宜蘭縣,礁溪鄉,時潮村,524,143,381,6,530,1460,0,36.3,9.79
宜蘭縣,礁溪鄉,玉田村,826,242,584,11,837,2114,0,39.59,11.45
宜蘭縣,礁溪鄉,三民村,842,283,559,12,854,2406,0,35.49,11.76
宜蘭縣,礁溪鄉,林美村,344,113,231,2,346,1132,0,30.57,9.98
宜蘭縣,礁溪鄉,白鵝村,293,103,190,4,297,830,0,35.78,12.41
宜蘭縣,礁溪鄉,玉光村,418,143,275,8,426,1059,0,40.23,13.5
宜蘭縣,礁溪鄉,光武村,479,150,329,4,483,1359,0,35.54,11.04
宜蘭縣,礁溪鄉,吳沙村,1032,345,687,10,1042,2526,0,41.25,13.66
宜蘭縣,礁溪鄉,龍潭村,1223,368,855,13,1236,3316,0,37.27,11.1
宜蘭縣,礁溪鄉,匏崙村,328,123,205,2,330,921,0,35.83,13.36
宜蘭縣,礁溪鄉,二結村,178,38,140,3,181,422,0,42.89,9.0
宜蘭縣,礁溪鄉,合計,11379,4134,7245,132,11511,30794,35091,37.38,13.42
宜蘭縣,壯圍鄉,吉祥村,976,352,624,10,986,2606,0,37.84,13.51
宜蘭縣,壯圍鄉,美福村,689,263,426,8,697,1928,0,36.15,13.64
宜蘭縣,壯圍鄉,新南村,365,125,240,6,371,931,0,39.85,13.43
宜蘭縣,壯圍鄉,東港村,280,79,201,3,283,979,0,28.91,8.07
宜蘭縣,壯圍鄉,復興村,518,146,372,7,525,1599,0,32.83,9.13
宜蘭縣,壯圍鄉,過嶺村,481,140,341,9,490,1492,0,32.84,9.38
宜蘭縣,壯圍鄉,永鎮村,305,90,215,3,308,792,0,38.89,11.36
宜蘭縣,壯圍鄉,忠孝村,872,279,593,14,886,2369,0,37.4,11.78
宜蘭縣,壯圍鄉,古亭村,593,198,395,2,595,1580,0,37.66,12.53
宜蘭縣,壯圍鄉,功勞村,502,158,344,4,506,1240,0,40.81,12.74
宜蘭縣,壯圍鄉,美城村,851,301,550,9,860,2246,0,38.29,13.4
宜蘭縣,壯圍鄉,新社村,379,122,257,9,388,1058,0,36.67,11.53
宜蘭縣,壯圍鄉,大福村,560,192,368,7,567,1756,0,32.29,10.93
宜蘭縣,壯圍鄉,古結村,419,142,277,3,422,1124,0,37.54,12.63
宜蘭縣,壯圍鄉,合計,7790,2587,5203,94,7884,21700,24419,36.33,11.92
宜蘭縣,員山鄉,員山村,2142,831,1311,22,2164,5810,0,37.25,14.3
宜蘭縣,員山鄉,尚德村,757,261,496,9,766,2164,0,35.4,12.06
宜蘭縣,員山鄉,惠好村,672,198,474,7,679,1676,0,40.51,11.81
宜蘭縣,員山鄉,七賢村,554,236,318,4,558,1505,0,37.08,15.68
宜蘭縣,員山鄉,深溝村,772,271,501,6,778,1941,0,40.08,13.96
宜蘭縣,員山鄉,蓁巷村,442,119,323,5,447,1249,0,35.79,9.53
宜蘭縣,員山鄉,內城村,450,187,263,11,461,1436,0,32.1,13.02
宜蘭縣,員山鄉,中華村,228,74,154,2,230,608,0,37.83,12.17
宜蘭縣,員山鄉,永和村,652,222,430,9,661,1818,0,36.36,12.21
宜蘭縣,員山鄉,頭分村,471,164,307,8,479,1340,0,35.75,12.24
宜蘭縣,員山鄉,枕山村,866,232,634,9,875,2277,0,38.43,10.19
宜蘭縣,員山鄉,同樂村,887,275,612,11,898,2403,0,37.37,11.44
宜蘭縣,員山鄉,湖東村,306,99,207,3,309,888,0,34.8,11.15
宜蘭縣,員山鄉,逸仙村,338,93,245,7,345,926,0,37.26,10.04
宜蘭縣,員山鄉,湖北村,350,128,222,4,354,997,0,35.51,12.84
宜蘭縣,員山鄉,湖西村,445,127,318,8,453,1363,0,33.24,9.32
宜蘭縣,員山鄉,合計,10332,3517,6815,125,10457,28401,32189,36.82,12.38
宜蘭縣,冬山鄉,武淵村,470,117,353,3,473,1262,0,37.48,9.27
宜蘭縣,冬山鄉,珍珠村,693,175,518,12,705,1625,0,43.38,10.77
宜蘭縣,冬山鄉,補城村,456,141,315,2,458,1136,0,40.32,12.41
宜蘭縣,冬山鄉,三奇村,318,99,219,4,322,894,0,36.02,11.07
宜蘭縣,冬山鄉,大興村,345,77,268,10,355,867,0,40.95,8.88
宜蘭縣,冬山鄉,東城村,545,175,370,5,550,1409,0,39.03,12.42
宜蘭縣,冬山鄉,香和村,1091,293,798,14,1105,2951,0,37.44,9.93
宜蘭縣,冬山鄉,南興村,1175,350,825,8,1183,2943,0,40.2,11.89
宜蘭縣,冬山鄉,冬山村,315,108,207,5,320,673,0,47.55,16.05
宜蘭縣,冬山鄉,安平村,281,59,222,3,284,709,0,40.06,8.32
宜蘭縣,冬山鄉,太和村,653,178,475,2,655,1498,0,43.72,11.88
宜蘭縣,冬山鄉,八寶村,355,93,262,6,361,870,0,41.49,10.69
宜蘭縣,冬山鄉,丸山村,546,135,411,4,550,1512,0,36.38,8.93
宜蘭縣,冬山鄉,中山村,207,55,152,1,208,474,0,43.88,11.6
宜蘭縣,冬山鄉,順安村,1829,552,1277,21,1850,4962,0,37.28,11.12
宜蘭縣,冬山鄉,永美村,1193,375,818,12,1205,3096,0,38.92,12.11
宜蘭縣,冬山鄉,群英村,1899,637,1262,25,1924,4619,0,41.65,13.79
宜蘭縣,冬山鄉,清溝村,1521,541,980,16,1537,3769,0,40.78,14.35
宜蘭縣,冬山鄉,鹿埔村,883,242,641,11,894,2557,0,34.96,9.46
宜蘭縣,冬山鄉,得安村,368,150,218,3,371,1080,0,34.35,13.89
宜蘭縣,冬山鄉,廣興村,927,306,621,10,937,2509,0,37.35,12.2
宜蘭縣,冬山鄉,廣安村,692,238,454,6,698,1680,0,41.55,14.17
宜蘭縣,冬山鄉,柯林村,748,247,501,6,754,1761,0,42.82,14.03
宜蘭縣,冬山鄉,大進村,309,79,230,4,313,780,0,40.13,10.13
宜蘭縣,冬山鄉,合計,17819,5422,12397,193,18012,45636,52999,39.47,11.88
宜蘭縣,五結鄉,三興村,802,227,575,8,810,2052,0,39.47,11.06
宜蘭縣,五結鄉,二結村,785,295,490,10,795,1872,0,42.47,15.76
宜蘭縣,五結鄉,鎮安村,1092,359,733,9,1101,2629,0,41.88,13.66
宜蘭縣,五結鄉,上四村,660,239,421,6,666,1563,0,42.61,15.29
宜蘭縣,五結鄉,中興村,501,162,339,3,504,1350,0,37.33,12.0
宜蘭縣,五結鄉,四結村,1109,409,700,10,1119,2551,0,43.87,16.03
宜蘭縣,五結鄉,福興村,739,218,521,7,746,1777,0,41.98,12.27
宜蘭縣,五結鄉,五結村,1343,453,890,16,1359,3725,0,36.48,12.16
宜蘭縣,五結鄉,大吉村,1439,514,925,9,1448,3727,0,38.85,13.79
宜蘭縣,五結鄉,協和村,1208,355,853,16,1224,3260,0,37.55,10.89
宜蘭縣,五結鄉,孝威村,639,169,470,4,643,1654,0,38.88,10.22
宜蘭縣,五結鄉,錦眾村,555,199,356,2,557,1417,0,39.31,14.04
宜蘭縣,五結鄉,利澤村,672,187,485,11,683,1951,0,35.01,9.58
宜蘭縣,五結鄉,成興村,1145,284,861,11,1156,3177,0,36.39,8.94
宜蘭縣,五結鄉,季新村,999,286,713,7,1006,2761,0,36.44,10.36
宜蘭縣,五結鄉,合計,13688,4356,9332,129,13817,35466,40343,38.96,12.28
宜蘭縣,三星鄉,員山村,83,37,46,0,83,207,0,40.1,17.87
宜蘭縣,三星鄉,天山村,147,56,91,3,150,498,0,30.12,11.24
宜蘭縣,三星鄉,天福村,234,76,158,5,239,712,0,33.57,10.67
宜蘭縣,三星鄉,雙賢村,246,71,175,2,248,553,0,44.85,12.84
宜蘭縣,三星鄉,人和村,158,64,94,1,159,448,0,35.49,14.29
宜蘭縣,三星鄉,義德村,406,171,235,2,408,1133,0,36.01,15.09
宜蘭縣,三星鄉,集慶村,429,162,267,5,434,1145,0,37.9,14.15
宜蘭縣,三星鄉,月眉村,306,116,190,4,310,870,0,35.63,13.33
宜蘭縣,三星鄉,拱照村,395,118,277,2,397,1358,0,29.23,8.69
宜蘭縣,三星鄉,大隱村,1539,519,1020,12,1551,4328,0,35.84,11.99
宜蘭縣,三星鄉,行健村,331,90,241,6,337,890,0,37.87,10.11
宜蘭縣,三星鄉,萬德村,238,80,158,3,241,586,0,41.13,13.65
宜蘭縣,三星鄉,貴林村,188,71,117,4,192,525,0,36.57,13.52
宜蘭縣,三星鄉,萬富村,281,97,184,4,285,731,0,38.99,13.27
宜蘭縣,三星鄉,大義村,520,153,367,6,526,1266,0,41.55,12.09
宜蘭縣,三星鄉,尚武村,287,97,190,3,290,758,0,38.26,12.8
宜蘭縣,三星鄉,大洲村,747,222,525,7,754,1581,0,47.69,14.04
宜蘭縣,三星鄉,尾塹村,605,168,437,7,612,1458,0,41.98,11.52
宜蘭縣,三星鄉,合計,7140,2368,4772,76,7216,19047,21219,37.89,12.43
宜蘭縣,大同鄉,寒溪村,288,249,39,2,290,923,0,31.42,26.98
宜蘭縣,大同鄉,崙埤村,184,163,21,5,189,629,0,30.05,25.91
宜蘭縣,大同鄉,松羅村,200,137,63,4,204,701,0,29.1,19.54
宜蘭縣,大同鄉,復興村,100,53,47,0,100,262,0,38.17,20.23
宜蘭縣,大同鄉,英士村,98,76,22,1,99,325,0,30.46,23.38
宜蘭縣,大同鄉,樂水村,112,97,15,1,113,392,0,28.83,24.74
宜蘭縣,大同鄉,太平村,18,11,7,0,18,54,0,33.33,20.37
宜蘭縣,大同鄉,四季村,185,151,34,3,188,763,0,24.64,19.79
宜蘭縣,大同鄉,南山村,126,94,32,2,128,659,0,19.42,14.26
宜蘭縣,大同鄉,茂安村,58,43,15,0,58,207,0,28.02,20.77
宜蘭縣,大同鄉,合計,1369,1074,295,18,1387,4915,6099,28.22,21.85
宜蘭縣,南澳鄉,南澳村,297,245,52,8,305,1156,0,26.38,21.19
宜蘭縣,南澳鄉,碧候村,236,205,31,3,239,955,0,25.03,21.47
宜蘭縣,南澳鄉,東岳村,153,125,28,0,153,435,0,35.17,28.74
宜蘭縣,南澳鄉,金岳村,86,79,7,2,88,406,0,21.67,19.46
宜蘭縣,南澳鄉,武塔村,130,107,23,3,133,430,0,30.93,24.88
宜蘭縣,南澳鄉,金洋村,126,105,21,1,127,475,0,26.74,22.11
宜蘭縣,南澳鄉,澳花村,229,204,25,7,236,707,0,33.38,28.85
宜蘭縣,南澳鄉,合計,1257,1070,187,24,1281,4564,5956,28.07,23.44
宜蘭縣,合計,合計,145530,54104,91426,1521,147051,385260,451946,38.17,14.04
花蓮縣,花蓮市,民立里,621,405,216,5,626,1592,0,39.32,25.44
花蓮縣,花蓮市,民運里,820,540,280,18,838,1985,0,42.22,27.2
花蓮縣,花蓮市,民族里,167,107,60,2,169,422,0,40.05,25.36
花蓮縣,花蓮市,主信里,273,158,115,2,275,664,0,41.42,23.8
花蓮縣,花蓮市,主睦里,206,122,84,0,206,558,0,36.92,21.86
花蓮縣,花蓮市,主和里,1094,685,409,11,1105,2927,0,37.75,23.4
花蓮縣,花蓮市,國威里,576,330,246,7,583,1769,0,32.96,18.65
花蓮縣,花蓮市,國風里,1249,801,448,12,1261,3186,0,39.58,25.14
花蓮縣,花蓮市,民德里,657,419,238,2,659,1486,0,44.35,28.2
花蓮縣,花蓮市,民意里,805,658,147,14,819,2020,0,40.54,32.57
花蓮縣,花蓮市,主義里,198,130,68,0,198,464,0,42.67,28.02
花蓮縣,花蓮市,主工里,227,131,96,1,228,492,0,46.34,26.63
花蓮縣,花蓮市,主農里,1329,862,467,14,1343,3477,0,38.63,24.79
花蓮縣,花蓮市,國治里,300,178,122,5,305,821,0,37.15,21.68
花蓮縣,花蓮市,國富里,1960,1277,683,17,1977,4822,0,41.0,26.48
花蓮縣,花蓮市,民政里,1537,1060,477,11,1548,3629,0,42.66,29.21
花蓮縣,花蓮市,民勤里,1250,855,395,19,1269,3092,0,41.04,27.65
花蓮縣,花蓮市,民生里,424,235,189,6,430,1077,0,39.93,21.82
花蓮縣,花蓮市,主商里,215,110,105,1,216,537,0,40.22,20.48
花蓮縣,花蓮市,主學里,715,444,271,9,724,1821,0,39.76,24.38
花蓮縣,花蓮市,國光里,466,318,148,5,471,1214,0,38.8,26.19
花蓮縣,花蓮市,國聯里,1022,621,401,5,1027,2759,0,37.22,22.51
花蓮縣,花蓮市,國強里,643,417,226,3,646,1757,0,36.77,23.73
花蓮縣,花蓮市,民心里,380,261,119,3,383,932,0,41.09,28.0
花蓮縣,花蓮市,民樂里,238,160,78,2,240,616,0,38.96,25.97
花蓮縣,花蓮市,民主里,208,153,55,1,209,549,0,38.07,27.87
花蓮縣,花蓮市,主勤里,333,198,135,2,335,763,0,43.91,25.95
花蓮縣,花蓮市,主力里,1047,640,407,8,1055,2643,0,39.92,24.21
花蓮縣,花蓮市,國安里,198,124,74,2,200,496,0,40.32,25.0
花蓮縣,花蓮市,國魂里,776,475,301,12,788,1849,0,42.62,25.69
花蓮縣,花蓮市,國慶里,405,224,181,3,408,1069,0,38.17,20.95
花蓮縣,花蓮市,民享里,1221,896,325,8,1229,3012,0,40.8,29.75
花蓮縣,花蓮市,民有里,222,119,103,0,222,584,0,38.01,20.38
花蓮縣,花蓮市,民權里,173,117,56,0,173,419,0,41.29,27.92
花蓮縣,花蓮市,主計里,305,202,103,1,306,817,0,37.45,24.72
花蓮縣,花蓮市,主權里,1975,1308,667,23,1998,5198,0,38.44,25.16
花蓮縣,花蓮市,國華里,870,550,320,4,874,2120,0,41.23,25.94
花蓮縣,花蓮市,國防里,316,188,128,1,317,816,0,38.85,23.04
花蓮縣,花蓮市,國福里,465,332,133,5,470,1480,0,31.76,22.43
花蓮縣,花蓮市,國裕里,1618,1102,516,10,1628,4171,0,39.03,26.42
花蓮縣,花蓮市,主安里,856,572,284,10,866,2412,0,35.9,23.71
花蓮縣,花蓮市,國盛里,1237,824,413,7,1244,3671,0,33.89,22.45
花蓮縣,花蓮市,國興里,1684,1139,545,15,1699,4204,0,40.41,27.09
花蓮縣,花蓮市,民孝里,1406,1017,389,16,1422,3438,0,41.36,29.58
花蓮縣,花蓮市,合計,32687,21464,11223,302,32989,83830,101853,39.35,25.6
花蓮縣,鳳林鎮,鳳仁里,433,298,135,11,444,1166,0,38.08,25.56
花蓮縣,鳳林鎮,鳳義里,261,205,56,5,266,631,0,42.16,32.49
花蓮縣,鳳林鎮,鳳禮里,260,180,80,3,263,575,0,45.74,31.3
花蓮縣,鳳林鎮,鳳智里,408,312,96,4,412,1075,0,38.33,29.02
花蓮縣,鳳林鎮,鳳信里,463,355,108,14,477,1332,0,35.81,26.65
花蓮縣,鳳林鎮,山興里,167,131,36,8,175,539,0,32.47,24.3
花蓮縣,鳳林鎮,大榮里,458,293,165,6,464,1250,0,37.12,23.44
花蓮縣,鳳林鎮,北林里,204,110,94,4,208,538,0,38.66,20.45
花蓮縣,鳳林鎮,南平里,208,137,71,3,211,524,0,40.27,26.15
花蓮縣,鳳林鎮,林榮里,339,235,104,3,342,793,0,43.13,29.63
花蓮縣,鳳林鎮,長橋里,319,212,107,8,327,959,0,34.1,22.11
花蓮縣,鳳林鎮,森榮里,44,36,8,0,44,97,0,45.36,37.11
花蓮縣,鳳林鎮,合計,3564,2504,1060,69,3633,9479,10764,38.33,26.42
花蓮縣,玉里鎮,中城里,1743,1166,577,19,1762,5047,0,34.91,23.1
花蓮縣,玉里鎮,啟模里,474,330,144,8,482,1587,0,30.37,20.79
花蓮縣,玉里鎮,永昌里,335,239,96,5,340,1191,0,28.55,20.07
花蓮縣,玉里鎮,泰昌里,336,248,88,3,339,1281,0,26.46,19.36
花蓮縣,玉里鎮,國武里,446,287,159,5,451,1150,0,39.22,24.96
花蓮縣,玉里鎮,源城里,314,220,94,4,318,1204,0,26.41,18.27
花蓮縣,玉里鎮,長良里,148,113,35,4,152,606,0,25.08,18.65
花蓮縣,玉里鎮,樂合里,280,229,51,7,287,963,0,29.8,23.78
花蓮縣,玉里鎮,東豐里,153,116,37,3,156,521,0,29.94,22.26
花蓮縣,玉里鎮,觀音里,399,304,95,11,410,1500,0,27.33,20.27
花蓮縣,玉里鎮,松浦里,306,232,74,10,316,1449,0,21.81,16.01
花蓮縣,玉里鎮,春日里,251,182,69,11,262,838,0,31.26,21.72
花蓮縣,玉里鎮,德武里,201,159,42,11,212,750,0,28.27,21.2
花蓮縣,玉里鎮,三民里,241,155,86,5,246,864,0,28.47,17.94
花蓮縣,玉里鎮,大禹里,284,214,70,1,285,1039,0,27.43,20.6
花蓮縣,玉里鎮,合計,5911,4194,1717,107,6018,19990,23121,30.11,20.98
花蓮縣,新城鄉,新城村,498,309,189,13,511,1249,0,40.91,24.74
花蓮縣,新城鄉,順安村,310,134,176,8,318,901,0,35.29,14.87
花蓮縣,新城鄉,康樂村,803,536,267,15,818,2413,0,33.9,22.21
花蓮縣,新城鄉,北埔村,1440,1005,435,17,1457,4113,0,35.42,24.43
花蓮縣,新城鄉,佳林村,370,246,124,2,372,992,0,37.5,24.8
花蓮縣,新城鄉,嘉里村,1247,904,343,13,1260,3787,0,33.27,23.87
花蓮縣,新城鄉,嘉新村,393,303,90,5,398,1243,0,32.02,24.38
花蓮縣,新城鄉,大漢村,879,679,200,19,898,2511,0,35.76,27.04
花蓮縣,新城鄉,合計,5940,4116,1824,92,6032,17209,20015,35.05,23.92
花蓮縣,吉安鄉,北昌村,2912,1867,1045,22,2934,7104,0,41.3,26.28
花蓮縣,吉安鄉,勝安村,2017,1272,745,12,2029,4909,0,41.33,25.91
花蓮縣,吉安鄉,太昌村,1273,782,491,28,1301,3726,0,34.92,20.99
花蓮縣,吉安鄉,永安村,1642,1099,543,11,1653,4253,0,38.87,25.84
花蓮縣,吉安鄉,慶豐村,2603,1734,869,25,2628,6951,0,37.81,24.95
花蓮縣,吉安鄉,吉安村,2024,1383,641,19,2043,5283,0,38.67,26.18
花蓮縣,吉安鄉,福興村,1171,739,432,22,1193,2931,0,40.7,25.21
花蓮縣,吉安鄉,南華村,603,346,257,11,614,1568,0,39.16,22.07
花蓮縣,吉安鄉,干城村,415,320,95,4,419,1280,0,32.73,25.0
花蓮縣,吉安鄉,永興村,1006,724,282,12,1018,2922,0,34.84,24.78
花蓮縣,吉安鄉,稻香村,1215,831,384,15,1230,3170,0,38.8,26.21
花蓮縣,吉安鄉,南昌村,1473,1032,441,12,1485,4138,0,35.89,24.94
花蓮縣,吉安鄉,宜昌村,1515,1014,501,11,1526,3933,0,38.8,25.78
花蓮縣,吉安鄉,仁里村,2292,1563,729,20,2312,5995,0,38.57,26.07
花蓮縣,吉安鄉,東昌村,2007,1458,549,32,2039,5503,0,37.05,26.49
花蓮縣,吉安鄉,仁安村,731,482,249,12,743,2360,0,31.48,20.42
花蓮縣,吉安鄉,仁和村,1512,1020,492,10,1522,4520,0,33.67,22.57
花蓮縣,吉安鄉,光華村,750,575,175,17,767,1987,0,38.6,28.94
花蓮縣,吉安鄉,合計,27161,18241,8920,295,27456,72533,83515,37.85,25.15
花蓮縣,壽豐鄉,樹湖村,138,84,54,1,139,352,0,39.49,23.86
花蓮縣,壽豐鄉,溪口村,385,258,127,6,391,1019,0,38.37,25.32
花蓮縣,壽豐鄉,豐山村,652,441,211,12,664,1879,0,35.34,23.47
花蓮縣,壽豐鄉,豐裡村,472,300,172,5,477,1317,0,36.22,22.78
花蓮縣,壽豐鄉,豐坪村,296,207,89,3,299,900,0,33.22,23.0
花蓮縣,壽豐鄉,共和村,318,219,99,1,319,729,0,43.76,30.04
花蓮縣,壽豐鄉,壽豐村,575,374,201,10,585,1627,0,35.96,22.99
花蓮縣,壽豐鄉,光榮村,284,231,53,4,288,772,0,37.31,29.92
花蓮縣,壽豐鄉,池南村,294,198,96,8,302,747,0,40.43,26.51
花蓮縣,壽豐鄉,平和村,534,312,222,6,540,1402,0,38.52,22.25
花蓮縣,壽豐鄉,志學村,935,540,395,6,941,2522,0,37.31,21.41
花蓮縣,壽豐鄉,米棧村,110,80,30,4,114,259,0,44.02,30.89
花蓮縣,壽豐鄉,月眉村,267,213,54,3,270,816,0,33.09,26.1
花蓮縣,壽豐鄉,水璉村,230,176,54,7,237,700,0,33.86,25.14
花蓮縣,壽豐鄉,鹽寮村,167,115,52,1,168,503,0,33.4,22.86
花蓮縣,壽豐鄉,合計,5657,3748,1909,77,5734,15544,17427,36.89,24.11
花蓮縣,光復鄉,大安村,320,204,116,1,321,809,0,39.68,25.22
花蓮縣,光復鄉,大華村,414,257,157,12,426,1258,0,33.86,20.43
花蓮縣,光復鄉,大平村,270,210,60,13,283,918,0,30.83,22.88
花蓮縣,光復鄉,大馬村,254,211,43,4,258,970,0,26.6,21.75
花蓮縣,光復鄉,大同村,353,246,107,4,357,1018,0,35.07,24.17
花蓮縣,光復鄉,大進村,178,127,51,2,180,435,0,41.38,29.2
花蓮縣,光復鄉,大全村,226,142,84,5,231,765,0,30.2,18.56
花蓮縣,光復鄉,大興村,160,128,32,0,160,454,0,35.24,28.19
花蓮縣,光復鄉,大富村,105,64,41,2,107,302,0,35.43,21.19
花蓮縣,光復鄉,大豐村,143,92,51,4,147,409,0,35.94,22.49
花蓮縣,光復鄉,東富村,293,248,45,7,300,990,0,30.3,25.05
花蓮縣,光復鄉,西富村,308,233,75,10,318,928,0,34.27,25.11
花蓮縣,光復鄉,南富村,252,174,78,11,263,820,0,32.07,21.22
花蓮縣,光復鄉,北富村,255,211,44,5,260,880,0,29.55,23.98
花蓮縣,光復鄉,合計,3531,2547,984,80,3611,10956,12280,32.96,23.25
花蓮縣,豐濱鄉,豐濱村,404,301,103,16,420,1596,0,26.32,18.86
花蓮縣,豐濱鄉,新社村,160,121,39,8,168,614,0,27.36,19.71
花蓮縣,豐濱鄉,磯崎村,118,99,19,2,120,390,0,30.77,25.38
花蓮縣,豐濱鄉,港口村,226,163,63,9,235,721,0,32.59,22.61
花蓮縣,豐濱鄉,靜浦村,183,157,26,5,188,645,0,29.15,24.34
花蓮縣,豐濱鄉,合計,1091,841,250,40,1131,3966,4341,28.52,21.21
花蓮縣,瑞穗鄉,瑞穗村,630,436,194,5,635,1828,0,34.74,23.85
花蓮縣,瑞穗鄉,瑞美村,635,436,199,10,645,1800,0,35.83,24.22
花蓮縣,瑞穗鄉,瑞良村,194,126,68,2,196,520,0,37.69,24.23
花蓮縣,瑞穗鄉,瑞祥村,295,191,104,2,297,923,0,32.18,20.69
花蓮縣,瑞穗鄉,瑞北村,160,120,40,7,167,580,0,28.79,20.69
花蓮縣,瑞穗鄉,舞鶴村,301,209,92,5,306,941,0,32.52,22.21
花蓮縣,瑞穗鄉,鶴岡村,250,200,50,3,253,867,0,29.18,23.07
花蓮縣,瑞穗鄉,奇美村,73,62,11,3,76,332,0,22.89,18.67
花蓮縣,瑞穗鄉,富源村,203,135,68,5,208,740,0,28.11,18.24
花蓮縣,瑞穗鄉,富民村,220,183,37,9,229,825,0,27.76,22.18
花蓮縣,瑞穗鄉,富興村,198,117,81,8,206,579,0,35.58,20.21
花蓮縣,瑞穗鄉,合計,3159,2215,944,59,3218,9935,11248,32.39,22.29
花蓮縣,富里鄉,吳江村,125,94,31,4,129,471,0,27.39,19.96
花蓮縣,富里鄉,東里村,232,148,84,5,237,970,0,24.43,15.26
花蓮縣,富里鄉,萬寧村,174,142,32,5,179,613,0,29.2,23.16
花蓮縣,富里鄉,新興村,144,104,40,5,149,573,0,26.0,18.15
花蓮縣,富里鄉,竹田村,317,234,83,3,320,1040,0,30.77,22.5
花蓮縣,富里鄉,羅山村,126,90,36,5,131,428,0,30.61,21.03
花蓮縣,富里鄉,石牌村,231,167,64,8,239,864,0,27.66,19.33
花蓮縣,富里鄉,明里村,132,92,40,2,134,368,0,36.41,25.0
花蓮縣,富里鄉,富里村,399,243,156,7,406,1306,0,31.09,18.61
花蓮縣,富里鄉,永豐村,148,100,48,3,151,442,0,34.16,22.62
花蓮縣,富里鄉,豐南村,158,129,29,11,169,597,0,28.31,21.61
花蓮縣,富里鄉,富南村,135,80,55,3,138,491,0,28.11,16.29
花蓮縣,富里鄉,學田村,193,108,85,10,203,622,0,32.64,17.36
花蓮縣,富里鄉,合計,2514,1731,783,71,2585,8785,9897,29.43,19.7
花蓮縣,秀林鄉,崇德村,381,318,63,3,384,1423,0,26.99,22.35
花蓮縣,秀林鄉,富世村,580,407,173,6,586,1842,0,31.81,22.1
花蓮縣,秀林鄉,秀林村,524,386,138,6,530,1790,0,29.61,21.56
花蓮縣,秀林鄉,水源村,387,328,59,4,391,1188,0,32.91,27.61
花蓮縣,秀林鄉,銅門村,397,331,66,9,406,1217,0,33.36,27.2
花蓮縣,秀林鄉,文蘭村,347,297,50,0,347,1126,0,30.82,26.38
花蓮縣,秀林鄉,景美村,500,363,137,9,509,1791,0,28.42,20.27
花蓮縣,秀林鄉,佳民村,357,304,53,2,359,1048,0,34.26,29.01
花蓮縣,秀林鄉,和平村,456,332,124,4,460,1541,0,29.85,21.54
花蓮縣,秀林鄉,合計,3929,3066,863,43,3972,12966,16204,30.63,23.65
花蓮縣,萬榮鄉,西林村,297,251,46,6,303,1044,0,29.02,24.04
花蓮縣,萬榮鄉,見晴村,121,103,18,0,121,515,0,23.5,20.0
花蓮縣,萬榮鄉,萬榮村,196,160,36,3,199,757,0,26.29,21.14
花蓮縣,萬榮鄉,明利村,181,152,29,3,184,639,0,28.79,23.79
花蓮縣,萬榮鄉,馬遠村,261,206,55,7,268,1075,0,24.93,19.16
花蓮縣,萬榮鄉,紅葉村,260,218,42,2,262,1050,0,24.95,20.76
花蓮縣,萬榮鄉,合計,1316,1090,226,21,1337,5080,6174,26.32,21.46
花蓮縣,卓溪鄉,崙山村,139,124,15,3,142,523,0,27.15,23.71
花蓮縣,卓溪鄉,立山村,235,207,28,7,242,969,0,24.97,21.36
花蓮縣,卓溪鄉,太平村,238,212,26,5,243,691,0,35.17,30.68
花蓮縣,卓溪鄉,卓溪村,191,170,21,3,194,721,0,26.91,23.58
花蓮縣,卓溪鄉,卓清村,230,207,23,6,236,1017,0,23.21,20.35
花蓮縣,卓溪鄉,古風村,287,252,35,6,293,897,0,32.66,28.09
花蓮縣,卓溪鄉,合計,1320,1172,148,30,1350,4818,5997,28.02,24.33
花蓮縣,合計,合計,97780,66929,30851,1286,99066,275091,322836,36.01,24.33
臺東縣,臺東市,富岡里,451,315,136,10,461,1446,0,31.88,21.78
臺東縣,臺東市,富豐里,255,165,90,6,261,865,0,30.17,19.08
臺東縣,臺東市,岩灣里,761,496,265,6,767,2210,0,34.71,22.44
臺東縣,臺東市,南王里,891,598,293,7,898,2796,0,32.12,21.39
臺東縣,臺東市,卑南里,1237,692,545,8,1245,2822,0,44.12,24.52
臺東縣,臺東市,南榮里,898,604,294,7,905,2707,0,33.43,22.31
臺東縣,臺東市,新生里,2326,1511,815,14,2340,6528,0,35.85,23.15
臺東縣,臺東市,民生里,1275,723,552,18,1293,3035,0,42.6,23.82
臺東縣,臺東市,寶桑里,301,164,137,2,303,826,0,36.68,19.85
臺東縣,臺東市,馬蘭里,942,650,292,6,948,2489,0,38.09,26.11
臺東縣,臺東市,中心里,1199,772,427,10,1209,3004,0,40.25,25.7
臺東縣,臺東市,自強里,1590,982,608,9,1599,3981,0,40.17,24.67
臺東縣,臺東市,民族里,480,263,217,2,482,1313,0,36.71,20.03
臺東縣,臺東市,四維里,220,155,65,2,222,638,0,34.8,24.29
臺東縣,臺東市,中華里,563,311,252,5,568,1628,0,34.89,19.1
臺東縣,臺東市,強國里,215,128,87,4,219,620,0,35.32,20.65
臺東縣,臺東市,建國里,398,226,172,3,401,1215,0,33.0,18.6
臺東縣,臺東市,民權里,326,183,143,2,328,813,0,40.34,22.51
臺東縣,臺東市,仁愛里,269,145,124,0,269,683,0,39.39,21.23
臺東縣,臺東市,中正里,346,184,162,2,348,768,0,45.31,23.96
臺東縣,臺東市,大同里,274,163,111,1,275,727,0,37.83,22.42
臺東縣,臺東市,成功里,290,146,144,0,290,762,0,38.06,19.16
臺東縣,臺東市,文化里,242,138,104,4,246,941,0,26.14,14.67
臺東縣,臺東市,中山里,316,179,137,3,319,736,0,43.34,24.32
臺東縣,臺東市,復國里,177,110,67,1,178,575,0,30.96,19.13
臺東縣,臺東市,興國里,268,124,144,3,271,711,0,38.12,17.44
臺東縣,臺東市,復興里,136,81,55,0,136,400,0,34.0,20.25
臺東縣,臺東市,鐵花里,154,86,68,1,155,389,0,39.85,22.11
臺東縣,臺東市,新園里,543,351,192,10,553,1604,0,34.48,21.88
臺東縣,臺東市,豐田里,728,397,331,10,738,2224,0,33.18,17.85
臺東縣,臺東市,豐年里,962,614,348,13,975,3044,0,32.03,20.17
臺東縣,臺東市,光明里,975,638,337,5,980,2559,0,38.3,24.93
臺東縣,臺東市,豐樂里,490,307,183,2,492,1481,0,33.22,20.73
臺東縣,臺東市,永樂里,724,448,276,5,729,2117,0,34.44,21.16
臺東縣,臺東市,康樂里,392,234,158,8,400,1309,0,30.56,17.88
臺東縣,臺東市,東海里,1028,660,368,12,1040,2638,0,39.42,25.02
臺東縣,臺東市,新興里,327,192,135,3,330,940,0,35.11,20.43
臺東縣,臺東市,豐榮里,2899,1891,1008,23,2922,8103,0,36.06,23.34
臺東縣,臺東市,豐谷里,1496,1020,476,13,1509,5024,0,30.04,20.3
臺東縣,臺東市,豐里里,750,414,336,4,754,2362,0,31.92,17.53
臺東縣,臺東市,豐原里,414,209,205,9,423,1214,0,34.84,17.22
臺東縣,臺東市,建和里,467,316,151,2,469,1392,0,33.69,22.7
臺東縣,臺東市,建興里,344,190,154,4,348,952,0,36.55,19.96
臺東縣,臺東市,建業里,385,227,158,3,388,1256,0,30.89,18.07
臺東縣,臺東市,知本里,458,284,174,7,465,1365,0,34.07,20.81
臺東縣,臺東市,建農里,570,429,141,15,585,1990,0,29.4,21.56
臺東縣,臺東市,合計,30752,19115,11637,284,31036,87202,104445,35.59,21.92
臺東縣,成功鎮,博愛里,202,166,36,10,212,596,0,35.57,27.85
臺東縣,成功鎮,忠孝里,228,156,72,8,236,935,0,25.24,16.68
臺東縣,成功鎮,三仙里,303,220,83,7,310,1337,0,23.19,16.45
臺東縣,成功鎮,三民里,655,505,150,19,674,2619,0,25.74,19.28
臺東縣,成功鎮,忠智里,578,398,180,6,584,1823,0,32.04,21.83
臺東縣,成功鎮,忠仁里,635,410,225,4,639,2079,0,30.74,19.72
臺東縣,成功鎮,和平里,188,139,49,5,193,725,0,26.62,19.17
臺東縣,成功鎮,信義里,501,398,103,9,510,1773,0,28.76,22.45
臺東縣,成功鎮,合計,3290,2392,898,68,3358,11887,13396,28.25,20.12
臺東縣,關山鎮,德高里,452,300,152,16,468,1682,0,27.82,17.84
臺東縣,關山鎮,豐泉里,378,263,115,4,382,1084,0,35.24,24.26
臺東縣,關山鎮,新福里,282,175,107,7,289,865,0,33.41,20.23
臺東縣,關山鎮,中福里,312,189,123,4,316,752,0,42.02,25.13
臺東縣,關山鎮,里壠里,527,387,140,4,531,1611,0,32.96,24.02
臺東縣,關山鎮,電光里,164,114,50,2,166,528,0,31.44,21.59
臺東縣,關山鎮,月眉里,187,107,80,7,194,689,0,28.16,15.53
臺東縣,關山鎮,合計,2302,1535,767,44,2346,7211,8330,32.53,21.29
臺東縣,卑南鄉,嘉豐村,135,83,52,5,140,486,0,28.81,17.08
臺東縣,卑南鄉,利吉村,154,115,39,1,155,449,0,34.52,25.61
臺東縣,卑南鄉,富山村,152,115,37,2,154,467,0,32.98,24.63
臺東縣,卑南鄉,富源村,118,58,60,2,120,333,0,36.04,17.42
臺東縣,卑南鄉,明峰村,341,187,154,5,346,1149,0,30.11,16.28
臺東縣,卑南鄉,初鹿村,365,224,141,5,370,1236,0,29.94,18.12
臺東縣,卑南鄉,美農村,358,171,187,7,365,1068,0,34.18,16.01
臺東縣,卑南鄉,賓朗村,727,408,319,9,736,2211,0,33.29,18.45
臺東縣,卑南鄉,泰安村,324,211,113,5,329,1122,0,29.32,18.81
臺東縣,卑南鄉,太平村,995,669,326,13,1008,3124,0,32.27,21.41
臺東縣,卑南鄉,利嘉村,403,302,101,5,408,1094,0,37.29,27.61
臺東縣,卑南鄉,東興村,390,327,63,10,400,1133,0,35.3,28.86
臺東縣,卑南鄉,溫泉村,345,126,219,5,350,1066,0,32.83,11.82
臺東縣,卑南鄉,合計,4807,2996,1811,74,4881,14938,16897,32.68,20.06
臺東縣,鹿野鄉,瑞和村,149,92,57,2,151,650,0,23.23,14.15
臺東縣,鹿野鄉,瑞豐村,318,134,184,5,323,871,0,37.08,15.38
臺東縣,鹿野鄉,瑞源村,220,131,89,7,227,835,0,27.19,15.69
臺東縣,鹿野鄉,永安村,427,269,158,0,427,1440,0,29.65,18.68
臺東縣,鹿野鄉,瑞隆村,216,144,72,5,221,858,0,25.76,16.78
臺東縣,鹿野鄉,鹿野村,321,234,87,6,327,1026,0,31.87,22.81
臺東縣,鹿野鄉,龍田村,367,168,199,6,373,1033,0,36.11,16.26
臺東縣,鹿野鄉,合計,2018,1172,846,31,2049,6713,7514,30.52,17.46
臺東縣,池上鄉,福文村,299,166,133,5,304,1091,0,27.86,15.22
臺東縣,池上鄉,慶豐村,214,133,81,6,220,660,0,33.33,20.15
臺東縣,池上鄉,大坡村,73,53,20,2,75,322,0,23.29,16.46
臺東縣,池上鄉,大埔村,250,163,87,8,258,773,0,33.38,21.09
臺東縣,池上鄉,福原村,660,386,274,10,670,1890,0,35.45,20.42
臺東縣,池上鄉,錦園村,93,40,53,5,98,337,0,29.08,11.87
臺東縣,池上鄉,新興村,254,141,113,4,258,832,0,31.01,16.95
臺東縣,池上鄉,萬安村,109,53,56,5,114,304,0,37.5,17.43
臺東縣,池上鄉,富興村,127,86,41,1,128,393,0,32.57,21.88
臺東縣,池上鄉,振興村,78,47,31,3,81,428,0,18.93,10.98
臺東縣,池上鄉,合計,2157,1268,889,49,2206,7030,8018,31.38,18.04
臺東縣,東河鄉,北源村,340,259,81,8,348,1544,0,22.54,16.77
臺東縣,東河鄉,泰源村,244,179,65,12,256,1127,0,22.72,15.88
臺東縣,東河鄉,東河村,263,191,72,5,268,951,0,28.18,20.08
臺東縣,東河鄉,尚德村,82,55,27,0,82,252,0,32.54,21.83
臺東縣,東河鄉,隆昌村,163,114,49,1,164,511,0,32.09,22.31
臺東縣,東河鄉,興昌村,293,177,116,3,296,886,0,33.41,19.98
臺東縣,東河鄉,都蘭村,670,427,243,16,686,2087,0,32.87,20.46
臺東縣,東河鄉,合計,2055,1402,653,45,2100,7358,8123,28.54,19.05
臺東縣,長濱鄉,樟原村,190,143,47,1,191,599,0,31.89,23.87
臺東縣,長濱鄉,三間村,332,267,65,12,344,1145,0,30.04,23.32
臺東縣,長濱鄉,忠勇村,124,81,43,5,129,519,0,24.86,15.61
臺東縣,長濱鄉,長濱村,587,402,185,7,594,1898,0,31.3,21.18
臺東縣,長濱鄉,竹湖村,258,164,94,6,264,853,0,30.95,19.23
臺東縣,長濱鄉,寧埔村,346,271,75,12,358,1154,0,31.02,23.48
臺東縣,長濱鄉,合計,1837,1328,509,43,1880,6168,6828,30.48,21.53
臺東縣,太麻里鄉,美和村,377,163,214,7,384,1297,0,29.61,12.57
臺東縣,太麻里鄉,三和村,193,103,90,4,197,589,0,33.45,17.49
臺東縣,太麻里鄉,華源村,187,84,103,5,192,588,0,32.65,14.29
臺東縣,太麻里鄉,北里村,187,96,91,3,190,564,0,33.69,17.02
臺東縣,太麻里鄉,泰和村,447,281,166,6,453,1352,0,33.51,20.78
臺東縣,太麻里鄉,大王村,575,382,193,12,587,1720,0,34.13,22.21
臺東縣,太麻里鄉,香蘭村,260,169,91,12,272,811,0,33.54,20.84
臺東縣,太麻里鄉,金崙村,423,360,63,11,434,1705,0,25.45,21.11
臺東縣,太麻里鄉,多良村,271,231,40,8,279,900,0,31.0,25.67
臺東縣,太麻里鄉,合計,2920,1869,1051,68,2988,9526,10806,31.37,19.62
臺東縣,大武鄉,大竹村,207,174,33,9,216,733,0,29.47,23.74
臺東縣,大武鄉,大鳥村,288,268,20,7,295,1061,0,27.8,25.26
臺東縣,大武鄉,大武村,344,247,97,7,351,1229,0,28.56,20.1
臺東縣,大武鄉,尚武村,332,172,160,11,343,1341,0,25.58,12.83
臺東縣,大武鄉,南興村,170,131,39,4,174,528,0,32.95,24.81
臺東縣,大武鄉,合計,1341,992,349,38,1379,4892,5663,28.19,20.28
臺東縣,綠島鄉,公舘村,198,155,43,4,202,986,0,20.49,15.72
臺東縣,綠島鄉,中寮村,169,128,41,3,172,1038,0,16.57,12.33
臺東縣,綠島鄉,南寮村,257,194,63,3,260,1538,0,16.91,12.61
臺東縣,綠島鄉,合計,624,477,147,10,634,3562,4083,17.8,13.39
臺東縣,海端鄉,廣原村,194,169,25,3,197,730,0,26.99,23.15
臺東縣,海端鄉,霧鹿村,103,83,20,2,105,251,0,41.83,33.07
臺東縣,海端鄉,利稻村,67,38,29,1,68,261,0,26.05,14.56
臺東縣,海端鄉,海端村,223,187,36,5,228,957,0,23.82,19.54
臺東縣,海端鄉,崁頂村,163,133,30,2,165,575,0,28.7,23.13
臺東縣,海端鄉,加拿村,143,122,21,2,145,501,0,28.94,24.35
臺東縣,海端鄉,合計,893,732,161,15,908,3275,4132,27.73,22.35
臺東縣,延平鄉,武陵村,181,159,22,7,188,593,0,31.7,26.81
臺東縣,延平鄉,永康村,112,102,10,1,113,318,0,35.53,32.08
臺東縣,延平鄉,紅葉村,135,114,21,3,138,421,0,32.78,27.08
臺東縣,延平鄉,鸞山村,145,128,17,3,148,577,0,25.65,22.18
臺東縣,延平鄉,桃源村,293,199,94,6,299,1003,0,29.81,19.84
臺東縣,延平鄉,合計,866,702,164,20,886,2912,3575,30.43,24.11
臺東縣,金峰鄉,新興村,244,211,33,5,249,512,0,48.63,41.21
臺東縣,金峰鄉,正興村,253,225,28,6,259,603,0,42.95,37.31
臺東縣,金峰鄉,嘉蘭村,377,322,55,10,387,1235,0,31.34,26.07
臺東縣,金峰鄉,賓茂村,122,112,10,2,124,325,0,38.15,34.46
臺東縣,金峰鄉,歷坵村,121,108,13,6,127,329,0,38.6,32.83
臺東縣,金峰鄉,合計,1117,978,139,29,1146,3004,3673,38.15,32.56
臺東縣,達仁鄉,台坂村,231,196,35,5,236,589,0,40.07,33.28
臺東縣,達仁鄉,土坂村,275,234,41,3,278,851,0,32.67,27.5
臺東縣,達仁鄉,新化村,98,83,15,2,100,334,0,29.94,24.85
臺東縣,達仁鄉,安朔村,207,163,44,2,209,548,0,38.14,29.74
臺東縣,達仁鄉,森永村,143,115,28,0,143,359,0,39.83,32.03
臺東縣,達仁鄉,南田村,107,91,16,2,109,309,0,35.28,29.45
臺東縣,達仁鄉,合計,1061,882,179,14,1075,2990,3450,35.95,29.5
臺東縣,蘭嶼鄉,東清村,208,116,92,2,210,1293,0,16.24,8.97
臺東縣,蘭嶼鄉,朗島村,128,38,90,10,138,773,0,17.85,4.92
臺東縣,蘭嶼鄉,紅頭村,267,157,110,10,277,1256,0,22.05,12.5
臺東縣,蘭嶼鄉,椰油村,186,133,53,3,189,968,0,19.52,13.74
臺東縣,蘭嶼鄉,合計,789,444,345,25,814,4290,5199,18.97,10.35
臺東縣,合計,合計,58829,38284,20545,857,59686,182958,214132,32.62,20.93
澎湖縣,馬公市,復興里,137,81,56,0,137,496,0,27.62,16.33
澎湖縣,馬公市,長安里,217,121,96,3,220,534,0,41.2,22.66
澎湖縣,馬公市,中央里,198,94,104,3,201,520,0,38.65,18.08
澎湖縣,馬公市,啟明里,334,145,189,2,336,872,0,38.53,16.63
澎湖縣,馬公市,重慶里,375,162,213,6,381,932,0,40.88,17.38
澎湖縣,馬公市,中興里,270,156,114,1,271,785,0,34.52,19.87
澎湖縣,馬公市,光復里,647,321,326,3,650,1903,0,34.16,16.87
澎湖縣,馬公市,光榮里,1480,960,520,17,1497,4135,0,36.2,23.22
澎湖縣,馬公市,光明里,411,245,166,5,416,1175,0,35.4,20.85
澎湖縣,馬公市,朝陽里,1666,911,755,4,1670,5179,0,32.25,17.59
澎湖縣,馬公市,陽明里,765,389,376,6,771,2417,0,31.9,16.09
澎湖縣,馬公市,重光里,509,252,257,7,516,1483,0,34.79,16.99
澎湖縣,馬公市,西衛里,1777,1019,758,17,1794,5825,0,30.8,17.49
澎湖縣,馬公市,西文里,997,544,453,5,1002,3202,0,31.29,16.99
澎湖縣,馬公市,東文里,987,534,453,9,996,3283,0,30.34,16.27
澎湖縣,馬公市,案山里,558,293,265,10,568,1855,0,30.62,15.8
澎湖縣,馬公市,光華里,221,136,85,3,224,979,0,22.88,13.89
澎湖縣,馬公市,前寮里,289,128,161,2,291,953,0,30.54,13.43
澎湖縣,馬公市,石泉里,879,508,371,4,883,2661,0,33.18,19.09
澎湖縣,馬公市,菜園里,145,71,74,0,145,439,0,33.03,16.17
澎湖縣,馬公市,東衛里,672,409,263,7,679,2134,0,31.82,19.17
澎湖縣,馬公市,安宅里,199,107,92,5,204,650,0,31.38,16.46
澎湖縣,馬公市,烏崁里,357,123,234,7,364,1060,0,34.34,11.6
澎湖縣,馬公市,興仁里,385,210,175,6,391,1240,0,31.53,16.94
澎湖縣,馬公市,鐵線里,229,71,158,1,230,677,0,33.97,10.49
澎湖縣,馬公市,山水里,513,194,319,8,521,1707,0,30.52,11.36
澎湖縣,馬公市,鎖港里,763,242,521,5,768,2539,0,30.25,9.53
澎湖縣,馬公市,五德里,97,54,43,0,97,470,0,20.64,11.49
澎湖縣,馬公市,井垵里,114,55,59,2,116,378,0,30.69,14.55
澎湖縣,馬公市,嵵裡里,303,182,121,6,309,1162,0,26.59,15.66
澎湖縣,馬公市,風櫃里,385,105,280,2,387,1368,0,28.29,7.68
澎湖縣,馬公市,虎井里,132,80,52,2,134,812,0,16.5,9.85
澎湖縣,馬公市,桶盤里,43,23,20,1,44,314,0,14.01,7.32
澎湖縣,馬公市,合計,17054,8925,8129,159,17213,54139,62912,31.79,16.49
澎湖縣,湖西鄉,湖西村,365,197,168,5,370,1199,0,30.86,16.43
澎湖縣,湖西鄉,湖東村,98,45,53,1,99,358,0,27.65,12.57
澎湖縣,湖西鄉,青螺村,66,36,30,2,68,243,0,27.98,14.81
澎湖縣,湖西鄉,白坑村,86,40,46,5,91,297,0,30.64,13.47
澎湖縣,湖西鄉,南寮村,181,44,137,3,184,683,0,26.94,6.44
澎湖縣,湖西鄉,北寮村,87,45,42,0,87,327,0,26.61,13.76
澎湖縣,湖西鄉,紅羅村,217,70,147,5,222,748,0,29.68,9.36
澎湖縣,湖西鄉,西溪村,167,74,93,4,171,839,0,20.38,8.82
澎湖縣,湖西鄉,成功村,291,125,166,3,294,860,0,34.19,14.53
澎湖縣,湖西鄉,東石村,49,16,33,1,50,123,0,40.65,13.01
澎湖縣,湖西鄉,中西村,73,36,37,2,75,221,0,33.94,16.29
澎湖縣,湖西鄉,潭邊村,108,55,53,2,110,300,0,36.67,18.33
澎湖縣,湖西鄉,鼎灣村,131,72,59,3,134,641,0,20.9,11.23
澎湖縣,湖西鄉,許家村,102,55,47,0,102,389,0,26.22,14.14
澎湖縣,湖西鄉,沙港村,261,61,200,3,264,807,0,32.71,7.56
澎湖縣,湖西鄉,城北村,120,74,46,3,123,334,0,36.83,22.16
澎湖縣,湖西鄉,太武村,31,14,17,1,32,94,0,34.04,14.89
澎湖縣,湖西鄉,隘門村,282,141,141,5,287,911,0,31.5,15.48
澎湖縣,湖西鄉,林投村,296,108,188,7,303,1004,0,30.18,10.76
澎湖縣,湖西鄉,尖山村,195,68,127,0,195,670,0,29.1,10.15
澎湖縣,湖西鄉,龍門村,541,245,296,3,544,1760,0,30.91,13.92
澎湖縣,湖西鄉,菓葉村,228,70,158,5,233,762,0,30.58,9.19
澎湖縣,湖西鄉,合計,3975,1691,2284,63,4038,13570,15248,29.76,12.46
澎湖縣,白沙鄉,中屯村,166,88,78,4,170,525,0,32.38,16.76
澎湖縣,白沙鄉,講美村,207,121,86,0,207,671,0,30.85,18.03
澎湖縣,白沙鄉,城前村,51,32,19,1,52,110,0,47.27,29.09
澎湖縣,白沙鄉,鎮海村,47,39,8,1,48,156,0,30.77,25.0
澎湖縣,白沙鄉,港子村,77,41,36,3,80,297,0,26.94,13.8
澎湖縣,白沙鄉,岐頭村,48,30,18,0,48,216,0,22.22,13.89
澎湖縣,白沙鄉,小赤村,62,32,30,1,63,168,0,37.5,19.05
澎湖縣,白沙鄉,赤崁村,465,242,223,5,470,1719,0,27.34,14.08
澎湖縣,白沙鄉,瓦硐村,89,45,44,1,90,307,0,29.32,14.66
澎湖縣,白沙鄉,後寮村,213,81,132,3,216,766,0,28.2,10.57
澎湖縣,白沙鄉,通梁村,203,84,119,3,206,798,0,25.81,10.53
澎湖縣,白沙鄉,吉貝村,263,59,204,2,265,1412,0,18.77,4.18
澎湖縣,白沙鄉,鳥嶼村,235,178,57,2,237,1110,0,21.35,16.04
澎湖縣,白沙鄉,員貝村,64,56,8,1,65,274,0,23.72,20.44
澎湖縣,白沙鄉,大倉村,49,11,38,2,51,269,0,18.96,4.09
澎湖縣,白沙鄉,合計,2239,1139,1100,29,2268,8798,9915,25.78,12.95
澎湖縣,西嶼鄉,橫礁村,56,21,35,1,57,301,0,18.94,6.98
澎湖縣,西嶼鄉,合界村,99,36,63,1,100,415,0,24.1,8.67
澎湖縣,西嶼鄉,小門村,94,64,30,3,97,285,0,34.04,22.46
澎湖縣,西嶼鄉,竹灣村,218,83,135,4,222,817,0,27.17,10.16
澎湖縣,西嶼鄉,大池村,189,72,117,1,190,665,0,28.57,10.83
澎湖縣,西嶼鄉,二崁村,56,14,42,1,57,145,0,39.31,9.66
澎湖縣,西嶼鄉,池東村,179,76,103,5,184,642,0,28.66,11.84
澎湖縣,西嶼鄉,池西村,62,15,47,2,64,225,0,28.44,6.67
澎湖縣,西嶼鄉,赤馬村,142,45,97,0,142,580,0,24.48,7.76
澎湖縣,西嶼鄉,內垵村,323,96,227,4,327,1265,0,25.85,7.59
澎湖縣,西嶼鄉,外垵村,479,337,142,2,481,2058,0,23.37,16.38
澎湖縣,西嶼鄉,合計,1897,859,1038,24,1921,7398,8309,25.97,11.61
澎湖縣,望安鄉,東安村,131,57,74,2,133,723,0,18.4,7.88
澎湖縣,望安鄉,西安村,92,52,40,0,92,436,0,21.1,11.93
澎湖縣,望安鄉,中社村,53,19,34,2,55,342,0,16.08,5.56
澎湖縣,望安鄉,水垵村,94,33,61,2,96,487,0,19.71,6.78
澎湖縣,望安鄉,將軍村,174,44,130,6,180,1425,0,12.63,3.09
澎湖縣,望安鄉,東坪村,18,10,8,0,18,527,0,3.42,1.9
澎湖縣,望安鄉,西坪村,8,3,5,0,8,220,0,3.64,1.36
澎湖縣,望安鄉,東吉村,36,17,19,2,38,296,0,12.84,5.74
澎湖縣,望安鄉,花嶼村,50,36,14,1,51,323,0,15.79,11.15
澎湖縣,望安鄉,合計,656,271,385,15,671,4779,5401,14.04,5.67
澎湖縣,七美鄉,東湖村,22,10,12,1,23,259,0,8.88,3.86
澎湖縣,七美鄉,西湖村,63,34,29,0,63,573,0,10.99,5.93
澎湖縣,七美鄉,中和村,69,40,29,3,72,643,0,11.2,6.22
澎湖縣,七美鄉,平和村,58,27,31,0,58,367,0,15.8,7.36
澎湖縣,七美鄉,海豐村,46,22,24,0,46,377,0,12.2,5.84
澎湖縣,七美鄉,南港村,142,94,48,4,146,1148,0,12.72,8.19
澎湖縣,七美鄉,合計,400,227,173,8,408,3367,3849,12.12,6.74
澎湖縣,合計,合計,26221,13112,13109,298,26519,92051,105634,28.81,14.24
基隆市,中正區,德義里,309,153,156,0,309,649,0,47.61,23.57
基隆市,中正區,正義里,543,295,248,5,548,1166,0,47.0,25.3
基隆市,中正區,信義里,371,189,182,3,374,874,0,42.79,21.62
基隆市,中正區,義重里,400,214,186,7,407,991,0,41.07,21.59
基隆市,中正區,港通里,583,285,298,4,587,1177,0,49.87,24.21
基隆市,中正區,中船里,467,216,251,0,467,1117,0,41.81,19.34
基隆市,中正區,正船里,532,301,231,8,540,1217,0,44.37,24.73
基隆市,中正區,入船里,320,175,145,8,328,752,0,43.62,23.27
基隆市,中正區,中砂里,545,312,233,8,553,1594,0,34.69,19.57
基隆市,中正區,正砂里,993,585,408,11,1004,2260,0,44.42,25.88
基隆市,中正區,真砂里,604,330,274,7,611,1294,0,47.22,25.5
基隆市,中正區,砂灣里,811,485,326,8,819,1981,0,41.34,24.48
基隆市,中正區,建國里,779,492,287,16,795,1945,0,40.87,25.3
基隆市,中正區,中濱里,510,280,230,4,514,1245,0,41.29,22.49
基隆市,中正區,海濱里,391,236,155,5,396,1125,0,35.2,20.98
基隆市,中正區,社寮里,677,297,380,6,683,1688,0,40.46,17.59
基隆市,中正區,和憲里,298,178,120,5,303,920,0,32.93,19.35
基隆市,中正區,平寮里,458,191,267,2,460,1211,0,37.99,15.77
基隆市,中正區,八斗里,601,167,434,4,605,1442,0,41.96,11.58
基隆市,中正區,碧砂里,401,155,246,4,405,1212,0,33.42,12.79
基隆市,中正區,長潭里,202,61,141,4,206,439,0,46.92,13.9
基隆市,中正區,砂子里,1832,873,959,14,1846,5622,0,32.84,15.53
基隆市,中正區,中正里,574,285,289,4,578,1615,0,35.79,17.65
基隆市,中正區,正濱里,356,195,161,5,361,907,0,39.8,21.5
基隆市,中正區,新豐里,2152,1277,875,12,2164,5731,0,37.76,22.28
基隆市,中正區,新富里,1616,889,727,15,1631,5124,0,31.83,17.35
基隆市,中正區,合計,17325,9116,8209,169,17494,45298,50967,38.62,20.12
基隆市,七堵區,長興里,1397,743,654,17,1414,3732,0,37.89,19.91
基隆市,七堵區,正光里,1022,499,523,6,1028,2522,0,40.76,19.79
基隆市,七堵區,富民里,1458,801,657,17,1475,3476,0,42.43,23.04
基隆市,七堵區,永平里,835,448,387,3,838,1877,0,44.65,23.87
基隆市,七堵區,永安里,936,514,422,11,947,2193,0,43.18,23.44
基隆市,七堵區,八德里,590,300,290,8,598,1482,0,40.35,20.24
基隆市,七堵區,自強里,471,256,215,8,479,1165,0,41.12,21.97
基隆市,七堵區,六堵里,833,405,428,7,840,2268,0,37.04,17.86
基隆市,七堵區,泰安里,1643,857,786,23,1666,4366,0,38.16,19.63
基隆市,七堵區,堵北里,1382,636,746,14,1396,3616,0,38.61,17.59
基隆市,七堵區,堵南里,730,346,384,10,740,2070,0,35.75,16.71
基隆市,七堵區,瑪南里,165,70,95,1,166,402,0,41.29,17.41
基隆市,七堵區,瑪東里,104,55,49,1,105,317,0,33.12,17.35
基隆市,七堵區,瑪西里,132,56,76,1,133,325,0,40.92,17.23
基隆市,七堵區,友一里,913,522,391,8,921,1965,0,46.87,26.56
基隆市,七堵區,友二里,227,87,140,7,234,448,0,52.23,19.42
基隆市,七堵區,正明里,793,429,364,28,821,1879,0,43.69,22.83
基隆市,七堵區,百福里,2139,1053,1086,10,2149,6051,0,35.51,17.4
基隆市,七堵區,實踐里,1392,678,714,10,1402,3772,0,37.17,17.97
基隆市,七堵區,長安里,840,432,408,8,848,2505,0,33.85,17.25
基隆市,七堵區,合計,18002,9187,8815,198,18200,46431,53534,39.2,19.79
基隆市,暖暖區,八西里,556,292,264,7,563,1390,0,40.5,21.01
基隆市,暖暖區,八堵里,277,130,147,3,280,641,0,43.68,20.28
基隆市,暖暖區,八南里,268,123,145,0,268,754,0,35.54,16.31
基隆市,暖暖區,過港里,1495,846,649,11,1506,3626,0,41.53,23.33
基隆市,暖暖區,碇內里,1050,581,469,6,1056,2636,0,40.06,22.04
基隆市,暖暖區,碇和里,1273,824,449,7,1280,2957,0,43.29,27.87
基隆市,暖暖區,暖同里,1000,569,431,12,1012,2529,0,40.02,22.5
基隆市,暖暖區,暖暖里,1087,570,517,13,1100,2563,0,42.92,22.24
基隆市,暖暖區,暖東里,142,62,80,3,145,405,0,35.8,15.31
基隆市,暖暖區,暖西里,1944,1011,933,15,1959,4724,0,41.47,21.4
基隆市,暖暖區,八中里,175,86,89,0,175,408,0,42.89,21.08
基隆市,暖暖區,碇安里,1991,1073,918,25,2016,4877,0,41.34,22.0
基隆市,暖暖區,碇祥里,2194,1263,931,31,2225,5937,0,37.48,21.27
基隆市,暖暖區,合計,13452,7430,6022,133,13585,33447,38494,40.62,22.21
基隆市,仁愛區,林泉里,642,329,313,7,649,1698,0,38.22,19.38
基隆市,仁愛區,花崗里,426,222,204,6,432,1015,0,42.56,21.87
基隆市,仁愛區,虹橋里,638,341,297,5,643,1481,0,43.42,23.02
基隆市,仁愛區,水錦里,697,388,309,4,701,1716,0,40.85,22.61
基隆市,仁愛區,智仁里,914,499,415,4,918,2263,0,40.57,22.05
基隆市,仁愛區,和明里,683,374,309,9,692,1653,0,41.86,22.63
基隆市,仁愛區,忠勇里,357,156,201,4,361,924,0,39.07,16.88
基隆市,仁愛區,玉田里,419,202,217,2,421,945,0,44.55,21.38
基隆市,仁愛區,仁德里,383,176,207,1,384,840,0,45.71,20.95
基隆市,仁愛區,博愛里,687,352,335,8,695,1413,0,49.19,24.91
基隆市,仁愛區,福仁里,330,137,193,6,336,730,0,46.03,18.77
基隆市,仁愛區,誠仁里,387,176,211,3,390,917,0,42.53,19.19
基隆市,仁愛區,吉仁里,990,478,512,5,995,2538,0,39.2,18.83
基隆市,仁愛區,育仁里,277,103,174,2,279,710,0,39.3,14.51
基隆市,仁愛區,英仁里,475,218,257,3,478,1247,0,38.33,17.48
基隆市,仁愛區,龍門里,313,131,182,4,317,770,0,41.17,17.01
基隆市,仁愛區,德厚里,721,374,347,2,723,1698,0,42.58,22.03
基隆市,仁愛區,曲水里,349,147,202,5,354,790,0,44.81,18.61
基隆市,仁愛區,崇文里,386,187,199,6,392,846,0,46.34,22.1
基隆市,仁愛區,文安里,281,131,150,4,285,820,0,34.76,15.98
基隆市,仁愛區,兆連里,300,169,131,3,303,670,0,45.22,25.22
基隆市,仁愛區,獅球里,339,188,151,7,346,957,0,36.15,19.64
基隆市,仁愛區,書院里,373,180,193,6,379,1056,0,35.89,17.05
基隆市,仁愛區,朝棟里,1142,711,431,19,1161,2712,0,42.81,26.22
基隆市,仁愛區,明德里,314,155,159,1,315,676,0,46.6,22.93
基隆市,仁愛區,同風里,247,114,133,1,248,548,0,45.26,20.8
基隆市,仁愛區,文昌里,367,141,226,2,369,692,0,53.32,20.38
基隆市,仁愛區,新店里,276,135,141,6,282,571,0,49.39,23.64
基隆市,仁愛區,光華里,1032,512,520,4,1036,2507,0,41.32,20.42
基隆市,仁愛區,合計,14745,7426,7319,139,14884,35403,42303,42.04,20.98
基隆市,中山區,新建里,355,189,166,2,357,769,0,46.42,24.58
基隆市,中山區,安民里,495,240,255,3,498,992,0,50.2,24.19
基隆市,中山區,安平里,313,151,162,5,318,750,0,42.4,20.13
基隆市,中山區,中山里,373,150,223,6,379,962,0,39.4,15.59
基隆市,中山區,民治里,346,194,152,4,350,749,0,46.73,25.9
基隆市,中山區,中興里,506,276,230,8,514,1221,0,42.1,22.6
基隆市,中山區,仁正里,306,182,124,4,310,742,0,41.78,24.53
基隆市,中山區,健民里,494,248,246,7,501,1138,0,44.02,21.79
基隆市,中山區,通化里,374,214,160,11,385,961,0,40.06,22.27
基隆市,中山區,居仁里,480,279,201,8,488,1266,0,38.55,22.04
基隆市,中山區,通明里,686,336,350,8,694,1710,0,40.58,19.65
基隆市,中山區,協和里,581,296,285,10,591,1512,0,39.09,19.58
基隆市,中山區,文化里,359,184,175,1,360,1271,0,28.32,14.48
基隆市,中山區,仙洞里,229,121,108,2,231,563,0,41.03,21.49
基隆市,中山區,太白里,316,151,165,4,320,864,0,37.04,17.48
基隆市,中山區,西榮里,273,116,157,7,280,654,0,42.81,17.74
基隆市,中山區,西華里,405,192,213,4,409,828,0,49.4,23.19
基隆市,中山區,西定里,339,161,178,7,346,904,0,38.27,17.81
基隆市,中山區,西康里,571,274,297,9,580,1556,0,37.28,17.61
基隆市,中山區,德和里,2460,1423,1037,19,2479,5331,0,46.5,26.69
基隆市,中山區,中和里,2144,1236,908,15,2159,5461,0,39.53,22.63
基隆市,中山區,德安里,1559,819,740,13,1572,3826,0,41.09,21.41
基隆市,中山區,和平里,206,125,81,4,210,431,0,48.72,29.0
基隆市,中山區,和慶里,2189,1151,1038,23,2212,6516,0,33.95,17.66
基隆市,中山區,合計,16359,8708,7651,184,16543,40977,46058,40.37,21.25
基隆市,安樂區,西川里,447,241,206,5,452,1179,0,38.34,20.44
基隆市,安樂區,定國里,402,195,207,5,407,1020,0,39.9,19.12
基隆市,安樂區,新西里,486,251,235,0,486,1326,0,36.65,18.93
基隆市,安樂區,定邦里,476,250,226,2,478,998,0,47.9,25.05
基隆市,安樂區,慈仁里,336,129,207,2,338,883,0,38.28,14.61
基隆市,安樂區,干城里,704,360,344,3,707,1988,0,35.56,18.11
基隆市,安樂區,永康里,697,333,364,3,700,1900,0,36.84,17.53
基隆市,安樂區,嘉仁里,1355,627,728,12,1367,3163,0,43.22,19.82
基隆市,安樂區,安和里,373,156,217,3,376,821,0,45.8,19.0
基隆市,安樂區,樂一里,220,99,121,2,222,556,0,39.93,17.81
基隆市,安樂區,外寮里,1432,778,654,16,1448,3892,0,37.2,19.99
基隆市,安樂區,中崙里,693,383,310,2,695,1657,0,41.94,23.11
基隆市,安樂區,內寮里,2051,1097,954,15,2066,5349,0,38.62,20.51
基隆市,安樂區,新崙里,1502,811,691,15,1517,4007,0,37.86,20.24
基隆市,安樂區,三民里,1057,544,513,8,1065,2451,0,43.45,22.2
基隆市,安樂區,四維里,2223,1252,971,16,2239,4656,0,48.09,26.89
基隆市,安樂區,五福里,1486,810,676,6,1492,3415,0,43.69,23.72
基隆市,安樂區,六合里,1814,1046,768,15,1829,3876,0,47.19,26.99
基隆市,安樂區,七賢里,1031,517,514,7,1038,2426,0,42.79,21.31
基隆市,安樂區,鶯歌里,1028,606,422,15,1043,2796,0,37.3,21.67
基隆市,安樂區,武崙里,2072,1173,899,18,2090,4808,0,43.47,24.4
基隆市,安樂區,長樂里,1641,967,674,13,1654,3289,0,50.29,29.4
基隆市,安樂區,興寮里,1707,969,738,20,1727,4694,0,36.79,20.64
基隆市,安樂區,鶯安里,2255,1350,905,15,2270,4907,0,46.26,27.51
基隆市,安樂區,壯觀里,1772,1055,717,19,1791,4239,0,42.25,24.89
基隆市,安樂區,合計,29260,15999,13261,237,29497,70296,81453,41.96,22.76
基隆市,信義區,仁壽里,505,280,225,10,515,1024,0,50.29,27.34
基隆市,信義區,仁義里,596,368,228,6,602,1165,0,51.67,31.59
基隆市,信義區,義昭里,600,342,258,3,603,1243,0,48.51,27.51
基隆市,信義區,義幸里,1084,628,456,7,1091,2232,0,48.88,28.14
基隆市,信義區,義民里,296,146,150,4,300,723,0,41.49,20.19
基隆市,信義區,義和里,567,333,234,4,571,1508,0,37.86,22.08
基隆市,信義區,智慧里,349,197,152,8,357,712,0,50.14,27.67
基隆市,信義區,智誠里,543,260,283,8,551,1483,0,37.15,17.53
基隆市,信義區,禮儀里,715,422,293,5,720,1552,0,46.39,27.19
基隆市,信義區,禮東里,707,419,288,6,713,1439,0,49.55,29.12
基隆市,信義區,信綠里,902,529,373,8,910,1997,0,45.57,26.49
基隆市,信義區,東光里,784,420,364,7,791,1817,0,43.53,23.12
基隆市,信義區,東明里,1464,921,543,9,1473,3468,0,42.47,26.56
基隆市,信義區,東安里,1129,637,492,12,1141,2716,0,42.01,23.45
基隆市,信義區,孝岡里,483,255,228,2,485,1308,0,37.08,19.5
基隆市,信義區,東信里,1858,1158,700,18,1876,4064,0,46.16,28.49
基隆市,信義區,孝深里,1615,903,712,21,1636,4618,0,35.43,19.55
基隆市,信義區,孝賢里,1538,918,620,15,1553,3461,0,44.87,26.52
基隆市,信義區,孝德里,960,521,439,8,968,2604,0,37.17,20.01
基隆市,信義區,孝忠里,2988,1673,1315,17,3005,7553,0,39.79,22.15
基隆市,信義區,合計,19683,11330,8353,178,19861,46687,53082,42.54,24.27
基隆市,合計,合計,128826,69196,59630,1238,130064,318539,365891,40.83,21.72
新竹市,東區,南門里,334,133,201,7,341,689,0,49.49,19.3
新竹市,東區,福德里,651,352,299,6,657,1426,0,46.07,24.68
新竹市,東區,南市里,364,136,228,6,370,860,0,43.02,15.81
新竹市,東區,關帝里,212,87,125,5,217,472,0,45.97,18.43
新竹市,東區,東門里,275,99,176,2,277,527,0,52.56,18.79
新竹市,東區,成功里,279,118,161,5,284,591,0,48.05,19.97
新竹市,東區,寺前里,313,146,167,3,316,712,0,44.38,20.51
新竹市,東區,育賢里,457,260,197,3,460,1657,0,27.76,15.69
新竹市,東區,中正里,241,107,134,4,245,544,0,45.04,19.67
新竹市,東區,公園里,1422,822,600,23,1445,3181,0,45.43,25.84
新竹市,東區,頂竹里,1251,578,673,17,1268,2794,0,45.38,20.69
新竹市,東區,南大里,631,284,347,6,637,1360,0,46.84,20.88
新竹市,東區,振興里,2178,1170,1008,21,2199,5451,0,40.34,21.46
新竹市,東區,親仁里,539,320,219,0,539,1058,0,50.95,30.25
新竹市,東區,文華里,2019,1117,902,25,2044,4446,0,45.97,25.12
新竹市,東區,復中里,1898,1053,845,17,1915,4120,0,46.48,25.56
新竹市,東區,三民里,2066,1051,1015,15,2081,4584,0,45.4,22.93
新竹市,東區,東園里,2663,1355,1308,30,2693,5827,0,46.22,23.25
新竹市,東區,東勢里,1448,731,717,19,1467,3117,0,47.06,23.45
新竹市,東區,光復里,1317,643,674,13,1330,2796,0,47.57,23.0
新竹市,東區,豐功里,2283,1337,946,26,2309,4392,0,52.57,30.44
新竹市,東區,武功里,2042,1531,511,24,2066,3972,0,52.01,38.54
新竹市,東區,綠水里,2868,1620,1248,44,2912,6185,0,47.08,26.19
新竹市,東區,東山里,1538,906,632,26,1564,3075,0,50.86,29.46
新竹市,東區,光鎮里,1512,774,738,14,1526,3537,0,43.14,21.88
新竹市,東區,新興里,1339,650,689,17,1356,3009,0,45.06,21.6
新竹市,東區,柴橋里,2308,1252,1056,24,2332,5175,0,45.06,24.19
新竹市,東區,高峰里,2446,1293,1153,32,2478,5610,0,44.17,23.05
新竹市,東區,仙宮里,579,323,256,9,588,1240,0,47.42,26.05
新竹市,東區,光明里,1457,944,513,23,1480,2932,0,50.48,32.2
新竹市,東區,立功里,412,318,94,5,417,887,0,47.01,35.85
新竹市,東區,軍功里,1249,844,405,9,1258,2672,0,47.08,31.59
新竹市,東區,建功里,1959,1437,522,25,1984,3777,0,52.53,38.05
新竹市,東區,前溪里,1136,541,595,13,1149,2728,0,42.12,19.83
新竹市,東區,水源里,1432,628,804,35,1467,3260,0,45.0,19.26
新竹市,東區,千甲里,881,489,392,11,892,2117,0,42.14,23.1
新竹市,東區,埔頂里,2639,1320,1319,21,2660,6204,0,42.88,21.28
新竹市,東區,龍山里,4327,2299,2028,36,4363,9368,0,46.57,24.54
新竹市,東區,新莊里,2304,1292,1012,36,2340,5305,0,44.11,24.35
新竹市,東區,仙水里,1989,1127,862,24,2013,4355,0,46.22,25.88
新竹市,東區,金山里,2134,1311,823,28,2162,5215,0,41.46,25.14
新竹市,東區,關東里,1959,1161,798,20,1979,4835,0,40.93,24.01
新竹市,東區,科園里,3215,1895,1320,36,3251,6299,0,51.61,30.08
新竹市,東區,建華里,1057,550,507,16,1073,2356,0,45.54,23.34
新竹市,東區,新光里,1448,720,728,14,1462,3398,0,43.03,21.19
新竹市,東區,復興里,2150,1154,996,24,2174,4960,0,43.83,23.27
新竹市,東區,錦華里,847,497,350,8,855,1881,0,45.45,26.42
新竹市,東區,湖濱里,1629,867,762,19,1648,3466,0,47.55,25.01
新竹市,東區,明湖里,1754,1017,737,20,1774,4931,0,35.98,20.62
新竹市,東區,關新里,1927,950,977,15,1942,3964,0,48.99,23.97
新竹市,東區,榮光里、親仁里,426,235,191,6,432,958,0,45.09,24.53
新竹市,東區,下竹里、竹蓮里,535,252,283,4,539,1175,0,45.87,21.45
新竹市,東區,合計,76339,42096,34243,891,77230,169450,221541,45.58,24.84
新竹市,北區,西門里,252,127,125,3,255,555,0,45.95,22.88
新竹市,北區,仁德里,320,138,182,1,321,728,0,44.09,18.96
新竹市,北區,潛園里,329,137,192,7,336,743,0,45.22,18.44
新竹市,北區,中央里,196,68,128,2,198,464,0,42.67,14.66
新竹市,北區,崇禮里,468,188,280,10,478,1063,0,44.97,17.69
新竹市,北區,興南里,526,231,295,10,536,1170,0,45.81,19.74
新竹市,北區,北門里,441,196,245,4,445,975,0,45.64,20.1
新竹市,北區,中興里,408,188,220,2,410,867,0,47.29,21.68
新竹市,北區,大同里,383,217,166,3,386,775,0,49.81,28.0
新竹市,北區,中山里,381,145,236,1,382,826,0,46.25,17.55
新竹市,北區,長和里,600,259,341,4,604,1365,0,44.25,18.97
新竹市,北區,新民里,680,319,361,6,686,1599,0,42.9,19.95
新竹市,北區,民富里,1901,863,1038,18,1919,4837,0,39.67,17.84
新竹市,北區,水田里,1340,690,650,16,1356,3018,0,44.93,22.86
新竹市,北區,文雅里,1780,879,901,25,1805,4021,0,44.89,21.86
新竹市,北區,光田里,957,522,435,8,965,2080,0,46.39,25.1
新竹市,北區,士林里,793,345,448,9,802,1845,0,43.47,18.7
新竹市,北區,福林里,1717,990,727,19,1736,3780,0,45.93,26.19
新竹市,北區,古賢里,353,144,209,8,361,837,0,43.13,17.2
新竹市,北區,湳雅里,1276,677,599,24,1300,2741,0,47.43,24.7
新竹市,北區,舊社里,2618,1378,1240,35,2653,5956,0,44.54,23.14
新竹市,北區,武陵里,2136,1683,453,23,2159,4508,0,47.89,37.33
新竹市,北區,南寮里,2013,997,1016,23,2036,5777,0,35.24,17.26
新竹市,北區,舊港里,221,108,113,6,227,574,0,39.55,18.82
新竹市,北區,康樂里,1194,566,628,22,1216,2946,0,41.28,19.21
新竹市,北區,港北里,741,329,412,18,759,1982,0,38.29,16.6
新竹市,北區,中寮里,1362,698,664,16,1378,3687,0,37.37,18.93
新竹市,北區,海濱里,1433,707,726,8,1441,4195,0,34.35,16.85
新竹市,北區,客雅里,698,331,367,8,706,1590,0,44.4,20.82
新竹市,北區,育英里,1493,691,802,19,1512,3409,0,44.35,20.27
新竹市,北區,曲溪里,1988,1030,958,23,2011,5102,0,39.42,20.19
新竹市,北區,西雅里,1194,519,675,23,1217,2825,0,43.08,18.37
新竹市,北區,南勢里,1498,600,898,22,1520,3409,0,44.59,17.6
新竹市,北區,境福里,2108,1096,1012,30,2138,4668,0,45.8,23.48
新竹市,北區,磐石里,2318,1094,1224,28,2346,5381,0,43.6,20.33
新竹市,北區,新雅里,1653,765,888,31,1684,4426,0,38.05,17.28
新竹市,北區,光華里,1495,805,690,14,1509,4165,0,36.23,19.33
新竹市,北區,金華里,2188,1145,1043,20,2208,4801,0,45.99,23.85
新竹市,北區,金竹里,2413,1335,1078,23,2436,5732,0,42.5,23.29
新竹市,北區,湳中里,2963,1663,1300,39,3002,6577,0,45.64,25.29
新竹市,北區,金雅里,1321,643,678,16,1337,2938,0,45.51,21.89
新竹市,北區,台溪里,603,306,297,5,608,1564,0,38.87,19.57
新竹市,北區,中雅里,1565,1015,550,16,1581,3326,0,47.53,30.52
新竹市,北區,石坊里、興南里,340,150,190,2,342,684,0,50.0,21.93
新竹市,北區,南勢里、大鵬里,363,161,202,7,370,995,0,37.19,16.18
新竹市,北區,合計,53020,27138,25882,657,53677,125506,152490,42.77,21.62
新竹市,香山區,港南里,1045,374,671,13,1058,2715,0,38.97,13.78
新竹市,香山區,虎山里,2072,892,1180,33,2105,5496,0,38.3,16.23
新竹市,香山區,虎林里,897,434,463,17,914,2275,0,40.18,19.08
新竹市,香山區,浸水里,824,326,498,11,835,2355,0,35.46,13.84
新竹市,香山區,樹下里,900,310,590,21,921,2096,0,43.94,14.79
新竹市,香山區,埔前里,1301,561,740,23,1324,3186,0,41.56,17.61
新竹市,香山區,中埔里,1280,625,655,12,1292,2869,0,45.03,21.78
新竹市,香山區,牛埔里,1720,882,838,21,1741,4595,0,37.89,19.19
新竹市,香山區,頂埔里,1963,984,979,18,1981,5017,0,39.49,19.61
新竹市,香山區,東香里,1811,1030,781,26,1837,4051,0,45.35,25.43
新竹市,香山區,香村里,1413,776,637,14,1427,3559,0,40.1,21.8
新竹市,香山區,香山里,1582,761,821,18,1600,4357,0,36.72,17.47
新竹市,香山區,大庄里,1063,447,616,19,1082,2843,0,38.06,15.72
新竹市,香山區,美山里,431,177,254,5,436,1121,0,38.89,15.79
新竹市,香山區,朝山里,773,361,412,10,783,2151,0,36.4,16.78
新竹市,香山區,海山里,875,446,429,15,890,2366,0,37.62,18.85
新竹市,香山區,茄苳里,273,137,136,4,277,924,0,29.98,14.83
新竹市,香山區,大湖里,329,161,168,4,333,862,0,38.63,18.68
新竹市,香山區,南隘里,298,162,136,5,303,770,0,39.35,21.04
新竹市,香山區,中隘里,626,350,276,11,637,1828,0,34.85,19.15
新竹市,香山區,內湖里,1482,716,766,21,1503,4280,0,35.12,16.73
新竹市,香山區,鹽水里,551,257,294,8,559,1479,0,37.8,17.38
新竹市,香山區,南港里,337,130,207,4,341,792,0,43.06,16.41
新竹市,香山區,頂福里,1766,914,852,20,1786,4410,0,40.5,20.73
新竹市,香山區,合計,25612,12213,13399,353,25965,66397,78776,39.11,18.39
新竹市,合計,合計,154971,81447,73524,1901,156872,361353,452807,43.41,22.54
嘉義市,東區,荖藤里,1751,712,1039,9,1760,4525,0,38.9,15.73
嘉義市,東區,後湖里,1369,595,774,5,1374,3379,0,40.66,17.61
嘉義市,東區,仁義里,1182,537,645,7,1189,2803,0,42.42,19.16
嘉義市,東區,中庄里,1315,610,705,13,1328,3208,0,41.4,19.01
嘉義市,東區,頂庄里,904,435,469,4,908,2125,0,42.73,20.47
嘉義市,東區,圳頭里,1770,961,809,12,1782,4239,0,42.04,22.67
嘉義市,東區,新店里,1846,920,926,20,1866,4140,0,45.07,22.22
嘉義市,東區,後庄里,1695,855,840,14,1709,3945,0,43.32,21.67
嘉義市,東區,王田里,1057,511,546,7,1064,2249,0,47.31,22.72
嘉義市,東區,東川里,803,428,375,6,809,1740,0,46.49,24.6
嘉義市,東區,太平里,1784,883,901,8,1792,4209,0,42.58,20.98
嘉義市,東區,盧厝里,803,370,433,5,808,1933,0,41.8,19.14
嘉義市,東區,鹿寮里,380,160,220,2,382,1058,0,36.11,15.12
嘉義市,東區,長竹里,1296,607,689,7,1303,2882,0,45.21,21.06
嘉義市,東區,短竹里,1083,539,544,6,1089,2346,0,46.42,22.98
嘉義市,東區,新開里,850,397,453,8,858,1953,0,43.93,20.33
嘉義市,東區,宣信里,494,195,299,3,497,1241,0,40.05,15.71
嘉義市,東區,興南里,632,222,410,10,642,1578,0,40.68,14.07
嘉義市,東區,豐年里,518,199,319,2,520,1231,0,42.24,16.17
嘉義市,東區,芳草里,1298,581,717,12,1310,3435,0,38.14,16.91
嘉義市,東區,芳安里,947,423,524,9,956,2160,0,44.26,19.58
嘉義市,東區,頂寮里,1063,433,630,13,1076,2474,0,43.49,17.5
嘉義市,東區,安寮里,1128,481,647,9,1137,2693,0,42.22,17.86
嘉義市,東區,興安里,1159,523,636,13,1172,2905,0,40.34,18.0
嘉義市,東區,興村里,1525,701,824,12,1537,3865,0,39.77,18.14
嘉義市,東區,興仁里,1517,711,806,12,1529,3606,0,42.4,19.72
嘉義市,東區,過溝里,905,371,534,5,910,1993,0,45.66,18.62
嘉義市,東區,民族里,665,278,387,4,669,1684,0,39.73,16.51
嘉義市,東區,朝陽里,843,330,513,10,853,1923,0,44.36,17.16
嘉義市,東區,華南里,802,324,478,8,810,1928,0,42.01,16.8
嘉義市,東區,東興里,851,353,498,5,856,1797,0,47.63,19.64
嘉義市,東區,中山里,902,446,456,5,907,1852,0,48.97,24.08
嘉義市,東區,中央里,994,360,634,7,1001,2130,0,47.0,16.9
嘉義市,東區,林森里,971,404,567,4,975,2284,0,42.69,17.69
嘉義市,東區,北門里,952,368,584,12,964,2085,0,46.24,17.65
嘉義市,東區,蘭潭里,911,438,473,3,914,2195,0,41.64,19.95
嘉義市,東區,文雅里,1622,819,803,10,1632,3695,0,44.17,22.17
嘉義市,東區,安業里,777,368,409,6,783,1950,0,40.15,18.87
嘉義市,東區,義教里,1042,452,590,4,1046,2719,0,38.47,16.62
嘉義市,東區,合計,42406,19300,23106,311,42717,100157,119170,42.65,19.27
嘉義市,西區,香湖里,302,123,179,3,305,819,0,37.24,15.02
嘉義市,西區,湖邊里,804,271,533,6,810,2045,0,39.61,13.25
嘉義市,西區,北榮里,1018,382,636,13,1031,2205,0,46.76,17.32
嘉義市,西區,重興里,761,289,472,14,775,1945,0,39.85,14.86
嘉義市,西區,竹圍里,1732,706,1026,22,1754,4451,0,39.41,15.86
嘉義市,西區,新厝里,1740,574,1166,18,1758,4153,0,42.33,13.82
嘉義市,西區,保安里,1299,542,757,12,1311,3225,0,40.65,16.81
嘉義市,西區,北湖里,1177,447,730,4,1181,2954,0,39.98,15.13
嘉義市,西區,下埤里,593,228,365,7,600,1556,0,38.56,14.65
嘉義市,西區,竹村里,424,176,248,9,433,1125,0,38.49,15.64
嘉義市,西區,大溪里,821,270,551,3,824,2143,0,38.45,12.6
嘉義市,西區,福全里,1611,683,928,20,1631,4114,0,39.65,16.6
嘉義市,西區,西平里,1336,535,801,16,1352,3239,0,41.74,16.52
嘉義市,西區,磚磘里,1394,551,843,11,1405,3497,0,40.18,15.76
嘉義市,西區,港坪里,1355,582,773,10,1365,3363,0,40.59,17.31
嘉義市,西區,頭港里,751,291,460,8,759,1847,0,41.09,15.76
嘉義市,西區,劉厝里,2650,1222,1428,23,2673,6843,0,39.06,17.86
嘉義市,西區,新西里,795,331,464,8,803,2010,0,39.95,16.47
嘉義市,西區,書院里,869,366,503,9,878,1889,0,46.48,19.38
嘉義市,西區,培元里,773,442,331,3,776,1615,0,48.05,27.37
嘉義市,西區,垂楊里,684,276,408,7,691,1915,0,36.08,14.41
嘉義市,西區,車店里,2339,992,1347,18,2357,5748,0,41.01,17.26
嘉義市,西區,福民里,2124,830,1294,12,2136,5437,0,39.29,15.27
嘉義市,西區,湖內里,1766,655,1111,8,1774,4510,0,39.33,14.52
嘉義市,西區,美源里,1532,659,873,9,1541,3560,0,43.29,18.51
嘉義市,西區,育英里,775,307,468,5,780,1726,0,45.19,17.79
嘉義市,西區,致遠里,817,601,216,6,823,1739,0,47.33,34.56
嘉義市,西區,光路里,2153,986,1167,27,2180,5111,0,42.65,19.29
嘉義市,西區,翠岱里,652,494,158,5,657,1383,0,47.51,35.72
嘉義市,西區,自強里,698,305,393,5,703,1622,0,43.34,18.8
嘉義市,西區,永和里,773,324,449,8,781,1864,0,41.9,17.38
嘉義市,西區,新富里,737,247,490,2,739,1627,0,45.42,15.18
嘉義市,西區,文化里,1027,393,634,3,1030,2211,0,46.59,17.77
嘉義市,西區,西榮里,1003,365,638,8,1011,2209,0,45.77,16.52
嘉義市,西區,國華里,548,230,318,3,551,1253,0,43.97,18.36
嘉義市,西區,番社里,640,229,411,5,645,1355,0,47.6,16.9
嘉義市,西區,導明里,687,269,418,7,694,1512,0,45.9,17.79
嘉義市,西區,慶安里,634,232,402,7,641,1521,0,42.14,15.25
嘉義市,西區,後驛里,807,282,525,4,811,2042,0,39.72,13.81
嘉義市,西區,福安里,1704,691,1013,13,1717,4195,0,40.93,16.47
嘉義市,西區,獅子里,1142,498,644,7,1149,2686,0,42.78,18.54
嘉義市,西區,紅瓦里,645,237,408,6,651,1570,0,41.46,15.1
嘉義市,西區,保福里,1366,591,775,6,1372,3637,0,37.72,16.25
嘉義市,西區,保生里,1836,717,1119,11,1847,4295,0,43.0,16.69
嘉義市,西區,北新里,509,180,329,2,511,1115,0,45.83,16.14
嘉義市,西區,合計,49803,20601,29202,413,50216,120881,145551,41.54,17.04
嘉義市,合計,合計,92209,39901,52308,724,92933,221038,264721,42.04,18.05
金門縣,金城鎮,東門里,954,843,111,12,966,4809,0,20.09,17.53
金門縣,金城鎮,西門里,2022,1768,254,18,2040,9671,0,21.09,18.28
金門縣,金城鎮,南門里,1062,928,134,19,1081,5344,0,20.23,17.37
金門縣,金城鎮,北門里,723,636,87,10,733,3979,0,18.42,15.98
金門縣,金城鎮,古城里,729,617,112,8,737,4023,0,18.32,15.34
金門縣,金城鎮,金水里,454,401,53,8,462,2226,0,20.75,18.01
金門縣,金城鎮,珠沙里,499,442,57,7,506,2885,0,17.54,15.32
金門縣,金城鎮,賢庵里,846,701,145,5,851,4730,0,17.99,14.82
金門縣,金城鎮,合計,7289,6336,953,87,7376,37667,42770,19.58,16.82
金門縣,金沙鎮,汶沙里,965,853,112,14,979,5076,0,19.29,16.8
金門縣,金沙鎮,三山里,336,300,36,7,343,1955,0,17.54,15.35
金門縣,金沙鎮,大洋里,216,200,16,4,220,1153,0,19.08,17.35
金門縣,金沙鎮,光前里,436,368,68,5,441,2348,0,18.78,15.67
金門縣,金沙鎮,何斗里,380,349,31,3,383,2045,0,18.73,17.07
金門縣,金沙鎮,西園里,265,232,33,0,265,1592,0,16.65,14.57
金門縣,金沙鎮,官嶼里,367,335,32,5,372,2210,0,16.83,15.16
金門縣,金沙鎮,浦山里,446,401,45,7,453,2345,0,19.32,17.1
金門縣,金沙鎮,合計,3411,3038,373,45,3456,18724,20622,18.46,16.23
金門縣,金湖鎮,新市里,839,745,94,15,854,3969,0,21.52,18.77
金門縣,金湖鎮,山外里,651,560,91,19,670,3328,0,20.13,16.83
金門縣,金湖鎮,正義里,516,450,66,10,526,2699,0,19.49,16.67
金門縣,金湖鎮,料羅里,425,352,73,4,429,2132,0,20.12,16.51
金門縣,金湖鎮,瓊林里,652,563,89,11,663,3259,0,20.34,17.28
金門縣,金湖鎮,新湖里,1528,1259,269,20,1548,8073,0,19.18,15.6
金門縣,金湖鎮,溪湖里,237,214,23,5,242,1560,0,15.51,13.72
金門縣,金湖鎮,蓮庵里,354,307,47,4,358,1704,0,21.01,18.02
金門縣,金湖鎮,合計,5202,4450,752,88,5290,26724,30316,19.79,16.65
金門縣,金寧鄉,古寧村,478,411,67,5,483,3363,0,14.36,12.22
金門縣,金寧鄉,安美村,820,681,139,18,838,5049,0,16.6,13.49
金門縣,金寧鄉,后盤村,304,259,45,1,305,1618,0,18.85,16.01
金門縣,金寧鄉,湖埔村,1525,1227,298,10,1535,7551,0,20.33,16.25
金門縣,金寧鄉,榜林村,929,787,142,10,939,5268,0,17.82,14.94
金門縣,金寧鄉,盤山村,1280,972,308,13,1293,6403,0,20.19,15.18
金門縣,金寧鄉,合計,5336,4337,999,57,5393,29252,32749,18.44,14.83
金門縣,烈嶼鄉,上岐村,456,410,46,9,465,2843,0,16.36,14.42
金門縣,烈嶼鄉,上林村,184,171,13,6,190,1428,0,13.31,11.97
金門縣,烈嶼鄉,西口村,344,295,49,7,351,2415,0,14.53,12.22
金門縣,烈嶼鄉,林湖村,612,543,69,4,616,3328,0,18.51,16.32
金門縣,烈嶼鄉,黃埔村,229,207,22,3,232,1642,0,14.13,12.61
金門縣,烈嶼鄉,合計,1825,1626,199,29,1854,11656,12646,15.91,13.95
金門縣,烏坵鄉,大坵村,19,15,4,0,19,270,0,7.04,5.56
金門縣,烏坵鄉,小坵村,18,15,3,0,18,299,0,6.02,5.02
金門縣,烏坵鄉,合計,37,30,7,0,37,569,661,6.5,5.27
金門縣,合計,合計,23100,19817,3283,306,23406,124592,139764,18.79,15.91
連江縣,南竿鄉,介壽村,645,551,94,7,652,1982,0,32.9,27.8
連江縣,南竿鄉,復興村、福沃村,469,408,61,4,473,1682,0,28.12,24.26
連江縣,南竿鄉,清水村、珠螺村,332,279,53,2,334,1223,0,27.31,22.81
連江縣,南竿鄉,仁愛村、津沙村、馬祖村、四維村,438,374,64,3,441,1618,0,27.26,23.11
連江縣,南竿鄉,合計,1884,1612,272,16,1900,6505,7644,29.21,24.78
連江縣,北竿鄉,塘岐村、后沃村,329,277,52,6,335,1310,0,25.57,21.15
連江縣,北竿鄉,橋仔村、芹壁村、坂里村、白沙村,288,246,42,1,289,1227,0,23.55,20.05
連江縣,北竿鄉,合計,617,523,94,7,624,2537,2846,24.6,20.61
連江縣,莒光鄉,青帆村、田沃村、西坵村,158,128,30,0,158,668,0,23.65,19.16
連江縣,莒光鄉,福正村、大坪村,139,118,21,2,141,695,0,20.29,16.98
連江縣,莒光鄉,合計,297,246,51,2,299,1363,1496,21.94,18.05
連江縣,東引鄉,中柳村、樂華村,295,253,42,0,295,1268,0,23.26,19.95
連江縣,東引鄉,合計,295,253,42,0,295,1268,1463,23.26,19.95
連江縣,合計,合計,3093,2634,459,25,3118,11673,13449,26.71,22.56
