縣市,鄉鎮市區,村里,valid_ticket,agree_ticket,disagree_ticket,invalid_ticket,vote_ticket,votable_population,population,vote_to_votable,agree_to_votable
臺北市,松山區,莊敬里,2017,1140,877,15,2032,4467,0,45.49,25.52
臺北市,松山區,東榮里,3400,1740,1660,16,3416,6468,0,52.81,26.9
臺北市,松山區,三民里,2929,1656,1273,20,2949,5723,0,51.53,28.94
臺北市,松山區,新益里,1995,1039,956,10,2005,3881,0,51.66,26.77
臺北市,松山區,富錦里,2178,1199,979,10,2188,4281,0,51.11,28.01
臺北市,松山區,新東里,2052,1127,925,15,2067,4135,0,49.99,27.26
臺北市,松山區,富泰里,1884,1157,727,15,1899,3884,0,48.89,29.79
臺北市,松山區,介壽里,1791,915,876,14,1805,3540,0,50.99,25.85
臺北市,松山區,精忠里,1779,980,799,15,1794,3553,0,50.49,27.58
臺北市,松山區,東光里,3037,1729,1308,25,3062,6051,0,50.6,28.57
臺北市,松山區,龍田里,4263,2809,1454,38,4301,8377,0,51.34,33.53
臺北市,松山區,東昌里,1179,584,595,2,1181,2184,0,54.08,26.74
臺北市,松山區,東勢里,1773,897,876,15,1788,3518,0,50.82,25.5
臺北市,松山區,中華里,2642,1488,1154,25,2667,5140,0,51.89,28.95
臺北市,松山區,民有里,3790,1856,1934,24,3814,7351,0,51.88,25.25
臺北市,松山區,民福里,2829,1676,1153,22,2851,5381,0,52.98,31.15
臺北市,松山區,慈祐里,2740,1319,1421,24,2764,7162,0,38.59,18.42
臺北市,松山區,安平里,3313,1672,1641,38,3351,7230,0,46.35,23.13
臺北市,松山區,鵬程里,2275,1399,876,24,2299,4616,0,49.81,30.31
臺北市,松山區,自強里,3965,2973,992,56,4021,7730,0,52.02,38.46
臺北市,松山區,吉祥里,3378,1832,1546,20,3398,6959,0,48.83,26.33
臺北市,松山區,新聚里,3091,1548,1543,25,3116,6657,0,46.81,23.25
臺北市,松山區,復盛里,2636,1496,1140,24,2660,5286,0,50.32,28.3
臺北市,松山區,中正里,3465,1714,1751,26,3491,7611,0,45.87,22.52
臺北市,松山區,中崙里,1570,818,752,19,1589,3317,0,47.9,24.66
臺北市,松山區,美仁里,1407,687,720,15,1422,2882,0,49.34,23.84
臺北市,松山區,吉仁里,1481,751,730,9,1490,3234,0,46.07,23.22
臺北市,松山區,敦化里,2883,1476,1407,29,2912,5590,0,52.09,26.4
臺北市,松山區,復源里,1329,750,579,14,1343,2642,0,50.83,28.39
臺北市,松山區,復建里,1807,1012,795,18,1825,3714,0,49.14,27.25
臺北市,松山區,復勢里,2510,1240,1270,21,2531,5206,0,48.62,23.82
臺北市,松山區,福成里,1051,516,535,14,1065,2147,0,49.6,24.03
臺北市,松山區,松基里,1464,745,719,12,1476,3047,0,48.44,24.45
臺北市,松山區,合計,79903,43940,35963,669,80572,162964,196890,49.44,26.96
臺北市,信義區,西村里,2112,1500,612,16,2128,4958,0,42.92,30.25
臺北市,信義區,正和里,1963,1203,760,18,1981,3767,0,52.59,31.94
臺北市,信義區,興隆里,1007,607,400,12,1019,2224,0,45.82,27.29
臺北市,信義區,中興里,1295,739,556,9,1304,2903,0,44.92,25.46
臺北市,信義區,新仁里,1334,804,530,13,1347,2732,0,49.3,29.43
臺北市,信義區,興雅里,2172,1200,972,29,2201,4753,0,46.31,25.25
臺北市,信義區,敦厚里,1993,1090,903,10,2003,4357,0,45.97,25.02
臺北市,信義區,廣居里,3057,1740,1317,26,3083,6335,0,48.67,27.47
臺北市,信義區,安康里,3915,2146,1769,31,3946,8511,0,46.36,25.21
臺北市,信義區,六藝里,1424,720,704,10,1434,3102,0,46.23,23.21
臺北市,信義區,雅祥里,2017,996,1021,25,2042,4266,0,47.87,23.35
臺北市,信義區,五常里,1479,795,684,9,1488,3106,0,47.91,25.6
臺北市,信義區,五全里,1944,886,1058,17,1961,4081,0,48.05,21.71
臺北市,信義區,永吉里,1409,594,815,13,1422,3370,0,42.2,17.63
臺北市,信義區,長春里,1558,785,773,15,1573,3629,0,43.35,21.63
臺北市,信義區,四育里,2319,1117,1202,30,2349,4754,0,49.41,23.5
臺北市,信義區,四維里,2120,1208,912,25,2145,4535,0,47.3,26.64
臺北市,信義區,永春里,1916,983,933,31,1947,4223,0,46.1,23.28
臺北市,信義區,富台里,1723,1099,624,23,1746,3723,0,46.9,29.52
臺北市,信義區,國業里,2831,1586,1245,16,2847,6147,0,46.32,25.8
臺北市,信義區,松隆里,880,471,409,6,886,1924,0,46.05,24.48
臺北市,信義區,松友里,2530,1410,1120,21,2551,5536,0,46.08,25.47
臺北市,信義區,松光里,1951,990,961,17,1968,4245,0,46.36,23.32
臺北市,信義區,中坡里,1868,994,874,21,1889,3791,0,49.83,26.22
臺北市,信義區,中行里,3058,1520,1538,29,3087,6724,0,45.91,22.61
臺北市,信義區,大道里,2469,1222,1247,20,2489,5177,0,48.08,23.6
臺北市,信義區,大仁里,1519,802,717,9,1528,3445,0,44.35,23.28
臺北市,信義區,景新里,2045,1209,836,17,2062,4324,0,47.69,27.96
臺北市,信義區,惠安里,2549,1539,1010,18,2567,5572,0,46.07,27.62
臺北市,信義區,三張里,3538,2088,1450,37,3575,7503,0,47.65,27.83
臺北市,信義區,三犁里,2014,1160,854,17,2031,4453,0,45.61,26.05
臺北市,信義區,六合里,2669,1676,993,21,2690,5784,0,46.51,28.98
臺北市,信義區,泰和里,2739,1575,1164,19,2758,6519,0,42.31,24.16
臺北市,信義區,景聯里,1915,1073,842,15,1930,3961,0,48.73,27.09
臺北市,信義區,景勤里,1472,863,609,16,1488,3292,0,45.2,26.22
臺北市,信義區,雙和里,2935,1744,1191,19,2954,6033,0,48.96,28.91
臺北市,信義區,嘉興里,1328,732,596,9,1337,2713,0,49.28,26.98
臺北市,信義區,黎順里,1556,897,659,12,1568,3427,0,45.75,26.17
臺北市,信義區,黎平里,2925,1713,1212,21,2946,5973,0,49.32,28.68
臺北市,信義區,黎忠里,1996,1168,828,9,2005,4141,0,48.42,28.21
臺北市,信義區,黎安里,736,484,252,13,749,1734,0,43.19,27.91
臺北市,信義區,合計,84280,47128,37152,744,85024,181747,210936,46.78,25.93
臺北市,大安區,德安里,2298,1436,862,10,2308,4632,0,49.83,31.0
臺北市,大安區,仁慈里,2180,1112,1068,7,2187,4304,0,50.81,25.84
臺北市,大安區,和安里,2628,1498,1130,19,2647,5471,0,48.38,27.38
臺北市,大安區,民炤里,3224,1715,1509,28,3252,6608,0,49.21,25.95
臺北市,大安區,仁愛里,1916,1019,897,12,1928,4212,0,45.77,24.19
臺北市,大安區,義村里,2463,1634,829,17,2480,4707,0,52.69,34.71
臺北市,大安區,民輝里,2710,1443,1267,28,2738,5704,0,48.0,25.3
臺北市,大安區,昌隆里,1351,680,671,18,1369,2713,0,50.46,25.06
臺北市,大安區,誠安里,1668,872,796,17,1685,3427,0,49.17,25.44
臺北市,大安區,光武里,2847,1545,1302,28,2875,6211,0,46.29,24.88
臺北市,大安區,龍坡里,2353,1312,1041,19,2372,4608,0,51.48,28.47
臺北市,大安區,龍泉里,1917,1034,883,10,1927,4046,0,47.63,25.56
臺北市,大安區,古風里,1792,966,826,15,1807,3495,0,51.7,27.64
臺北市,大安區,古莊里,2900,1596,1304,16,2916,6074,0,48.01,26.28
臺北市,大安區,龍安里,2447,1293,1154,11,2458,6710,0,36.63,19.27
臺北市,大安區,錦安里,2357,1332,1025,15,2372,4806,0,49.35,27.72
臺北市,大安區,福住里,2377,1269,1108,17,2394,5061,0,47.3,25.07
臺北市,大安區,永康里,1433,805,628,8,1441,2977,0,48.4,27.04
臺北市,大安區,光明里,1468,824,644,14,1482,2987,0,49.61,27.59
臺北市,大安區,錦泰里,1494,914,580,18,1512,3004,0,50.33,30.43
臺北市,大安區,錦華里,2365,1363,1002,15,2380,4627,0,51.44,29.46
臺北市,大安區,龍圖里,2708,1566,1142,16,2724,5613,0,48.53,27.9
臺北市,大安區,新龍里,2885,1953,932,30,2915,5527,0,52.74,35.34
臺北市,大安區,龍陣里,1476,830,646,9,1485,2947,0,50.39,28.16
臺北市,大安區,龍雲里,1997,1106,891,17,2014,3937,0,51.16,28.09
臺北市,大安區,龍生里,2758,1625,1133,23,2781,5409,0,51.41,30.04
臺北市,大安區,住安里,1878,1111,767,16,1894,4245,0,44.62,26.17
臺北市,大安區,義安里,2075,1219,856,9,2084,4455,0,46.78,27.36
臺北市,大安區,通化里,2486,1254,1232,19,2505,5249,0,47.72,23.89
臺北市,大安區,通安里,2172,1211,961,37,2209,4590,0,48.13,26.38
臺北市,大安區,臨江里,1628,890,738,22,1650,3527,0,46.78,25.23
臺北市,大安區,法治里,1865,1171,694,22,1887,3732,0,50.56,31.38
臺北市,大安區,全安里,1786,1045,741,17,1803,3699,0,48.74,28.25
臺北市,大安區,群賢里,2410,1455,955,15,2425,4899,0,49.5,29.7
臺北市,大安區,群英里,3140,2250,890,20,3160,5848,0,54.04,38.47
臺北市,大安區,虎嘯里,1552,869,683,10,1562,3137,0,49.79,27.7
臺北市,大安區,臥龍里,878,536,342,5,883,1729,0,51.07,31.0
臺北市,大安區,龍淵里,3685,2038,1647,26,3711,7435,0,49.91,27.41
臺北市,大安區,龍門里,1848,999,849,13,1861,3529,0,52.73,28.31
臺北市,大安區,大學里,3648,2051,1597,28,3676,6961,0,52.81,29.46
臺北市,大安區,芳和里,2336,1350,986,25,2361,4904,0,48.14,27.53
臺北市,大安區,黎元里,2103,1180,923,18,2121,4683,0,45.29,25.2
臺北市,大安區,黎孝里,3207,1835,1372,30,3237,6467,0,50.05,28.37
臺北市,大安區,黎和里,1871,1155,716,26,1897,3938,0,48.17,29.33
臺北市,大安區,建安里,1820,1033,787,12,1832,4048,0,45.26,25.52
臺北市,大安區,建倫里,2267,1246,1021,24,2291,5023,0,45.61,24.81
臺北市,大安區,敦安里,2351,1264,1087,21,2372,5100,0,46.51,24.78
臺北市,大安區,正聲里,1764,1033,731,17,1781,3818,0,46.65,27.06
臺北市,大安區,敦煌里,2342,1242,1100,20,2362,4922,0,47.99,25.23
臺北市,大安區,華聲里,1570,885,685,17,1587,3473,0,45.7,25.48
臺北市,大安區,車層里,2442,1307,1135,15,2457,5221,0,47.06,25.03
臺北市,大安區,光信里,3053,1734,1319,44,3097,6249,0,49.56,27.75
臺北市,大安區,學府里,969,581,388,10,979,2171,0,45.09,26.76
臺北市,大安區,合計,117158,66686,50472,975,118133,242869,296546,48.64,27.46
臺北市,中山區,正守里,1271,608,663,11,1282,2806,0,45.69,21.67
臺北市,中山區,正義里,1851,930,921,11,1862,4541,0,41.0,20.48
臺北市,中山區,正得里,1377,699,678,10,1387,3136,0,44.23,22.29
臺北市,中山區,民安里,1827,845,982,10,1837,3798,0,48.37,22.25
臺北市,中山區,康樂里,1006,536,470,8,1014,2307,0,43.95,23.23
臺北市,中山區,中山里,2503,1213,1290,18,2521,5902,0,42.71,20.55
臺北市,中山區,聚盛里,1451,789,662,18,1469,3728,0,39.4,21.16
臺北市,中山區,集英里,2716,1204,1512,20,2736,5936,0,46.09,20.28
臺北市,中山區,聚葉里,1486,711,775,12,1498,3471,0,43.16,20.48
臺北市,中山區,恆安里,1773,855,918,21,1794,4310,0,41.62,19.84
臺北市,中山區,晴光里,1948,1023,925,12,1960,4704,0,41.67,21.75
臺北市,中山區,圓山里,1555,727,828,12,1567,3587,0,43.69,20.27
臺北市,中山區,劍潭里,1552,1199,353,21,1573,3095,0,50.82,38.74
臺北市,中山區,大直里,3701,2101,1600,30,3731,7456,0,50.04,28.18
臺北市,中山區,成功里,2485,1249,1236,20,2505,5305,0,47.22,23.54
臺北市,中山區,永安里,3828,1998,1830,23,3851,7732,0,49.81,25.84
臺北市,中山區,大佳里,414,150,264,2,416,904,0,46.02,16.59
臺北市,中山區,新喜里,1946,864,1082,18,1964,4399,0,44.65,19.64
臺北市,中山區,新庄里,1991,897,1094,26,2017,4267,0,47.27,21.02
臺北市,中山區,新福里,2108,864,1244,16,2124,4414,0,48.12,19.57
臺北市,中山區,松江里,2561,1198,1363,25,2586,5384,0,48.03,22.25
臺北市,中山區,新生里,1860,838,1022,14,1874,4061,0,46.15,20.64
臺北市,中山區,中庄里,1956,858,1098,16,1972,4318,0,45.67,19.87
臺北市,中山區,行政里,2333,1132,1201,22,2355,6616,0,35.6,17.11
臺北市,中山區,行仁里,3065,1385,1680,29,3094,6794,0,45.54,20.39
臺北市,中山區,行孝里,1587,689,898,14,1601,3692,0,43.36,18.66
臺北市,中山區,下埤里,3084,1408,1676,20,3104,6421,0,48.34,21.93
臺北市,中山區,江寧里,2848,1446,1402,21,2869,5828,0,49.23,24.81
臺北市,中山區,江山里,3107,1433,1674,21,3128,6371,0,49.1,22.49
臺北市,中山區,中吉里,2257,947,1310,22,2279,4719,0,48.29,20.07
臺北市,中山區,中原里,2187,984,1203,12,2199,4380,0,50.21,22.47
臺北市,中山區,興亞里,2159,1017,1142,14,2173,4589,0,47.35,22.16
臺北市,中山區,中央里,1467,706,761,7,1474,3031,0,48.63,23.29
臺北市,中山區,朱馥里,2073,1073,1000,17,2090,4892,0,42.72,21.93
臺北市,中山區,龍洲里,2239,1541,698,20,2259,4278,0,52.81,36.02
臺北市,中山區,朱園里,1861,863,998,14,1875,3885,0,48.26,22.21
臺北市,中山區,埤頭里,1309,670,639,12,1321,2772,0,47.66,24.17
臺北市,中山區,朱崙里,1208,567,641,12,1220,2553,0,47.79,22.21
臺北市,中山區,力行里,2485,1142,1343,26,2511,5215,0,48.15,21.9
臺北市,中山區,復華里,1930,1095,835,28,1958,4000,0,48.95,27.38
臺北市,中山區,金泰里,2898,1570,1328,26,2924,6417,0,45.57,24.47
臺北市,中山區,北安里,1083,650,433,7,1090,2179,0,50.02,29.83
臺北市,中山區,合計,86346,42674,43672,718,87064,188193,219840,46.26,22.68
臺北市,中正區,水源里,1193,607,586,13,1206,2569,0,46.94,23.63
臺北市,中正區,富水里,893,590,303,7,900,2107,0,42.71,28.0
臺北市,中正區,文盛里,1113,594,519,7,1120,2181,0,51.35,27.24
臺北市,中正區,林興里,1888,1112,776,15,1903,4011,0,47.44,27.72
臺北市,中正區,河堤里,1943,1140,803,15,1958,3802,0,51.5,29.98
臺北市,中正區,頂東里,2687,1457,1230,20,2707,5155,0,52.51,28.26
臺北市,中正區,網溪里,2486,1375,1111,27,2513,4893,0,51.36,28.1
臺北市,中正區,板溪里,1306,752,554,7,1313,2775,0,47.32,27.1
臺北市,中正區,螢圃里,2372,1344,1028,15,2387,4773,0,50.01,28.16
臺北市,中正區,螢雪里,1766,1018,748,13,1779,3653,0,48.7,27.87
臺北市,中正區,永功里,2456,1286,1170,40,2496,5214,0,47.87,24.66
臺北市,中正區,永昌里,1980,1072,908,17,1997,4177,0,47.81,25.66
臺北市,中正區,龍興里,1327,701,626,15,1342,2906,0,46.18,24.12
臺北市,中正區,忠勤里,2327,1336,991,32,2359,5486,0,43.0,24.35
臺北市,中正區,廈安里,1590,812,778,10,1600,3475,0,46.04,23.37
臺北市,中正區,愛國里,1228,650,578,12,1240,2583,0,48.01,25.16
臺北市,中正區,南門里,1119,674,445,12,1131,2153,0,52.53,31.31
臺北市,中正區,龍光里,1352,789,563,14,1366,2662,0,51.31,29.64
臺北市,中正區,南福里,4416,2476,1940,28,4444,8918,0,49.83,27.76
臺北市,中正區,龍福里,2029,1118,911,17,2046,4216,0,48.53,26.52
臺北市,中正區,新營里,3275,1954,1321,27,3302,6851,0,48.2,28.52
臺北市,中正區,建國里,562,333,229,5,567,1240,0,45.73,26.85
臺北市,中正區,光復里,1405,742,663,9,1414,3153,0,44.85,23.53
臺北市,中正區,黎明里,1073,581,492,7,1080,2719,0,39.72,21.37
臺北市,中正區,梅花里,1289,644,645,9,1298,2626,0,49.43,24.52
臺北市,中正區,幸福里,1911,1066,845,14,1925,4871,0,39.52,21.88
臺北市,中正區,幸市里,1927,987,940,15,1942,3689,0,52.64,26.76
臺北市,中正區,東門里,1505,902,603,15,1520,3113,0,48.83,28.98
臺北市,中正區,文北里,2303,1234,1069,14,2317,4517,0,51.3,27.32
臺北市,中正區,文祥里,3073,1684,1389,27,3100,6282,0,49.35,26.81
臺北市,中正區,三愛里,3387,1836,1551,29,3416,6997,0,48.82,26.24
臺北市,中正區,合計,59181,32866,26315,507,59688,123767,153172,48.23,26.55
臺北市,大同區,玉泉里,1137,483,654,12,1149,2534,0,45.34,19.06
臺北市,大同區,建明里,1219,510,709,10,1229,2790,0,44.05,18.28
臺北市,大同區,建功里,1739,742,997,12,1751,3999,0,43.79,18.55
臺北市,大同區,建泰里,1418,576,842,31,1449,3039,0,47.68,18.95
臺北市,大同區,永樂里,2041,796,1245,11,2052,4399,0,46.65,18.1
臺北市,大同區,朝陽里,1804,781,1023,10,1814,3812,0,47.59,20.49
臺北市,大同區,星明里,2180,976,1204,16,2196,4940,0,44.45,19.76
臺北市,大同區,光能里,1949,838,1111,11,1960,4161,0,47.1,20.14
臺北市,大同區,大有里,1816,707,1109,19,1835,3943,0,46.54,17.93
臺北市,大同區,延平里,1590,684,906,13,1603,3592,0,44.63,19.04
臺北市,大同區,雙連里,3427,1483,1944,26,3453,7671,0,45.01,19.33
臺北市,大同區,南芳里,1536,640,896,15,1551,3376,0,45.94,18.96
臺北市,大同區,民權里,2490,1119,1371,12,2502,5223,0,47.9,21.42
臺北市,大同區,景星里,985,383,602,6,991,2231,0,44.42,17.17
臺北市,大同區,隆和里,1413,547,866,10,1423,2898,0,49.1,18.88
臺北市,大同區,蓬萊里,1953,827,1126,14,1967,4213,0,46.69,19.63
臺北市,大同區,國順里,1000,357,643,7,1007,2305,0,43.69,15.49
臺北市,大同區,國慶里,1903,813,1090,13,1916,3894,0,49.2,20.88
臺北市,大同區,揚雅里,1419,564,855,15,1434,4063,0,35.29,13.88
臺北市,大同區,斯文里,1805,721,1084,18,1823,4057,0,44.93,17.77
臺北市,大同區,鄰江里,2593,1024,1569,20,2613,5537,0,47.19,18.49
臺北市,大同區,至聖里,3181,1328,1853,28,3209,6748,0,47.55,19.68
臺北市,大同區,老師里,2162,861,1301,11,2173,4953,0,43.87,17.38
臺北市,大同區,重慶里,2694,1273,1421,15,2709,5666,0,47.81,22.47
臺北市,大同區,保安里,1858,766,1092,18,1876,3771,0,49.75,20.31
臺北市,大同區,合計,47312,19799,27513,373,47685,103815,122719,45.93,19.07
臺北市,萬華區,福星里,1951,1040,911,26,1977,4638,0,42.63,22.42
臺北市,萬華區,萬壽里,1117,610,507,17,1134,2831,0,40.06,21.55
臺北市,萬華區,西門里,1344,724,620,9,1353,3187,0,42.45,22.72
臺北市,萬華區,新起里,2700,1351,1349,36,2736,5920,0,46.22,22.82
臺北市,萬華區,菜園里,2519,1133,1386,12,2531,5356,0,47.26,21.15
臺北市,萬華區,青山里,2252,1045,1207,19,2271,5124,0,44.32,20.39
臺北市,萬華區,富民里,1964,828,1136,26,1990,4299,0,46.29,19.26
臺北市,萬華區,福音里,1566,701,865,12,1578,3366,0,46.88,20.83
臺北市,萬華區,仁德里,2027,962,1065,11,2038,4094,0,49.78,23.5
臺北市,萬華區,富福里,1913,833,1080,22,1935,5354,0,36.14,15.56
臺北市,萬華區,頂碩里,2821,1244,1577,23,2844,6064,0,46.9,20.51
臺北市,萬華區,雙園里,1773,812,961,19,1792,3864,0,46.38,21.01
臺北市,萬華區,新忠里,1531,1161,370,8,1539,2993,0,51.42,38.79
臺北市,萬華區,新和里,3763,2768,995,45,3808,7108,0,53.57,38.94
臺北市,萬華區,糖廍里,2202,993,1209,19,2221,4679,0,47.47,21.22
臺北市,萬華區,和平里,2479,957,1522,28,2507,5752,0,43.58,16.64
臺北市,萬華區,綠堤里,1510,779,731,19,1529,3698,0,41.35,21.07
臺北市,萬華區,華江里,3192,1523,1669,27,3219,7226,0,44.55,21.08
臺北市,萬華區,柳鄉里,1895,803,1092,22,1917,4403,0,43.54,18.24
臺北市,萬華區,日善里,1449,670,779,12,1461,3103,0,47.08,21.59
臺北市,萬華區,新安里,2213,1327,886,27,2240,5228,0,42.85,25.38
臺北市,萬華區,忠德里,1750,764,986,13,1763,3813,0,46.24,20.04
臺北市,萬華區,孝德里,1311,524,787,13,1324,2802,0,47.25,18.7
臺北市,萬華區,和德里,2295,1003,1292,23,2318,5570,0,41.62,18.01
臺北市,萬華區,錦德里,2097,986,1111,21,2118,4714,0,44.93,20.92
臺北市,萬華區,全德里,1683,797,886,24,1707,3631,0,47.01,21.95
臺北市,萬華區,保德里,1341,647,694,5,1346,2752,0,48.91,23.51
臺北市,萬華區,銘德里,1770,792,978,16,1786,3985,0,44.82,19.87
臺北市,萬華區,榮德里,1483,658,825,20,1503,3075,0,48.88,21.4
臺北市,萬華區,壽德里,1946,950,996,17,1963,4233,0,46.37,22.44
臺北市,萬華區,興德里,1743,786,957,16,1759,3911,0,44.98,20.1
臺北市,萬華區,華中里,2447,1107,1340,26,2473,5226,0,47.32,21.18
臺北市,萬華區,日祥里,2557,1612,945,27,2584,5167,0,50.01,31.2
臺北市,萬華區,忠貞里,1955,1320,635,25,1980,4179,0,47.38,31.59
臺北市,萬華區,凌霄里,1456,954,502,25,1481,3097,0,47.82,30.8
臺北市,萬華區,騰雲里,1332,845,487,18,1350,2636,0,51.21,32.06
臺北市,萬華區,合計,71347,36009,35338,728,72075,157078,179485,45.88,22.92
臺北市,文山區,景行里,2886,1575,1311,28,2914,6344,0,45.93,24.83
臺北市,文山區,景東里,2827,1833,994,15,2842,5987,0,47.47,30.62
臺北市,文山區,景美里,2059,1164,895,10,2069,4219,0,49.04,27.59
臺北市,文山區,景慶里,2632,1526,1106,26,2658,5431,0,48.94,28.1
臺北市,文山區,景仁里,2341,1421,920,27,2368,4675,0,50.65,30.4
臺北市,文山區,景華里,2371,1450,921,14,2385,4768,0,50.02,30.41
臺北市,文山區,萬有里,2328,1407,921,17,2345,4621,0,50.75,30.45
臺北市,文山區,萬祥里,1869,1048,821,19,1888,3814,0,49.5,27.48
臺北市,文山區,萬隆里,3021,1874,1147,20,3041,6067,0,50.12,30.89
臺北市,文山區,萬年里,2247,1300,947,29,2276,4515,0,50.41,28.79
臺北市,文山區,萬和里,1442,1017,425,16,1458,2826,0,51.59,35.99
臺北市,文山區,萬盛里,1941,1186,755,15,1956,3978,0,49.17,29.81
臺北市,文山區,興豐里,2126,1311,815,28,2154,4213,0,51.13,31.12
臺北市,文山區,興光里,1460,893,567,15,1475,3144,0,46.91,28.4
臺北市,文山區,興家里,3109,2005,1104,20,3129,6323,0,49.49,31.71
臺北市,文山區,興得里,2406,1509,897,24,2430,5161,0,47.08,29.24
臺北市,文山區,興業里,2265,1521,744,17,2282,4630,0,49.29,32.85
臺北市,文山區,興安里,2893,1871,1022,23,2916,5698,0,51.18,32.84
臺北市,文山區,興福里,2300,1344,956,16,2316,4637,0,49.95,28.98
臺北市,文山區,興旺里,3256,2147,1109,22,3278,7009,0,46.77,30.63
臺北市,文山區,興泰里,1731,1046,685,20,1751,3527,0,49.65,29.66
臺北市,文山區,興昌里,2710,1709,1001,23,2733,5643,0,48.43,30.29
臺北市,文山區,試院里,2897,1910,987,40,2937,5797,0,50.66,32.95
臺北市,文山區,華興里,3793,2402,1391,39,3832,7631,0,50.22,31.48
臺北市,文山區,明義里,1535,926,609,16,1551,3738,0,41.49,24.77
臺北市,文山區,明興里,2793,1780,1013,22,2815,5826,0,48.32,30.55
臺北市,文山區,木柵里,3849,2552,1297,31,3880,7776,0,49.9,32.82
臺北市,文山區,木新里,3453,1939,1514,33,3486,8867,0,39.31,21.87
臺北市,文山區,順興里,2989,1776,1213,17,3006,6234,0,48.22,28.49
臺北市,文山區,樟林里,3278,2097,1181,32,3310,7099,0,46.63,29.54
臺北市,文山區,樟新里,2297,1463,834,16,2313,4662,0,49.61,31.38
臺北市,文山區,樟腳里,2244,1323,921,21,2265,4648,0,48.73,28.46
臺北市,文山區,萬芳里,3202,2025,1177,24,3226,6704,0,48.12,30.21
臺北市,文山區,博嘉里,2359,1391,968,14,2373,5050,0,46.99,27.54
臺北市,文山區,萬興里,3498,2055,1443,37,3535,7045,0,50.18,29.17
臺北市,文山區,指南里,1528,832,696,18,1546,3435,0,45.01,24.22
臺北市,文山區,老泉里,345,145,200,4,349,778,0,44.86,18.64
臺北市,文山區,忠順里,1899,1272,627,15,1914,3647,0,52.48,34.88
臺北市,文山區,萬美里,2828,1743,1085,18,2846,6271,0,45.38,27.79
臺北市,文山區,政大里,3022,1792,1230,25,3047,6269,0,48.6,28.59
臺北市,文山區,樟文里,2455,1443,1012,26,2481,5223,0,47.5,27.63
臺北市,文山區,興邦里,2148,1495,653,15,2163,4301,0,50.29,34.76
臺北市,文山區,樟樹里,1903,1132,771,19,1922,3996,0,48.1,28.33
臺北市,文山區,合計,106535,65650,40885,926,107461,222227,264975,48.36,29.54
臺北市,南港區,南港里,2179,1126,1053,8,2187,5637,0,38.8,19.98
臺北市,南港區,中南里,1244,596,648,3,1247,3127,0,39.88,19.06
臺北市,南港區,新富里,1475,708,767,13,1488,3300,0,45.09,21.45
臺北市,南港區,三重里,2700,1457,1243,17,2717,6452,0,42.11,22.58
臺北市,南港區,東新里,2589,1334,1255,17,2606,6152,0,42.36,21.68
臺北市,南港區,新光里,1451,806,645,13,1464,3170,0,46.18,25.43
臺北市,南港區,東明里,2309,1329,980,21,2330,4785,0,48.69,27.77
臺北市,南港區,西新里,1781,776,1005,23,1804,4037,0,44.69,19.22
臺北市,南港區,玉成里,1860,914,946,14,1874,4075,0,45.99,22.43
臺北市,南港區,合成里,2694,1398,1296,28,2722,5716,0,47.62,24.46
臺北市,南港區,成福里,3033,1738,1295,34,3067,6413,0,47.82,27.1
臺北市,南港區,萬福里,1889,1076,813,14,1903,3623,0,52.53,29.7
臺北市,南港區,鴻福里,1860,1001,859,9,1869,3885,0,48.11,25.77
臺北市,南港區,百福里,2001,1031,970,19,2020,4544,0,44.45,22.69
臺北市,南港區,聯成里,2005,1105,900,19,2024,4274,0,47.36,25.85
臺北市,南港區,舊莊里,3013,1546,1467,26,3039,7580,0,40.09,20.4
臺北市,南港區,中研里,3580,1859,1721,36,3616,7890,0,45.83,23.56
臺北市,南港區,九如里,2389,1405,984,22,2411,5386,0,44.76,26.09
臺北市,南港區,仁福里,2361,1491,870,19,2380,4777,0,49.82,31.21
臺北市,南港區,重陽里,2110,1201,909,16,2126,4541,0,46.82,26.45
臺北市,南港區,合計,44523,23897,20626,371,44894,99364,117188,45.18,24.05
臺北市,內湖區,西湖里,2891,1455,1436,23,2914,6163,0,47.28,23.61
臺北市,內湖區,西康里,3980,2226,1754,37,4017,8190,0,49.05,27.18
臺北市,內湖區,西安里,2753,1494,1259,27,2780,5644,0,49.26,26.47
臺北市,內湖區,港墘里,2463,1313,1150,16,2479,5115,0,48.47,25.67
臺北市,內湖區,港都里,2131,1109,1022,11,2142,4642,0,46.14,23.89
臺北市,內湖區,港富里,3759,2025,1734,34,3793,7960,0,47.65,25.44
臺北市,內湖區,港華里,3543,1881,1662,36,3579,7644,0,46.82,24.61
臺北市,內湖區,內湖里,2607,1486,1121,15,2622,5561,0,47.15,26.72
臺北市,內湖區,湖濱里,3657,2176,1481,35,3692,7099,0,52.01,30.65
臺北市,內湖區,紫星里,3336,1703,1633,24,3360,6865,0,48.94,24.81
臺北市,內湖區,大湖里,2214,1214,1000,16,2230,4641,0,48.05,26.16
臺北市,內湖區,金龍里,2127,1171,956,16,2143,4647,0,46.12,25.2
臺北市,內湖區,金瑞里,2846,1489,1357,23,2869,5790,0,49.55,25.72
臺北市,內湖區,碧山里,2906,1628,1278,23,2929,6061,0,48.33,26.86
臺北市,內湖區,紫雲里,2356,1460,896,25,2381,4880,0,48.79,29.92
臺北市,內湖區,清白里,3536,1985,1551,26,3562,7269,0,49.0,27.31
臺北市,內湖區,葫洲里,2681,1593,1088,26,2707,5983,0,45.24,26.63
臺北市,內湖區,紫陽里,3388,1825,1563,30,3418,7104,0,48.11,25.69
臺北市,內湖區,瑞陽里,3419,2160,1259,42,3461,6596,0,52.47,32.75
臺北市,內湖區,瑞光里,1947,1206,741,17,1964,3925,0,50.04,30.73
臺北市,內湖區,五分里,3430,1785,1645,30,3460,8758,0,39.51,20.38
臺北市,內湖區,東湖里,2951,1579,1372,25,2976,6861,0,43.38,23.01
臺北市,內湖區,樂康里,2902,1543,1359,21,2923,6927,0,42.2,22.28
臺北市,內湖區,內溝里,1799,989,810,13,1812,4037,0,44.88,24.5
臺北市,內湖區,週美里,3310,1605,1705,28,3338,7466,0,44.71,21.5
臺北市,內湖區,行善里,2935,1508,1427,30,2965,6099,0,48.61,24.73
臺北市,內湖區,石潭里,1441,804,637,14,1455,3369,0,43.19,23.86
臺北市,內湖區,湖興里,2739,1486,1253,16,2755,7424,0,37.11,20.02
臺北市,內湖區,湖元里,2107,1085,1022,19,2126,4537,0,46.86,23.91
臺北市,內湖區,安湖里,2870,1501,1369,26,2896,6387,0,45.34,23.5
臺北市,內湖區,秀湖里,2585,1509,1076,27,2612,5366,0,48.68,28.12
臺北市,內湖區,安泰里,1950,1071,879,15,1965,4591,0,42.8,23.33
臺北市,內湖區,金湖里,3787,2127,1660,38,3825,8128,0,47.06,26.17
臺北市,內湖區,康寧里,3337,1927,1410,29,3366,7322,0,45.97,26.32
臺北市,內湖區,明湖里,1988,1015,973,15,2003,4501,0,44.5,22.55
臺北市,內湖區,蘆洲里,391,169,222,5,396,1126,0,35.17,15.01
臺北市,內湖區,麗山里,2279,1108,1171,28,2307,4994,0,46.2,22.19
臺北市,內湖區,寶湖里,3701,2118,1583,26,3727,7959,0,46.83,26.61
臺北市,內湖區,南湖里,2141,1232,909,27,2168,4674,0,46.38,26.36
臺北市,內湖區,合計,107183,58760,48423,934,108117,232305,279598,46.54,25.29
臺北市,士林區,仁勇里,1547,672,875,13,1560,3285,0,47.49,20.46
臺北市,士林區,義信里,1235,620,615,12,1247,2736,0,45.58,22.66
臺北市,士林區,福林里,1137,549,588,14,1151,2482,0,46.37,22.12
臺北市,士林區,福德里,1836,938,898,12,1848,5079,0,36.39,18.47
臺北市,士林區,福志里,3378,1782,1596,22,3400,6507,0,52.25,27.39
臺北市,士林區,舊佳里,2597,1256,1341,19,2616,5295,0,49.41,23.72
臺北市,士林區,福佳里,3187,1500,1687,27,3214,6549,0,49.08,22.9
臺北市,士林區,後港里,2955,1249,1706,20,2975,6846,0,43.46,18.24
臺北市,士林區,福中里,2635,1128,1507,22,2657,5673,0,46.84,19.88
臺北市,士林區,前港里,1737,699,1038,14,1751,3851,0,45.47,18.15
臺北市,士林區,百齡里,2776,1177,1599,29,2805,5841,0,48.02,20.15
臺北市,士林區,承德里,2190,1088,1102,13,2203,4783,0,46.06,22.75
臺北市,士林區,福華里,2254,1110,1144,24,2278,5342,0,42.64,20.78
臺北市,士林區,明勝里,1987,939,1048,17,2004,4156,0,48.22,22.59
臺北市,士林區,福順里,2164,885,1279,28,2192,4679,0,46.85,18.91
臺北市,士林區,富光里,2240,896,1344,21,2261,5082,0,44.49,17.63
臺北市,士林區,葫蘆里,2891,1358,1533,41,2932,6264,0,46.81,21.68
臺北市,士林區,葫東里,1600,676,924,14,1614,3514,0,45.93,19.24
臺北市,士林區,社子里,2423,951,1472,26,2449,5517,0,44.39,17.24
臺北市,士林區,社新里,3264,1254,2010,29,3293,7737,0,42.56,16.21
臺北市,士林區,社園里,2761,1015,1746,25,2786,6210,0,44.86,16.34
臺北市,士林區,永倫里,2681,1022,1659,27,2708,6117,0,44.27,16.71
臺北市,士林區,福安里,1891,490,1401,24,1915,4416,0,43.37,11.1
臺北市,士林區,富洲里,2269,662,1607,22,2291,5424,0,42.24,12.21
臺北市,士林區,岩山里,1338,722,616,7,1345,2895,0,46.46,24.94
臺北市,士林區,名山里,3094,1601,1493,28,3122,6048,0,51.62,26.47
臺北市,士林區,德行里,1866,879,987,11,1877,3773,0,49.75,23.3
臺北市,士林區,德華里,2294,1073,1221,10,2304,4821,0,47.79,22.26
臺北市,士林區,聖山里,2127,1194,933,26,2153,4319,0,49.85,27.65
臺北市,士林區,忠誠里,2257,1415,842,16,2273,4739,0,47.96,29.86
臺北市,士林區,芝山里,3168,1597,1571,19,3187,6439,0,49.5,24.8
臺北市,士林區,東山里,2094,1193,901,26,2120,4371,0,48.5,27.29
臺北市,士林區,三玉里,2349,1195,1154,17,2366,4881,0,48.47,24.48
臺北市,士林區,蘭雅里,3431,1706,1725,35,3466,7425,0,46.68,22.98
臺北市,士林區,蘭興里,2682,1279,1403,17,2699,5452,0,49.5,23.46
臺北市,士林區,天福里,2432,1227,1205,16,2448,5286,0,46.31,23.21
臺北市,士林區,天祿里,2114,1013,1101,13,2127,4413,0,48.2,22.95
臺北市,士林區,天壽里,2070,1011,1059,15,2085,4299,0,48.5,23.52
臺北市,士林區,天和里,3005,1524,1481,27,3032,6370,0,47.6,23.92
臺北市,士林區,天山里,2801,1463,1338,28,2829,5880,0,48.11,24.88
臺北市,士林區,天玉里,3535,1798,1737,28,3563,7345,0,48.51,24.48
臺北市,士林區,天母里,2687,1376,1311,25,2712,5559,0,48.79,24.75
臺北市,士林區,永福里,521,199,322,3,524,1083,0,48.38,18.37
臺北市,士林區,公館里,494,169,325,10,504,1228,0,41.04,13.76
臺北市,士林區,新安里,795,304,491,7,802,1668,0,48.08,18.23
臺北市,士林區,陽明里,1116,511,605,12,1128,2666,0,42.31,19.17
臺北市,士林區,菁山里,558,227,331,4,562,1421,0,39.55,15.97
臺北市,士林區,平等里,550,156,394,5,555,1306,0,42.5,11.94
臺北市,士林區,溪山里,566,230,336,6,572,1328,0,43.07,17.32
臺北市,士林區,翠山里,1200,782,418,9,1209,2345,0,51.56,33.35
臺北市,士林區,臨溪里,1160,596,564,9,1169,2508,0,46.61,23.76
臺北市,士林區,合計,107939,50356,57583,944,108883,233253,274056,46.68,21.59
臺北市,北投區,建民里,1846,805,1041,12,1858,3704,0,50.16,21.73
臺北市,北投區,文林里,1704,754,950,11,1715,3685,0,46.54,20.46
臺北市,北投區,石牌里,2141,963,1178,14,2155,4492,0,47.97,21.44
臺北市,北投區,福興里,2884,1408,1476,32,2916,5935,0,49.13,23.72
臺北市,北投區,榮光里,2594,1312,1282,34,2628,6019,0,43.66,21.8
臺北市,北投區,榮華里,3127,1567,1560,17,3144,6221,0,50.54,25.19
臺北市,北投區,裕民里,3050,1516,1534,24,3074,6632,0,46.35,22.86
臺北市,北投區,振華里,2978,1560,1418,26,3004,6389,0,47.02,24.42
臺北市,北投區,永和里,3721,1805,1916,22,3743,7885,0,47.47,22.89
臺北市,北投區,永欣里,3259,1720,1539,20,3279,6840,0,47.94,25.15
臺北市,北投區,永明里,1977,1013,964,25,2002,4020,0,49.8,25.2
臺北市,北投區,東華里,1893,1028,865,14,1907,3773,0,50.54,27.25
臺北市,北投區,吉利里,2797,1525,1272,23,2820,5623,0,50.15,27.12
臺北市,北投區,吉慶里,1998,881,1117,19,2017,4216,0,47.84,20.9
臺北市,北投區,尊賢里,1839,782,1057,13,1852,3960,0,46.77,19.75
臺北市,北投區,立賢里,2092,1022,1070,21,2113,4612,0,45.82,22.16
臺北市,北投區,立農里,3619,1725,1894,34,3653,7578,0,48.21,22.76
臺北市,北投區,八仙里,2138,954,1184,21,2159,4729,0,45.65,20.17
臺北市,北投區,洲美里,933,347,586,8,941,1949,0,48.28,17.8
臺北市,北投區,奇岩里,4451,2146,2305,27,4478,9427,0,47.5,22.76
臺北市,北投區,清江里,3365,1597,1768,48,3413,8533,0,40.0,18.72
臺北市,北投區,中央里,3076,1404,1672,28,3104,7167,0,43.31,19.59
臺北市,北投區,長安里,2213,1034,1179,17,2230,5324,0,41.89,19.42
臺北市,北投區,大同里,2160,929,1231,29,2189,4700,0,46.57,19.77
臺北市,北投區,溫泉里,2613,1226,1387,21,2634,5643,0,46.68,21.73
臺北市,北投區,林泉里,1018,543,475,10,1028,2679,0,38.37,20.27
臺北市,北投區,中心里,2355,1230,1125,17,2372,5695,0,41.65,21.6
臺北市,北投區,中庸里,1541,714,827,8,1549,3547,0,43.67,20.13
臺北市,北投區,開明里,2688,1415,1273,25,2713,5783,0,46.91,24.47
臺北市,北投區,中和里,2082,1083,999,15,2097,4233,0,49.54,25.58
臺北市,北投區,智仁里,2253,1162,1091,16,2269,5189,0,43.73,22.39
臺北市,北投區,秀山里,1230,643,587,18,1248,2834,0,44.04,22.69
臺北市,北投區,文化里,1703,1138,565,16,1719,3518,0,48.86,32.35
臺北市,北投區,豐年里,1487,757,730,8,1495,3811,0,39.23,19.86
臺北市,北投區,稻香里,2062,1165,897,18,2080,4730,0,43.97,24.63
臺北市,北投區,桃源里,2392,1086,1306,19,2411,5227,0,46.13,20.78
臺北市,北投區,一德里,2731,1211,1520,26,2757,6316,0,43.65,19.17
臺北市,北投區,關渡里,4187,2063,2124,57,4244,9738,0,43.58,21.19
臺北市,北投區,泉源里,822,336,486,8,830,2119,0,39.17,15.86
臺北市,北投區,湖山里,580,265,315,9,589,1446,0,40.73,18.33
臺北市,北投區,大屯里,415,145,270,2,417,1087,0,38.36,13.34
臺北市,北投區,湖田里,316,146,170,3,319,826,0,38.62,17.68
臺北市,北投區,合計,94330,46125,48205,835,95165,207834,247333,45.79,22.19
臺北市,合計,合計,1006037,533890,472147,8724,1014761,2155416,2562738,47.08,24.77
新北市,板橋區,留侯里,699,392,307,6,705,1395,0,50.54,28.1
新北市,板橋區,流芳里,557,266,291,5,562,1228,0,45.77,21.66
新北市,板橋區,赤松里,422,212,210,1,423,838,0,50.48,25.3
新北市,板橋區,黃石里,465,191,274,7,472,1026,0,46.0,18.62
新北市,板橋區,挹秀里,828,485,343,7,835,1648,0,50.67,29.43
新北市,板橋區,湳興里,1911,938,973,18,1929,4525,0,42.63,20.73
新北市,板橋區,新興里,1140,532,608,11,1151,2846,0,40.44,18.69
新北市,板橋區,社後里,2464,1208,1256,27,2491,8998,0,27.68,13.43
新北市,板橋區,香社里,1731,749,982,18,1749,3907,0,44.77,19.17
新北市,板橋區,中正里,1875,860,1015,14,1889,4691,0,40.27,18.33
新北市,板橋區,自強里,2339,1337,1002,13,2352,4425,0,53.15,30.21
新北市,板橋區,自立里,1150,507,643,10,1160,2471,0,46.94,20.52
新北市,板橋區,光華里,1103,581,522,11,1114,2357,0,47.26,24.65
新北市,板橋區,國光里,1799,1281,518,9,1808,3349,0,53.99,38.25
新北市,板橋區,港尾里,1228,615,613,7,1235,2463,0,50.14,24.97
新北市,板橋區,金華里,1460,629,831,10,1470,3446,0,42.66,18.25
新北市,板橋區,港德里,1695,746,949,17,1712,4107,0,41.68,18.16
新北市,板橋區,民權里,1142,596,546,9,1151,2304,0,49.96,25.87
新北市,板橋區,建國里,1426,598,828,17,1443,3109,0,46.41,19.23
新北市,板橋區,漢生里,1797,894,903,14,1811,3542,0,51.13,25.24
新北市,板橋區,公舘里,1463,615,848,14,1477,3318,0,44.51,18.54
新北市,板橋區,新民里,1664,797,867,16,1680,3648,0,46.05,21.85
新北市,板橋區,幸福里,1406,586,820,10,1416,3487,0,40.61,16.81
新北市,板橋區,忠誠里,1866,1290,576,12,1878,3605,0,52.09,35.78
新北市,板橋區,百壽里,1030,477,553,13,1043,2364,0,44.12,20.18
新北市,板橋區,介壽里,1080,528,552,13,1093,2555,0,42.78,20.67
新北市,板橋區,新埔里,929,394,535,10,939,1865,0,50.35,21.13
新北市,板橋區,華江里,2824,1392,1432,16,2840,6159,0,46.11,22.6
新北市,板橋區,江翠里,1931,762,1169,12,1943,4582,0,42.41,16.63
新北市,板橋區,純翠里,1981,810,1171,14,1995,4774,0,41.79,16.97
新北市,板橋區,溪頭里,2424,1004,1420,21,2445,5675,0,43.08,17.69
新北市,板橋區,聯翠里,1455,743,712,12,1467,3287,0,44.63,22.6
新北市,板橋區,宏翠里,1983,956,1027,19,2002,4715,0,42.46,20.28
新北市,板橋區,仁翠里,1126,416,710,14,1140,2555,0,44.62,16.28
新北市,板橋區,新翠里,3166,1406,1760,25,3191,7107,0,44.9,19.78
新北市,板橋區,吉翠里,1500,605,895,12,1512,3275,0,46.17,18.47
新北市,板橋區,德翠里,2760,1421,1339,27,2787,6174,0,45.14,23.02
新北市,板橋區,滿翠里,1121,394,727,16,1137,2666,0,42.65,14.78
新北市,板橋區,明翠里,1822,766,1056,21,1843,4242,0,43.45,18.06
新北市,板橋區,松翠里,1299,537,762,9,1308,2962,0,44.16,18.13
新北市,板橋區,柏翠里,1778,808,970,18,1796,4168,0,43.09,19.39
新北市,板橋區,龍翠里,1904,824,1080,15,1919,4391,0,43.7,18.77
新北市,板橋區,華翠里,1430,619,811,14,1444,3044,0,47.44,20.34
新北市,板橋區,忠翠里,4158,2040,2118,35,4193,9043,0,46.37,22.56
新北市,板橋區,嵐翠里,921,345,576,8,929,2150,0,43.21,16.05
新北市,板橋區,文翠里,1566,693,873,6,1572,3515,0,44.72,19.72
新北市,板橋區,青翠里,1123,454,669,8,1131,2638,0,42.87,17.21
新北市,板橋區,懷翠里,2071,845,1226,24,2095,5414,0,38.7,15.61
新北市,板橋區,福翠里,533,257,276,6,539,1221,0,44.14,21.05
新北市,板橋區,港嘴里,2280,998,1282,24,2304,5318,0,43.32,18.77
新北市,板橋區,振興里,1796,800,996,17,1813,3920,0,46.25,20.41
新北市,板橋區,振義里,1677,680,997,22,1699,3731,0,45.54,18.23
新北市,板橋區,光復里,1288,557,731,6,1294,2939,0,44.03,18.95
新北市,板橋區,埔墘里,2389,1077,1312,18,2407,5578,0,43.15,19.31
新北市,板橋區,長壽里,1190,501,689,12,1202,2572,0,46.73,19.48
新北市,板橋區,福壽里,1314,690,624,11,1325,2920,0,45.38,23.63
新北市,板橋區,海山里,2943,1403,1540,19,2962,6417,0,46.16,21.86
新北市,板橋區,九如里,1082,415,667,11,1093,2522,0,43.34,16.46
新北市,板橋區,玉光里,1886,831,1055,14,1900,4586,0,41.43,18.12
新北市,板橋區,光仁里,1123,522,601,14,1137,2444,0,46.52,21.36
新北市,板橋區,埤墘里,1783,782,1001,24,1807,3765,0,47.99,20.77
新北市,板橋區,永安里,1324,543,781,15,1339,3069,0,43.63,17.69
新北市,板橋區,雙玉里,1583,690,893,12,1595,3525,0,45.25,19.57
新北市,板橋區,廣新里,1221,569,652,16,1237,3031,0,40.81,18.77
新北市,板橋區,深丘里,3227,1694,1533,25,3252,7123,0,45.65,23.78
新北市,板橋區,香丘里,1347,599,748,6,1353,3179,0,42.56,18.84
新北市,板橋區,西安里,1019,475,544,7,1026,2350,0,43.66,20.21
新北市,板橋區,東丘里,1764,741,1023,22,1786,3895,0,45.85,19.02
新北市,板橋區,長安里,1749,829,920,17,1766,3802,0,46.45,21.8
新北市,板橋區,福丘里,1996,1075,921,26,2022,4141,0,48.83,25.96
新北市,板橋區,福祿里,1467,818,649,10,1477,3382,0,43.67,24.19
新北市,板橋區,民族里,1760,864,896,16,1776,3878,0,45.8,22.28
新北市,板橋區,國泰里,1431,724,707,22,1453,3111,0,46.71,23.27
新北市,板橋區,福德里,2036,969,1067,14,2050,4371,0,46.9,22.17
新北市,板橋區,景星里,1288,660,628,14,1302,3021,0,43.1,21.85
新北市,板橋區,福星里,1514,749,765,4,1518,3064,0,49.54,24.45
新北市,板橋區,鄉雲里,1556,780,776,21,1577,3320,0,47.5,23.49
新北市,板橋區,廣德里,2630,1297,1333,21,2651,5909,0,44.86,21.95
新北市,板橋區,大豐里,1803,926,877,14,1817,4094,0,44.38,22.62
新北市,板橋區,重慶里,3118,1591,1527,26,3144,7469,0,42.09,21.3
新北市,板橋區,仁愛里,1236,718,518,11,1247,2702,0,46.15,26.57
新北市,板橋區,和平里,1401,796,605,14,1415,3281,0,43.13,24.26
新北市,板橋區,廣福里,1339,641,698,11,1350,3505,0,38.52,18.29
新北市,板橋區,華興里,1703,845,858,21,1724,3734,0,46.17,22.63
新北市,板橋區,華貴里,1032,468,564,17,1049,2257,0,46.48,20.74
新北市,板橋區,華德里,2444,1210,1234,29,2473,6150,0,40.21,19.67
新北市,板橋區,華東里,3350,1809,1541,24,3374,6979,0,48.35,25.92
新北市,板橋區,信義里,1600,790,810,13,1613,3812,0,42.31,20.72
新北市,板橋區,浮洲里,1355,525,830,11,1366,3334,0,40.97,15.75
新北市,板橋區,華中里,1922,779,1143,16,1938,4625,0,41.9,16.84
新北市,板橋區,僑中里,1437,585,852,7,1444,3700,0,39.03,15.81
新北市,板橋區,中山里,2501,1311,1190,23,2524,6074,0,41.55,21.58
新北市,板橋區,復興里,433,252,181,6,439,873,0,50.29,28.87
新北市,板橋區,大安里,1472,673,799,12,1484,3466,0,42.82,19.42
新北市,板橋區,福安里,2648,1447,1201,20,2668,6234,0,42.8,23.21
新北市,板橋區,聚安里,1781,767,1014,18,1799,4615,0,38.98,16.62
新北市,板橋區,龍安里,1067,448,619,20,1087,2464,0,44.12,18.18
新北市,板橋區,崑崙里,3334,1563,1771,34,3368,8523,0,39.52,18.34
新北市,板橋區,溪洲里,2013,908,1105,21,2034,5148,0,39.51,17.64
新北市,板橋區,溪北里,1290,603,687,17,1307,3079,0,42.45,19.58
新北市,板橋區,香雅里,1026,484,542,11,1037,2397,0,43.26,20.19
新北市,板橋區,新生里,1653,725,928,17,1670,3742,0,44.63,19.37
新北市,板橋區,文德里,1191,599,592,5,1196,2692,0,44.43,22.25
新北市,板橋區,文化里,1325,573,752,17,1342,2948,0,45.52,19.44
新北市,板橋區,新海里,1292,567,725,6,1298,3027,0,42.88,18.73
新北市,板橋區,莒光里,1133,467,666,12,1145,2449,0,46.75,19.07
新北市,板橋區,富貴里,1001,477,524,11,1012,2040,0,49.61,23.38
新北市,板橋區,正泰里,1219,553,666,18,1237,2595,0,47.67,21.31
新北市,板橋區,民生里,897,402,495,13,910,1940,0,46.91,20.72
新北市,板橋區,後埔里,1529,777,752,20,1549,3280,0,47.23,23.69
新北市,板橋區,華福里,822,422,400,7,829,1789,0,46.34,23.59
新北市,板橋區,堂春里,1474,670,804,19,1493,3718,0,40.16,18.02
新北市,板橋區,成和里,2168,1018,1150,23,2191,6055,0,36.18,16.81
新北市,板橋區,光榮里,1032,545,487,5,1037,2287,0,45.34,23.83
新北市,板橋區,民安里,835,432,403,4,839,1772,0,47.35,24.38
新北市,板橋區,陽明里,1124,472,652,9,1133,2400,0,47.21,19.67
新北市,板橋區,朝陽里,1234,487,747,13,1247,2973,0,41.94,16.38
新北市,板橋區,松柏里,953,419,534,16,969,2012,0,48.16,20.83
新北市,板橋區,文聖里,1498,607,891,12,1510,3479,0,43.4,17.45
新北市,板橋區,居仁里,1435,622,813,16,1451,3379,0,42.94,18.41
新北市,板橋區,莊敬里,1661,821,840,19,1680,3540,0,47.46,23.19
新北市,板橋區,東安里,824,358,466,13,837,2026,0,41.31,17.67
新北市,板橋區,五權里,1581,729,852,14,1595,3585,0,44.49,20.33
新北市,板橋區,溪福里,4709,2358,2351,41,4750,12217,0,38.88,19.3
新北市,板橋區,大觀里,1250,501,749,10,1260,3210,0,39.25,15.61
新北市,板橋區,歡園里,496,192,304,4,500,1091,0,45.83,17.6
新北市,板橋區,合計,202849,95665,107184,1871,204720,466918,555551,43.84,20.49
新北市,三重區,大有里,2039,842,1197,16,2055,4726,0,43.48,17.82
新北市,三重區,二重里,565,330,235,9,574,1436,0,39.97,22.98
新北市,三重區,頂崁里,966,338,628,3,969,2322,0,41.73,14.56
新北市,三重區,谷王里,444,172,272,4,448,904,0,49.56,19.03
新北市,三重區,中興里,1650,629,1021,15,1665,3568,0,46.66,17.63
新北市,三重區,德厚里,176,62,114,2,178,351,0,50.71,17.66
新北市,三重區,成功里,2616,1255,1361,15,2631,5671,0,46.39,22.13
新北市,三重區,福祉里,2171,968,1203,13,2184,4889,0,44.67,19.8
新北市,三重區,福民里,1314,541,773,15,1329,3007,0,44.2,17.99
新北市,三重區,過田里,2490,1186,1304,30,2520,8822,0,28.56,13.44
新北市,三重區,錦田里,830,339,491,5,835,1860,0,44.89,18.23
新北市,三重區,重明里,1500,658,842,14,1514,3239,0,46.74,20.31
新北市,三重區,光田里,1879,839,1040,30,1909,3937,0,48.49,21.31
新北市,三重區,光陽里,2719,1223,1496,26,2745,5711,0,48.07,21.41
新北市,三重區,田心里,1536,641,895,17,1553,3667,0,42.35,17.48
新北市,三重區,福田里,1467,621,846,13,1480,3107,0,47.63,19.99
新北市,三重區,田中里,2429,933,1496,22,2451,5458,0,44.91,17.09
新北市,三重區,田安里,2414,1042,1372,27,2441,5517,0,44.25,18.89
新北市,三重區,三民里,1185,462,723,12,1197,2877,0,41.61,16.06
新北市,三重區,光明里,2793,1283,1510,20,2813,6525,0,43.11,19.66
新北市,三重區,光正里,1086,557,529,6,1092,2380,0,45.88,23.4
新北市,三重區,同安里,487,224,263,6,493,1288,0,38.28,17.39
新北市,三重區,同慶里,696,308,388,2,698,1582,0,44.12,19.47
新北市,三重區,菜寮里,897,396,501,8,905,1982,0,45.66,19.98
新北市,三重區,永春里,731,354,377,11,742,1664,0,44.59,21.27
新北市,三重區,中正里,593,272,321,8,601,1261,0,47.66,21.57
新北市,三重區,吉利里,533,240,293,8,541,1289,0,41.97,18.62
新北市,三重區,大同里,765,342,423,5,770,1819,0,42.33,18.8
新北市,三重區,中民里,504,236,268,3,507,1130,0,44.87,20.88
新北市,三重區,平和里,610,294,316,10,620,1363,0,45.49,21.57
新北市,三重區,大安里,636,328,308,4,640,1483,0,43.16,22.12
新北市,三重區,仁德里,722,309,413,7,729,1785,0,40.84,17.31
新北市,三重區,忠孝里,711,315,396,8,719,1629,0,44.14,19.34
新北市,三重區,仁義里,511,220,291,5,516,1175,0,43.91,18.72
新北市,三重區,光榮里,538,242,296,4,542,1315,0,41.22,18.4
新北市,三重區,光輝里,611,284,327,5,616,1391,0,44.28,20.42
新北市,三重區,福星里,555,263,292,3,558,1098,0,50.82,23.95
新北市,三重區,福利里,927,451,476,3,930,2035,0,45.7,22.16
新北市,三重區,清和里,1689,764,925,21,1710,3628,0,47.13,21.06
新北市,三重區,永興里,604,279,325,8,612,1275,0,48.0,21.88
新北市,三重區,中山里,1083,479,604,10,1093,2448,0,44.65,19.57
新北市,三重區,大園里,1006,429,577,5,1011,2453,0,41.21,17.49
新北市,三重區,國隆里,1139,577,562,10,1149,2406,0,47.76,23.98
新北市,三重區,重陽里,1317,600,717,14,1331,3178,0,41.88,18.88
新北市,三重區,民生里,1647,633,1014,15,1662,3797,0,43.77,16.67
新北市,三重區,重新里,641,218,423,11,652,1352,0,48.22,16.12
新北市,三重區,正德里,466,209,257,2,468,1030,0,45.44,20.29
新北市,三重區,正義里,774,320,454,8,782,1597,0,48.97,20.04
新北市,三重區,正安里,802,362,440,5,807,1771,0,45.57,20.44
新北市,三重區,自強里,695,279,416,8,703,1652,0,42.55,16.89
新北市,三重區,文化里,955,407,548,5,960,2007,0,47.83,20.28
新北市,三重區,中央里,686,267,419,5,691,1674,0,41.28,15.95
新北市,三重區,雙園里,396,203,193,3,399,855,0,46.67,23.74
新北市,三重區,錦通里,634,291,343,8,642,1344,0,47.77,21.65
新北市,三重區,錦安里,681,303,378,3,684,1672,0,40.91,18.12
新北市,三重區,長安里,820,339,481,7,827,1939,0,42.65,17.48
新北市,三重區,光華里,886,382,504,6,892,2070,0,43.09,18.45
新北市,三重區,長生里,348,146,202,5,353,813,0,43.42,17.96
新北市,三重區,開元里,649,300,349,23,672,1385,0,48.52,21.66
新北市,三重區,大德里,352,172,180,6,358,770,0,46.49,22.34
新北市,三重區,長元里,941,441,500,12,953,2229,0,42.75,19.78
新北市,三重區,長江里,818,346,472,10,828,1876,0,44.14,18.44
新北市,三重區,長泰里,844,369,475,12,856,2003,0,42.74,18.42
新北市,三重區,長福里,583,248,335,14,597,1436,0,41.57,17.27
新北市,三重區,介壽里,460,215,245,13,473,1039,0,45.52,20.69
新北市,三重區,萬壽里,812,380,432,17,829,1775,0,46.7,21.41
新北市,三重區,錦江里,800,315,485,13,813,2123,0,38.29,14.84
新北市,三重區,龍濱里,1264,544,720,15,1279,2926,0,43.71,18.59
新北市,三重區,龍門里,682,306,376,5,687,1678,0,40.94,18.24
新北市,三重區,秀江里,469,201,268,5,474,1136,0,41.73,17.69
新北市,三重區,奕壽里,721,300,421,8,729,1549,0,47.06,19.37
新北市,三重區,三安里,1004,444,560,7,1011,2410,0,41.95,18.42
新北市,三重區,福安里,1175,476,699,20,1195,2698,0,44.29,17.64
新北市,三重區,信安里,720,340,380,6,726,1802,0,40.29,18.87
新北市,三重區,安慶里,815,328,487,3,818,1889,0,43.3,17.36
新北市,三重區,幸福里,1784,690,1094,11,1795,4172,0,43.02,16.54
新北市,三重區,六合里,1455,625,830,16,1471,3336,0,44.09,18.74
新北市,三重區,六福里,2039,812,1227,16,2055,4936,0,41.63,16.45
新北市,三重區,順德里,891,395,496,11,902,2027,0,44.5,19.49
新北市,三重區,承德里,715,290,425,7,722,1631,0,44.27,17.78
新北市,三重區,瑞德里,935,404,531,12,947,2145,0,44.15,18.83
新北市,三重區,崇德里,1543,606,937,11,1554,3509,0,44.29,17.27
新北市,三重區,厚德里,1461,645,816,15,1476,3088,0,47.8,20.89
新北市,三重區,維德里,1169,479,690,16,1185,2545,0,46.56,18.82
新北市,三重區,尚德里,1131,470,661,5,1136,2674,0,42.48,17.58
新北市,三重區,培德里,1500,614,886,7,1507,3267,0,46.13,18.79
新北市,三重區,永德里,1802,704,1098,24,1826,4360,0,41.88,16.15
新北市,三重區,永盛里,1237,475,762,14,1251,2861,0,43.73,16.6
新北市,三重區,永福里,2044,797,1247,23,2067,4596,0,44.97,17.34
新北市,三重區,永清里,1900,668,1232,10,1910,4710,0,40.55,14.18
新北市,三重區,永安里,1516,618,898,11,1527,3553,0,42.98,17.39
新北市,三重區,永煇里,970,357,613,14,984,2263,0,43.48,15.78
新北市,三重區,溪美里,3389,1405,1984,33,3422,7625,0,44.88,18.43
新北市,三重區,福隆里,1625,669,956,9,1634,3940,0,41.47,16.98
新北市,三重區,五常里,1606,656,950,17,1623,3874,0,41.89,16.93
新北市,三重區,五福里,1352,552,800,10,1362,3407,0,39.98,16.2
新北市,三重區,仁忠里,1016,443,573,12,1028,2802,0,36.69,15.81
新北市,三重區,慈福里,862,303,559,7,869,1998,0,43.49,15.17
新北市,三重區,慈生里,931,372,559,12,943,2046,0,46.09,18.18
新北市,三重區,慈惠里,909,321,588,7,916,2029,0,45.15,15.82
新北市,三重區,慈愛里,1381,537,844,21,1402,3070,0,45.67,17.49
新北市,三重區,慈化里,931,376,555,6,937,2229,0,42.04,16.87
新北市,三重區,慈祐里,1821,726,1095,23,1844,4356,0,42.33,16.67
新北市,三重區,五華里,1926,756,1170,17,1943,4540,0,42.8,16.65
新北市,三重區,富貴里,2469,1146,1323,15,2484,5713,0,43.48,20.06
新北市,三重區,富華里,1142,492,650,16,1158,2882,0,40.18,17.07
新北市,三重區,富福里,683,278,405,3,686,1839,0,37.3,15.12
新北市,三重區,碧華里,3121,1494,1627,21,3142,7294,0,43.08,20.48
新北市,三重區,五谷里,817,345,472,8,825,1740,0,47.41,19.83
新北市,三重區,博愛里,1790,758,1032,17,1807,4013,0,45.03,18.89
新北市,三重區,福德里,1566,716,850,12,1578,3686,0,42.81,19.42
新北市,三重區,永吉里,1037,427,610,6,1043,2539,0,41.08,16.82
新北市,三重區,永發里,2245,821,1424,18,2263,5046,0,44.85,16.27
新北市,三重區,永順里,1666,638,1028,10,1676,4437,0,37.77,14.38
新北市,三重區,永豐里,2064,784,1280,21,2085,5061,0,41.2,15.49
新北市,三重區,立德里,1348,559,789,11,1359,2994,0,45.39,18.67
新北市,三重區,福樂里,1355,505,850,11,1366,3293,0,41.48,15.34
新北市,三重區,仁華里,1685,704,981,18,1703,3764,0,45.24,18.7
新北市,三重區,五順里,1346,532,814,10,1356,3524,0,38.48,15.1
新北市,三重區,合計,141849,60175,81674,1356,143205,330362,383135,43.35,18.21
新北市,中和區,中原里,2690,1384,1306,24,2714,6550,0,41.44,21.13
新北市,中和區,平河里,3637,1987,1650,29,3666,7974,0,45.97,24.92
新北市,中和區,信和里,1703,847,856,20,1723,3796,0,45.39,22.31
新北市,中和區,仁和里,1410,745,665,8,1418,3469,0,40.88,21.48
新北市,中和區,中正里,1354,697,657,13,1367,3452,0,39.6,20.19
新北市,中和區,建和里,1554,983,571,14,1568,3096,0,50.65,31.75
新北市,中和區,連和里,1024,667,357,10,1034,2171,0,47.63,30.72
新北市,中和區,連城里,2717,1654,1063,22,2739,5682,0,48.2,29.11
新北市,中和區,力行里,2515,1351,1164,28,2543,5265,0,48.3,25.66
新北市,中和區,枋寮里,1506,805,701,17,1523,3312,0,45.98,24.31
新北市,中和區,漳和里,1573,870,703,9,1582,3410,0,46.39,25.51
新北市,中和區,廟美里,1796,953,843,14,1810,3887,0,46.57,24.52
新北市,中和區,福真里,1683,863,820,18,1701,3709,0,45.86,23.27
新北市,中和區,福善里,1791,956,835,13,1804,3832,0,47.08,24.95
新北市,中和區,福美里,1878,1024,854,12,1890,3903,0,48.42,26.24
新北市,中和區,福祥里,2126,1110,1016,22,2148,4460,0,48.16,24.89
新北市,中和區,瓦磘里,2073,1099,974,17,2090,4916,0,42.51,22.36
新北市,中和區,福和里,1484,809,675,19,1503,3253,0,46.2,24.87
新北市,中和區,佳和里,2092,1172,920,27,2119,4420,0,47.94,26.52
新北市,中和區,安樂里,1682,1067,615,17,1699,3265,0,52.04,32.68
新北市,中和區,安和里,1408,804,604,9,1417,2767,0,51.21,29.06
新北市,中和區,安平里,2702,1757,945,27,2729,5289,0,51.6,33.22
新北市,中和區,中安里,2086,1346,740,12,2098,3903,0,53.75,34.49
新北市,中和區,泰安里,1461,834,627,26,1487,3171,0,46.89,26.3
新北市,中和區,新南里,3308,1953,1355,24,3332,7115,0,46.83,27.45
新北市,中和區,南山里,2154,1258,896,17,2171,4499,0,48.26,27.96
新北市,中和區,秀山里,1860,1120,740,13,1873,4018,0,46.62,27.87
新北市,中和區,秀成里,1441,852,589,10,1451,3062,0,47.39,27.82
新北市,中和區,秀福里,2071,1228,843,13,2084,4298,0,48.49,28.57
新北市,中和區,秀景里,2775,1771,1004,23,2798,5620,0,49.79,31.51
新北市,中和區,秀明里,2116,1450,666,27,2143,4436,0,48.31,32.69
新北市,中和區,秀峰里,2030,1293,737,22,2052,4318,0,47.52,29.94
新北市,中和區,秀仁里,1302,796,506,15,1317,2931,0,44.93,27.16
新北市,中和區,頂南里,1251,820,431,12,1263,2614,0,48.32,31.37
新北市,中和區,華新里,2727,1755,972,32,2759,6686,0,41.27,26.25
新北市,中和區,東南里,1792,1350,442,21,1813,3818,0,47.49,35.36
新北市,中和區,華南里,2009,1302,707,14,2023,4482,0,45.14,29.05
新北市,中和區,忠孝里,1711,1113,598,19,1730,4171,0,41.48,26.68
新北市,中和區,崇南里,1905,1253,652,29,1934,3856,0,50.16,32.49
新北市,中和區,景南里,1240,773,467,18,1258,2778,0,45.28,27.83
新北市,中和區,橫路里,142,63,79,0,142,310,0,45.81,20.32
新北市,中和區,內南里,1893,1155,738,23,1916,4421,0,43.34,26.13
新北市,中和區,壽南里,961,548,413,14,975,2183,0,44.66,25.1
新北市,中和區,外南里,1622,897,725,10,1632,6944,0,23.5,12.92
新北市,中和區,復興里,2069,1218,851,22,2091,4423,0,47.28,27.54
新北市,中和區,和興里,1905,1131,774,18,1923,3949,0,48.7,28.64
新北市,中和區,景平里,2386,1493,893,21,2407,4885,0,49.27,30.56
新北市,中和區,景新里,1540,908,632,18,1558,3210,0,48.54,28.29
新北市,中和區,景福里,2374,1461,913,29,2403,5145,0,46.71,28.4
新北市,中和區,景安里,2195,1333,862,25,2220,4350,0,51.03,30.64
新北市,中和區,景文里,1615,978,637,18,1633,3381,0,48.3,28.93
新北市,中和區,錦和里,2112,1162,950,21,2133,4740,0,45.0,24.51
新北市,中和區,錦昌里,947,576,371,11,958,1986,0,48.24,29.0
新北市,中和區,灰磘里,279,121,158,2,281,699,0,40.2,17.31
新北市,中和區,積穗里,3452,1855,1597,24,3476,7243,0,47.99,25.61
新北市,中和區,民享里,1084,476,608,4,1088,2221,0,48.99,21.43
新北市,中和區,員山里,2422,1204,1218,32,2454,5500,0,44.62,21.89
新北市,中和區,嘉穗里,1107,543,564,14,1121,2534,0,44.24,21.43
新北市,中和區,文元里,2041,977,1064,19,2060,4552,0,45.25,21.46
新北市,中和區,嘉新里,1474,740,734,13,1487,3544,0,41.96,20.88
新北市,中和區,民安里,1974,994,980,15,1989,4463,0,44.57,22.27
新北市,中和區,安穗里,1710,826,884,9,1719,4026,0,42.7,20.52
新北市,中和區,瑞穗里,977,557,420,11,988,2090,0,47.27,26.65
新北市,中和區,明穗里,1828,864,964,14,1842,3932,0,46.85,21.97
新北市,中和區,清穗里,1306,645,661,8,1314,2811,0,46.74,22.95
新北市,中和區,自強里,1857,869,988,15,1872,4374,0,42.8,19.87
新北市,中和區,德穗里,1823,946,877,19,1842,4038,0,45.62,23.43
新北市,中和區,民生里,1750,900,850,24,1774,3746,0,47.36,24.03
新北市,中和區,國光里,1593,852,741,15,1608,3413,0,47.11,24.96
新北市,中和區,壽德里,1952,1315,637,22,1974,3950,0,49.97,33.29
新北市,中和區,明德里,1431,666,765,19,1450,3434,0,42.22,19.39
新北市,中和區,秀水里,1470,948,522,12,1482,3329,0,44.52,28.48
新北市,中和區,德行里,2819,1621,1198,23,2842,5696,0,49.89,28.46
新北市,中和區,宜安里,863,558,305,13,876,1721,0,50.9,32.42
新北市,中和區,安順里,1984,1236,748,25,2009,3886,0,51.7,31.81
新北市,中和區,秀義里,1195,664,531,10,1205,2405,0,50.1,27.61
新北市,中和區,秀士里,1007,651,356,12,1019,2226,0,45.78,29.25
新北市,中和區,興南里,1248,776,472,21,1269,2756,0,46.04,28.16
新北市,中和區,景本里,941,565,376,6,947,1883,0,50.29,30.01
新北市,中和區,福南里,1673,1096,577,18,1691,3773,0,44.82,29.05
新北市,中和區,中興里,2657,1593,1064,12,2669,5825,0,45.82,27.35
新北市,中和區,吉興里,1187,750,437,11,1198,2623,0,45.67,28.59
新北市,中和區,中山里,998,495,503,10,1008,2395,0,42.09,20.67
新北市,中和區,碧河里,2044,1081,963,17,2061,4326,0,47.64,24.99
新北市,中和區,錦中里,1559,829,730,11,1570,3643,0,43.1,22.76
新北市,中和區,錦盛里,1486,708,778,17,1503,3432,0,43.79,20.63
新北市,中和區,民有里,1174,617,557,10,1184,2486,0,47.63,24.82
新北市,中和區,員富里,1354,667,687,17,1371,3236,0,42.37,20.61
新北市,中和區,嘉慶里,1506,735,771,11,1517,3862,0,39.28,19.03
新北市,中和區,冠穗里,1455,698,757,14,1469,2946,0,49.86,23.69
新北市,中和區,國華里,1311,636,675,18,1329,2987,0,44.49,21.29
新北市,中和區,正南里,1281,838,443,17,1298,3087,0,42.05,27.15
新北市,中和區,正行里,1172,660,512,4,1176,2564,0,45.87,25.74
新北市,中和區,合計,161842,92566,69276,1554,163396,355238,408654,46.0,26.06
新北市,永和區,福林里,1366,812,554,13,1379,2917,0,47.27,27.84
新北市,永和區,文化里,1184,739,445,16,1200,2476,0,48.47,29.85
新北市,永和區,豫溪里,1554,981,573,21,1575,4502,0,34.98,21.79
新北市,永和區,光明里,1338,845,493,13,1351,2581,0,52.34,32.74
新北市,永和區,仁愛里,1229,723,506,11,1240,2419,0,51.26,29.89
新北市,永和區,永貞里,1473,879,594,13,1486,2938,0,50.58,29.92
新北市,永和區,永福里,1241,747,494,8,1249,2396,0,52.13,31.18
新北市,永和區,民治里,1065,679,386,8,1073,2525,0,42.5,26.89
新北市,永和區,永成里,409,329,80,7,416,876,0,47.49,37.56
新北市,永和區,忠義里,347,282,65,5,352,704,0,50.0,40.06
新北市,永和區,永元里,1978,1188,790,20,1998,4085,0,48.91,29.08
新北市,永和區,秀林里,1714,926,788,8,1722,3437,0,50.1,26.94
新北市,永和區,保安里,3051,1750,1301,27,3078,6137,0,50.15,28.52
新北市,永和區,中溪里,2120,1180,940,19,2139,4473,0,47.82,26.38
新北市,永和區,永安里,1874,1157,717,13,1887,3634,0,51.93,31.84
新北市,永和區,民族里,1944,1208,736,10,1954,3986,0,49.02,30.31
新北市,永和區,民權里,1837,1112,725,14,1851,3852,0,48.05,28.87
新北市,永和區,中興里,1315,794,521,9,1324,2760,0,47.97,28.77
新北市,永和區,勵行里,493,239,254,2,495,1091,0,45.37,21.91
新北市,永和區,秀朗里,1523,879,644,11,1534,3358,0,45.68,26.18
新北市,永和區,秀成里,1199,683,516,9,1208,2545,0,47.47,26.84
新北市,永和區,上溪里,782,457,325,6,788,1702,0,46.3,26.85
新北市,永和區,竹林里,1501,972,529,12,1513,3222,0,46.96,30.17
新北市,永和區,雙和里,1764,1082,682,15,1779,3413,0,52.12,31.7
新北市,永和區,安和里,1649,1026,623,18,1667,3354,0,49.7,30.59
新北市,永和區,水源里,1791,1086,705,13,1804,3469,0,52.0,31.31
新北市,永和區,協和里,1275,738,537,7,1282,2623,0,48.88,28.14
新北市,永和區,河堤里,1381,871,510,12,1393,2995,0,46.51,29.08
新北市,永和區,頂溪里,1115,663,452,19,1134,2205,0,51.43,30.07
新北市,永和區,潭墘里,1977,1295,682,18,1995,3956,0,50.43,32.74
新北市,永和區,潭安里,2006,1315,691,21,2027,4105,0,49.38,32.03
新北市,永和區,大新里,1153,703,450,11,1164,2298,0,50.65,30.59
新北市,永和區,保平里,2027,1143,884,21,2048,4115,0,49.77,27.78
新北市,永和區,民本里,1505,885,620,13,1518,3433,0,44.22,25.78
新北市,永和區,民樂里,2060,1329,731,12,2072,4047,0,51.2,32.84
新北市,永和區,光復里,713,440,273,5,718,1527,0,47.02,28.81
新北市,永和區,復興里,1037,631,406,11,1048,2119,0,49.46,29.78
新北市,永和區,福和里,2203,1396,807,16,2219,4495,0,49.37,31.06
新北市,永和區,得和里,1934,1263,671,22,1956,3718,0,52.61,33.97
新北市,永和區,智光里,1226,749,477,9,1235,2845,0,43.41,26.33
新北市,永和區,新生里,383,276,107,5,388,809,0,47.96,34.12
新北市,永和區,大同里,444,321,123,3,447,907,0,49.28,35.39
新北市,永和區,前溪里,911,565,346,5,916,1894,0,48.36,29.83
新北市,永和區,和平里,1938,1156,782,21,1959,4232,0,46.29,27.32
新北市,永和區,新廍里,1016,618,398,7,1023,1996,0,51.25,30.96
新北市,永和區,下溪里,1907,1107,800,25,1932,3972,0,48.64,27.87
新北市,永和區,秀和里,2093,1246,847,24,2117,4293,0,49.31,29.02
新北市,永和區,河濱里,1327,771,556,7,1334,2797,0,47.69,27.57
新北市,永和區,民生里,1611,935,676,9,1620,3428,0,47.26,27.28
新北市,永和區,秀得里,1074,664,410,11,1085,2304,0,47.09,28.82
新北市,永和區,上林里,1518,1002,516,16,1534,3036,0,50.53,33.0
新北市,永和區,網溪里,463,307,156,6,469,1031,0,45.49,29.78
新北市,永和區,正興里,931,550,381,11,942,1963,0,47.99,28.02
新北市,永和區,永興里,1291,806,485,9,1300,2764,0,47.03,29.16
新北市,永和區,桂林里,1491,982,509,17,1508,3259,0,46.27,30.13
新北市,永和區,店街里,1645,1030,615,10,1655,3607,0,45.88,28.56
新北市,永和區,信義里,1150,683,467,16,1166,2350,0,49.62,29.06
新北市,永和區,後溪里,901,490,411,7,908,1783,0,50.93,27.48
新北市,永和區,民富里,1150,692,458,17,1167,2527,0,46.18,27.38
新北市,永和區,秀元里,1274,765,509,5,1279,2627,0,48.69,29.12
新北市,永和區,永樂里,982,542,440,8,990,2095,0,47.26,25.87
新北市,永和區,保順里,4153,2546,1607,19,4172,9013,0,46.29,28.25
新北市,永和區,合計,89006,54230,34776,776,89782,186020,217795,48.26,29.15
新北市,新莊區,海山里,2121,920,1201,15,2136,4736,0,45.1,19.43
新北市,新莊區,頭前里,3582,1579,2003,31,3613,8383,0,43.1,18.84
新北市,新莊區,國泰里,558,251,307,5,563,1293,0,43.54,19.41
新北市,新莊區,全安里,1860,826,1034,13,1873,3916,0,47.83,21.09
新北市,新莊區,福基里,2018,950,1068,12,2030,4570,0,44.42,20.79
新北市,新莊區,豐年里,1354,583,771,15,1369,3237,0,42.29,18.01
新北市,新莊區,忠孝里,2049,930,1119,22,2071,4625,0,44.78,20.11
新北市,新莊區,恆安里,1739,795,944,12,1751,3906,0,44.83,20.35
新北市,新莊區,後港里,2786,1326,1460,18,2804,6314,0,44.41,21.0
新北市,新莊區,文衡里,906,385,521,5,911,1879,0,48.48,20.49
新北市,新莊區,中美里,2331,1044,1287,19,2350,5211,0,45.1,20.03
新北市,新莊區,八德里,1024,437,587,6,1030,2744,0,37.54,15.93
新北市,新莊區,興漢里,1411,737,674,9,1420,2917,0,48.68,25.27
新北市,新莊區,中和里,1818,813,1005,17,1835,4028,0,45.56,20.18
新北市,新莊區,西盛里,4310,1958,2352,29,4339,10595,0,40.95,18.48
新北市,新莊區,榮和里,1298,604,694,8,1306,5142,0,25.4,11.75
新北市,新莊區,中泰里,1564,599,965,19,1583,3896,0,40.63,15.37
新北市,新莊區,瓊林里,2027,793,1234,20,2047,5058,0,40.47,15.68
新北市,新莊區,文德里,731,377,354,8,739,1553,0,47.59,24.28
新北市,新莊區,中誠里,759,304,455,7,766,1903,0,40.25,15.97
新北市,新莊區,裕民里,2393,997,1396,30,2423,6057,0,40.0,16.46
新北市,新莊區,文明里,668,285,383,5,673,1547,0,43.5,18.42
新北市,新莊區,中港里,2323,995,1328,26,2349,5390,0,43.58,18.46
新北市,新莊區,富國里,853,366,487,12,865,2056,0,42.07,17.8
新北市,新莊區,思源里,1982,826,1156,23,2005,4652,0,43.1,17.76
新北市,新莊區,立人里,840,526,314,9,849,1674,0,50.72,31.42
新北市,新莊區,南港里,1764,760,1004,26,1790,4664,0,38.38,16.3
新北市,新莊區,仁愛里,937,385,552,9,946,2389,0,39.6,16.12
新北市,新莊區,立德里,1047,498,549,4,1051,2305,0,45.6,21.61
新北市,新莊區,信義里,1875,826,1049,22,1897,4652,0,40.78,17.76
新北市,新莊區,立言里,1879,880,999,15,1894,4324,0,43.8,20.35
新北市,新莊區,民安里,1966,892,1074,21,1987,5143,0,38.64,17.34
新北市,新莊區,和平里,1719,655,1064,20,1739,4178,0,41.62,15.68
新北市,新莊區,立功里,1248,507,741,10,1258,3266,0,38.52,15.52
新北市,新莊區,民本里,1006,392,614,8,1014,2666,0,38.03,14.7
新北市,新莊區,化成里,1486,583,903,10,1496,3422,0,43.72,17.04
新北市,新莊區,立志里,1486,602,884,11,1497,3451,0,43.38,17.44
新北市,新莊區,光華里,2231,956,1275,22,2253,6136,0,36.72,15.58
新北市,新莊區,思賢里,1623,698,925,16,1639,3692,0,44.39,18.91
新北市,新莊區,營盤里,772,337,435,3,775,1701,0,45.56,19.81
新北市,新莊區,光榮里,1345,640,705,10,1355,3835,0,35.33,16.69
新北市,新莊區,自強里,841,334,507,9,850,2341,0,36.31,14.27
新北市,新莊區,丹鳳里,2909,1385,1524,29,2938,7720,0,38.06,17.94
新北市,新莊區,光明里,1426,626,800,13,1439,4165,0,34.55,15.03
新北市,新莊區,自立里,1892,799,1093,34,1926,4667,0,41.27,17.12
新北市,新莊區,合鳳里,1495,641,854,18,1513,4014,0,37.69,15.97
新北市,新莊區,幸福里,1496,536,960,9,1505,3807,0,39.53,14.08
新北市,新莊區,雙鳳里,3798,1875,1923,32,3830,9790,0,39.12,19.15
新北市,新莊區,自信里,858,340,518,5,863,2188,0,39.44,15.54
新北市,新莊區,龍鳳里,3410,1627,1783,28,3438,8555,0,40.19,19.02
新北市,新莊區,中華里,1128,516,612,7,1135,2558,0,44.37,20.17
新北市,新莊區,中隆里,1707,762,945,18,1725,4343,0,39.72,17.55
新北市,新莊區,中原里,4529,2053,2476,40,4569,11108,0,41.13,18.48
新北市,新莊區,中信里,3015,1306,1709,23,3038,7280,0,41.73,17.94
新北市,新莊區,四維里,1462,598,864,20,1482,4090,0,36.23,14.62
新北市,新莊區,建福里,950,418,532,8,958,2178,0,43.99,19.19
新北市,新莊區,中宏里,1345,588,757,13,1358,3219,0,42.19,18.27
新北市,新莊區,中全里,1193,404,789,12,1205,3118,0,38.65,12.96
新北市,新莊區,立泰里,1850,858,992,25,1875,4308,0,43.52,19.92
新北市,新莊區,全泰里,2092,1047,1045,19,2111,4287,0,49.24,24.42
新北市,新莊區,仁義里,1273,480,793,8,1281,3271,0,39.16,14.67
新北市,新莊區,立基里,2461,1134,1327,27,2488,5316,0,46.8,21.33
新北市,新莊區,昌明里,1372,618,754,11,1383,3181,0,43.48,19.43
新北市,新莊區,昌平里,2970,1472,1498,13,2983,7008,0,42.57,21.0
新北市,新莊區,文聖里,1435,721,714,12,1447,2960,0,48.89,24.36
新北市,新莊區,萬安里,1271,556,715,13,1284,3234,0,39.7,17.19
新北市,新莊區,龍安里,769,335,434,13,782,2075,0,37.69,16.14
新北市,新莊區,福營里,996,426,570,8,1004,2274,0,44.15,18.73
新北市,新莊區,後德里,1275,671,604,13,1288,2720,0,47.35,24.67
新北市,新莊區,建安里,2308,1016,1292,20,2328,5875,0,39.63,17.29
新北市,新莊區,成德里,1608,702,906,13,1621,4416,0,36.71,15.9
新北市,新莊區,福興里,2275,990,1285,23,2298,5247,0,43.8,18.87
新北市,新莊區,昌信里,1350,587,763,8,1358,3272,0,41.5,17.94
新北市,新莊區,昌隆里,1658,798,860,17,1675,3858,0,43.42,20.68
新北市,新莊區,中平里,3249,1627,1622,32,3281,7749,0,42.34,21.0
新北市,新莊區,立廷里,4171,2092,2079,27,4198,9967,0,42.12,20.99
新北市,新莊區,泰豐里,958,439,519,14,972,2206,0,44.06,19.9
新北市,新莊區,富民里,1452,675,777,8,1460,3404,0,42.89,19.83
新北市,新莊區,龍福里,797,386,411,7,804,1990,0,40.4,19.4
新北市,新莊區,祥鳳里,857,412,445,5,862,2133,0,40.41,19.32
新北市,新莊區,民全里,1326,589,737,14,1340,3307,0,40.52,17.81
新北市,新莊區,民有里,1529,734,795,20,1549,3548,0,43.66,20.69
新北市,新莊區,光正里,1456,662,794,18,1474,3815,0,38.64,17.35
新北市,新莊區,光和里,902,344,558,5,907,2430,0,37.33,14.16
新北市,新莊區,合計,144803,64996,79807,1313,146116,352098,422668,41.5,18.46
新北市,新店區,國豐里,1411,952,459,17,1428,2846,0,50.18,33.45
新北市,新店區,明德里,1681,1072,609,18,1699,3541,0,47.98,30.27
新北市,新店區,大豐里,1601,977,624,6,1607,3306,0,48.61,29.55
新北市,新店區,大同里,1837,1138,699,14,1851,3497,0,52.93,32.54
新北市,新店區,江陵里,2483,1601,882,24,2507,4908,0,51.08,32.62
新北市,新店區,寶興里,2529,1576,953,25,2554,4879,0,52.35,32.3
新北市,新店區,寶安里,2457,1621,836,26,2483,4940,0,50.26,32.81
新北市,新店區,信義里,2991,1740,1251,26,3017,6086,0,49.57,28.59
新北市,新店區,忠孝里,1074,746,328,10,1084,2525,0,42.93,29.54
新北市,新店區,大鵬里,1414,1146,268,11,1425,2477,0,57.53,46.27
新北市,新店區,太平里,1279,822,457,9,1288,2805,0,45.92,29.3
新北市,新店區,頂城里,577,334,243,6,583,1541,0,37.83,21.67
新北市,新店區,下城里,1283,632,651,5,1288,2878,0,44.75,21.96
新北市,新店區,柴埕里,3369,2040,1329,27,3396,8098,0,41.94,25.19
新北市,新店區,永安里,1991,1141,850,13,2004,4606,0,43.51,24.77
新北市,新店區,公崙里,4955,3052,1903,41,4996,11616,0,43.01,26.27
新北市,新店區,德安里,2216,1224,992,22,2238,5492,0,40.75,22.29
新北市,新店區,雙城里,2114,1180,934,20,2134,5146,0,41.47,22.93
新北市,新店區,日興里,1983,1037,946,17,2000,5288,0,37.82,19.61
新北市,新店區,玫瑰里,2371,1525,846,12,2383,5383,0,44.27,28.33
新北市,新店區,塗潭里,375,99,276,7,382,928,0,41.16,10.67
新北市,新店區,美潭里,2082,1282,800,17,2099,4705,0,44.61,27.25
新北市,新店區,員潭里,1965,1166,799,21,1986,4714,0,42.13,24.73
新北市,新店區,雙坑里,252,107,145,3,255,726,0,35.12,14.74
新北市,新店區,粗坑里,1388,704,684,9,1397,2813,0,49.66,25.03
新北市,新店區,屈尺里,942,449,493,9,951,2253,0,42.21,19.93
新北市,新店區,龜山里,634,297,337,6,640,1598,0,40.05,18.59
新北市,新店區,廣興里,496,189,307,8,504,1264,0,39.87,14.95
新北市,新店區,直潭里,512,196,316,4,516,1196,0,43.14,16.39
新北市,新店區,青潭里,2064,1192,872,15,2079,4825,0,43.09,24.7
新北市,新店區,新店里,758,380,378,3,761,1629,0,46.72,23.33
新北市,新店區,張南里,1079,670,409,5,1084,2137,0,50.73,31.35
新北市,新店區,國校里,1027,587,440,9,1036,2320,0,44.66,25.3
新北市,新店區,文中里,731,475,256,10,741,1575,0,47.05,30.16
新北市,新店區,廣明里,412,193,219,5,417,782,0,53.32,24.68
新北市,新店區,文明里,1130,605,525,7,1137,2230,0,50.99,27.13
新北市,新店區,中興里,2403,1570,833,21,2424,6858,0,35.35,22.89
新北市,新店區,新生里,2618,1678,940,30,2648,5204,0,50.88,32.24
新北市,新店區,新德里,1085,641,444,7,1092,2418,0,45.16,26.51
新北市,新店區,張北里,3675,2416,1259,38,3713,8055,0,46.1,29.99
新北市,新店區,五峯里,3333,2097,1236,27,3360,6910,0,48.63,30.35
新北市,新店區,新安里,1744,1165,579,19,1763,3647,0,48.34,31.94
新北市,新店區,忠誠里,1155,742,413,4,1159,2185,0,53.04,33.96
新北市,新店區,中正里,2614,1689,925,32,2646,5458,0,48.48,30.95
新北市,新店區,中華里,1874,1279,595,18,1892,3832,0,49.37,33.38
新北市,新店區,仁愛里,934,633,301,3,937,1791,0,52.32,35.34
新北市,新店區,百忍里,1644,1094,550,19,1663,3376,0,49.26,32.41
新北市,新店區,百和里,1411,892,519,9,1420,2847,0,49.88,31.33
新北市,新店區,福德里,1573,1002,571,15,1588,3469,0,45.78,28.88
新北市,新店區,百福里,1684,1075,609,8,1692,3294,0,51.37,32.64
新北市,新店區,福民里,1837,1299,538,12,1849,3726,0,49.62,34.86
新北市,新店區,中山里,2327,1603,724,18,2345,4191,0,55.95,38.25
新北市,新店區,和平里,548,362,186,16,564,1240,0,45.48,29.19
新北市,新店區,中央里,2867,1921,946,22,2889,5278,0,54.74,36.4
新北市,新店區,明城里,1470,999,471,4,1474,3130,0,47.09,31.92
新北市,新店區,安和里,3092,1834,1258,32,3124,7029,0,44.44,26.09
新北市,新店區,吉祥里,2026,1403,623,26,2052,4302,0,47.7,32.61
新北市,新店區,寶福里,3227,2031,1196,21,3248,6458,0,50.29,31.45
新北市,新店區,小城里,1661,1085,576,12,1673,3305,0,50.62,32.83
新北市,新店區,香坡里,4461,3006,1455,44,4505,10096,0,44.62,29.77
新北市,新店區,建國里,1386,967,419,13,1399,2786,0,50.22,34.71
新北市,新店區,復興里,1194,726,468,8,1202,2930,0,41.02,24.78
新北市,新店區,美城里,1134,692,442,14,1148,2466,0,46.55,28.06
新北市,新店區,安昌里,2259,1403,856,21,2280,4853,0,46.98,28.91
新北市,新店區,長春里,1227,779,448,8,1235,2304,0,53.6,33.81
新北市,新店區,新和里,1655,1077,578,17,1672,3718,0,44.97,28.97
新北市,新店區,永平里,2191,1302,889,19,2210,4949,0,44.66,26.31
新北市,新店區,達觀里,1665,1172,493,14,1679,3614,0,46.46,32.43
新北市,新店區,華城里,1303,795,508,16,1319,2551,0,51.71,31.16
新北市,新店區,合計,122740,76576,46164,1074,123814,265823,301768,46.58,28.81
新北市,樹林區,三多里,1392,585,807,9,1401,3594,0,38.98,16.28
新北市,樹林區,三福里,1334,625,709,19,1353,3437,0,39.37,18.18
新北市,樹林區,三興里,1568,675,893,12,1580,4203,0,37.59,16.06
新北市,樹林區,圳安里,1327,526,801,15,1342,3354,0,40.01,15.68
新北市,樹林區,保安里,2352,1084,1268,22,2374,5473,0,43.38,19.81
新北市,樹林區,潭底里,1549,665,884,14,1563,4463,0,35.02,14.9
新北市,樹林區,獇寮里,1551,610,941,10,1561,4406,0,35.43,13.84
新北市,樹林區,樹德里,1490,726,764,11,1501,3190,0,47.05,22.76
新北市,樹林區,樹西里,2098,1015,1083,16,2114,4496,0,47.02,22.58
新北市,樹林區,樹南里,1627,747,880,9,1636,3699,0,44.23,20.19
新北市,樹林區,樹人里,1217,645,572,11,1228,2937,0,41.81,21.96
新北市,樹林區,坡內里,586,237,349,5,591,1506,0,39.24,15.74
新北市,樹林區,樹東里,443,221,222,3,446,1073,0,41.57,20.6
新北市,樹林區,大同里,1317,665,652,6,1323,3130,0,42.27,21.25
新北市,樹林區,和平里,1342,552,790,12,1354,3345,0,40.48,16.5
新北市,樹林區,彭厝里,1550,651,899,17,1567,4373,0,35.83,14.89
新北市,樹林區,彭福里,1821,824,997,12,1833,4657,0,39.36,17.69
新北市,樹林區,東山里,1098,456,642,14,1112,2876,0,38.66,15.86
新北市,樹林區,東陽里,1989,941,1048,11,2000,5229,0,38.25,18.0
新北市,樹林區,東昇里,1774,787,987,17,1791,4435,0,40.38,17.75
新北市,樹林區,樂山里,630,281,349,4,634,1769,0,35.84,15.88
新北市,樹林區,東園里,605,185,420,1,606,1494,0,40.56,12.38
新北市,樹林區,西園里,638,222,416,9,647,1602,0,40.39,13.86
新北市,樹林區,南園里,5266,2887,2379,28,5294,12321,0,42.97,23.43
新北市,樹林區,北園里,788,266,522,8,796,1967,0,40.47,13.52
新北市,樹林區,柑園里,3496,1915,1581,24,3520,8030,0,43.84,23.85
新北市,樹林區,樹北里,428,207,221,2,430,853,0,50.41,24.27
新北市,樹林區,圳福里,1534,719,815,9,1543,3833,0,40.26,18.76
新北市,樹林區,樹興里,1326,639,687,14,1340,3184,0,42.09,20.07
新北市,樹林區,樹福里,1500,698,802,22,1522,3145,0,48.39,22.19
新北市,樹林區,光興里,1360,574,786,6,1366,3600,0,37.94,15.94
新北市,樹林區,金寮里,1468,606,862,18,1486,3906,0,38.04,15.51
新北市,樹林區,彭興里,1817,766,1051,17,1834,5086,0,36.06,15.06
新北市,樹林區,文林里,1841,853,988,21,1862,4401,0,42.31,19.38
新北市,樹林區,山佳里,1876,820,1056,15,1891,5096,0,37.11,16.09
新北市,樹林區,中山里,1830,791,1039,27,1857,4640,0,40.02,17.05
新北市,樹林區,育英里,1245,582,663,12,1257,2790,0,45.05,20.86
新北市,樹林區,中華里,1108,548,560,9,1117,3019,0,37.0,18.15
新北市,樹林區,太順里,859,362,497,6,865,2412,0,35.86,15.01
新北市,樹林區,圳民里,1030,480,550,14,1044,2578,0,40.5,18.62
新北市,樹林區,圳生里,613,189,424,1,614,1430,0,42.94,13.22
新北市,樹林區,三龍里,820,335,485,5,825,1875,0,44.0,17.87
新北市,樹林區,合計,61503,28162,33341,517,62020,152907,182668,40.56,18.42
新北市,鶯歌區,東鶯里,442,189,253,4,446,946,0,47.15,19.98
新北市,鶯歌區,西鶯里,867,410,457,1,868,1968,0,44.11,20.83
新北市,鶯歌區,南鶯里,2135,963,1172,15,2150,4997,0,43.03,19.27
新北市,鶯歌區,北鶯里,1473,753,720,21,1494,3748,0,39.86,20.09
新北市,鶯歌區,中鶯里,464,193,271,3,467,940,0,49.68,20.53
新北市,鶯歌區,建德里,241,109,132,0,241,518,0,46.53,21.04
新北市,鶯歌區,同慶里,636,271,365,2,638,1386,0,46.03,19.55
新北市,鶯歌區,永昌里,2840,1316,1524,25,2865,7317,0,39.16,17.99
新北市,鶯歌區,南靖里,1320,550,770,9,1329,3154,0,42.14,17.44
新北市,鶯歌區,尖山里,2932,1351,1581,37,2969,7755,0,38.28,17.42
新北市,鶯歌區,二橋里,2662,1203,1459,17,2679,7334,0,36.53,16.4
新北市,鶯歌區,二甲里,375,166,209,6,381,836,0,45.57,19.86
新北市,鶯歌區,東湖里,149,67,82,1,150,250,0,60.0,26.8
新北市,鶯歌區,大湖里,1875,923,952,15,1890,4527,0,41.75,20.39
新北市,鶯歌區,鳳鳴里,1750,826,924,22,1772,4996,0,35.47,16.53
新北市,鶯歌區,鳳福里,1476,704,772,11,1487,3896,0,38.17,18.07
新北市,鶯歌區,永吉里,1706,817,889,22,1728,4275,0,40.42,19.11
新北市,鶯歌區,中湖里,1829,882,947,11,1840,5088,0,36.16,17.33
新北市,鶯歌區,鳳祥里,1450,647,803,10,1460,3878,0,37.65,16.68
新北市,鶯歌區,建國里,2309,1022,1287,18,2327,6172,0,37.7,16.56
新北市,鶯歌區,合計,28931,13362,15569,250,29181,73981,88131,39.44,18.06
新北市,三峽區,三峽里,161,72,89,3,164,285,0,57.54,25.26
新北市,三峽區,秀川里,229,100,129,1,230,575,0,40.0,17.39
新北市,三峽區,八張里,1350,684,666,15,1365,3542,0,38.54,19.31
新北市,三峽區,中埔里,1066,591,475,8,1074,3013,0,35.65,19.62
新北市,三峽區,弘道里,367,122,245,1,368,1027,0,35.83,11.88
新北市,三峽區,永舘里,2549,1147,1402,26,2575,6463,0,39.84,17.75
新北市,三峽區,礁溪里,1912,938,974,22,1934,5237,0,36.93,17.91
新北市,三峽區,鳶山里,3070,1463,1607,31,3101,8816,0,35.17,16.59
新北市,三峽區,龍埔里,3092,1582,1510,36,3128,8410,0,37.19,18.81
新北市,三峽區,大埔里,1347,716,631,10,1357,3676,0,36.92,19.48
新北市,三峽區,嘉添里,839,450,389,13,852,2111,0,40.36,21.32
新北市,三峽區,添福里,384,144,240,2,386,1045,0,36.94,13.78
新北市,三峽區,金圳里,174,65,109,6,180,486,0,37.04,13.37
新北市,三峽區,五寮里,232,106,126,4,236,794,0,29.72,13.35
新北市,三峽區,插角里,280,93,187,2,282,632,0,44.62,14.72
新北市,三峽區,有木里,217,72,145,1,218,683,0,31.92,10.54
新北市,三峽區,溪北里,870,358,512,9,879,2123,0,41.4,16.86
新北市,三峽區,溪南里,591,237,354,3,594,1375,0,43.2,17.24
新北市,三峽區,溪東里,987,461,526,9,996,2733,0,36.44,16.87
新北市,三峽區,成福里,395,158,237,5,400,860,0,46.51,18.37
新北市,三峽區,安坑里,449,156,293,8,457,1294,0,35.32,12.06
新北市,三峽區,竹崙里,642,242,400,2,644,1870,0,34.44,12.94
新北市,三峽區,介壽里,2010,911,1099,7,2017,6055,0,33.31,15.05
新北市,三峽區,安溪里,2330,1186,1144,15,2345,6654,0,35.24,17.82
新北市,三峽區,中正里,1582,726,856,17,1599,4616,0,34.64,15.73
新北市,三峽區,二鬮里,1204,667,537,10,1214,3228,0,37.61,20.66
新北市,三峽區,龍學里,5483,3186,2297,33,5516,12581,0,43.84,25.32
新北市,三峽區,龍恩里,2398,1352,1046,21,2419,5980,0,40.45,22.61
新北市,三峽區,合計,36210,17985,18225,320,36530,96164,116549,37.99,18.7
新北市,淡水區,中和里,194,67,127,3,197,557,0,35.37,12.03
新北市,淡水區,屯山里,321,119,202,6,327,994,0,32.9,11.97
新北市,淡水區,賢孝里,476,228,248,8,484,1447,0,33.45,15.76
新北市,淡水區,興仁里,569,253,316,5,574,1510,0,38.01,16.75
新北市,淡水區,蕃薯里,342,173,169,0,342,973,0,35.15,17.78
新北市,淡水區,義山里,802,398,404,11,813,2422,0,33.57,16.43
新北市,淡水區,忠山里,320,151,169,10,330,803,0,41.1,18.8
新北市,淡水區,崁頂里,6101,3532,2569,47,6148,17538,0,35.06,20.14
新北市,淡水區,埤島里,578,280,298,5,583,1616,0,36.08,17.33
新北市,淡水區,新興里,2526,1380,1146,21,2547,6573,0,38.75,20.99
新北市,淡水區,水碓里,1979,955,1024,26,2005,5098,0,39.33,18.73
新北市,淡水區,北投里,3657,2039,1618,29,3686,9067,0,40.65,22.49
新北市,淡水區,水源里,742,278,464,9,751,1974,0,38.04,14.08
新北市,淡水區,忠寮里,403,166,237,3,406,1054,0,38.52,15.75
新北市,淡水區,樹興里,545,263,282,9,554,1361,0,40.71,19.32
新北市,淡水區,坪頂里,545,265,280,3,548,1263,0,43.39,20.98
新北市,淡水區,福德里,3078,1733,1345,29,3107,6369,0,48.78,27.21
新北市,淡水區,竹圍里,2560,1405,1155,30,2590,5639,0,45.93,24.92
新北市,淡水區,民生里,2762,1407,1355,15,2777,6465,0,42.95,21.76
新北市,淡水區,八勢里,2573,1388,1185,23,2596,6014,0,43.17,23.08
新北市,淡水區,竿蓁里,4066,2291,1775,36,4102,10029,0,40.9,22.84
新北市,淡水區,鄧公里,2296,1248,1048,17,2313,5542,0,41.74,22.52
新北市,淡水區,中興里,1391,679,712,23,1414,3650,0,38.74,18.6
新北市,淡水區,長庚里,612,287,325,5,617,1326,0,46.53,21.64
新北市,淡水區,清文里,422,184,238,3,425,1068,0,39.79,17.23
新北市,淡水區,草東里,307,122,185,3,310,682,0,45.45,17.89
新北市,淡水區,協元里,518,231,287,4,522,1339,0,38.98,17.25
新北市,淡水區,永吉里,394,187,207,6,400,804,0,49.75,23.26
新北市,淡水區,民安里,315,140,175,8,323,624,0,51.76,22.44
新北市,淡水區,新生里,185,88,97,1,186,396,0,46.97,22.22
新北市,淡水區,文化里,663,372,291,9,672,1587,0,42.34,23.44
新北市,淡水區,油車里,2037,1127,910,22,2059,4932,0,41.75,22.85
新北市,淡水區,沙崙里,1590,864,726,9,1599,4158,0,38.46,20.78
新北市,淡水區,新義里,1347,589,758,16,1363,3658,0,37.26,16.1
新北市,淡水區,新春里,2941,1495,1446,19,2960,7974,0,37.12,18.75
新北市,淡水區,新民里,1763,915,848,9,1772,4269,0,41.51,21.43
新北市,淡水區,正德里,1636,933,703,20,1656,4169,0,39.72,22.38
新北市,淡水區,北新里,963,520,443,3,966,2486,0,38.86,20.92
新北市,淡水區,民權里,1924,960,964,17,1941,4221,0,45.98,22.74
新北市,淡水區,幸福里,1413,698,715,15,1428,3477,0,41.07,20.07
新北市,淡水區,學府里,1573,868,705,12,1585,4251,0,37.29,20.42
新北市,淡水區,大庄里,3818,2199,1619,31,3849,9198,0,41.85,23.91
新北市,淡水區,合計,63247,33477,29770,580,63827,158577,184450,40.25,21.11
新北市,汐止區,義民里,528,286,242,4,532,1238,0,42.97,23.1
新北市,汐止區,禮門里,450,210,240,2,452,980,0,46.12,21.43
新北市,汐止區,智慧里,1865,1084,781,15,1880,4239,0,44.35,25.57
新北市,汐止區,信望里,146,73,73,1,147,320,0,45.94,22.81
新北市,汐止區,橋東里,1243,649,594,10,1253,2889,0,43.37,22.46
新北市,汐止區,秀峰里,1414,687,727,11,1425,4888,0,29.15,14.05
新北市,汐止區,新昌里,1956,1002,954,17,1973,4758,0,41.47,21.06
新北市,汐止區,復興里,3165,1767,1398,26,3191,6286,0,50.76,28.11
新北市,汐止區,茄苳里,1379,685,694,12,1391,3956,0,35.16,17.32
新北市,汐止區,長安里,632,296,336,7,639,1489,0,42.91,19.88
新北市,汐止區,保安里,546,271,275,5,551,1494,0,36.88,18.14
新北市,汐止區,保長里,1660,842,818,28,1688,4194,0,40.25,20.08
新北市,汐止區,鄉長里,936,457,479,6,942,2101,0,44.84,21.75
新北市,汐止區,江北里,2110,1081,1029,19,2129,5478,0,38.86,19.73
新北市,汐止區,拱北里,1593,816,777,15,1608,4648,0,34.6,17.56
新北市,汐止區,烘內里,618,320,298,15,633,1479,0,42.8,21.64
新北市,汐止區,八連里,341,146,195,1,342,921,0,37.13,15.85
新北市,汐止區,樟樹里,764,354,410,11,775,1990,0,38.94,17.79
新北市,汐止區,北峰里,1717,777,940,18,1735,4527,0,38.33,17.16
新北市,汐止區,北山里,2405,1258,1147,24,2429,5282,0,45.99,23.82
新北市,汐止區,白雲里,1596,834,762,19,1615,3974,0,40.64,20.99
新北市,汐止區,橫科里,1822,985,837,28,1850,4272,0,43.31,23.06
新北市,汐止區,東山里,210,110,100,8,218,542,0,40.22,20.3
新北市,汐止區,福山里,1539,881,658,20,1559,3388,0,46.02,26.0
新北市,汐止區,宜興里,1324,803,521,14,1338,2728,0,49.05,29.44
新北市,汐止區,中興里,2721,1381,1340,31,2752,7130,0,38.6,19.37
新北市,汐止區,湖光里,2477,1439,1038,23,2500,5589,0,44.73,25.75
新北市,汐止區,仁德里,739,409,330,8,747,1675,0,44.6,24.42
新北市,汐止區,厚德里,2442,1387,1055,18,2460,6767,0,36.35,20.5
新北市,汐止區,忠孝里,2937,1642,1295,20,2957,7500,0,39.43,21.89
新北市,汐止區,自強里,2140,1165,975,26,2166,5118,0,42.32,22.76
新北市,汐止區,文化里,1728,916,812,11,1739,4130,0,42.11,22.18
新北市,汐止區,金龍里,1931,1022,909,20,1951,4841,0,40.3,21.11
新北市,汐止區,福德里,1129,581,548,14,1143,2985,0,38.29,19.46
新北市,汐止區,興福里,1270,692,578,5,1275,2904,0,43.9,23.83
新北市,汐止區,康福里,1865,972,893,20,1885,4716,0,39.97,20.61
新北市,汐止區,忠山里,1640,1007,633,11,1651,3115,0,53.0,32.33
新北市,汐止區,環河里,514,202,312,3,517,1145,0,45.15,17.64
新北市,汐止區,東勢里,2073,1176,897,18,2091,4238,0,49.34,27.75
新北市,汐止區,山光里,891,531,360,9,900,2598,0,34.64,20.44
新北市,汐止區,大同里,1091,595,496,2,1093,2552,0,42.83,23.32
新北市,汐止區,崇德里,1921,1002,919,19,1940,4444,0,43.65,22.55
新北市,汐止區,湖興里,2743,1671,1072,21,2764,6020,0,45.91,27.76
新北市,汐止區,長青里,453,257,196,8,461,872,0,52.87,29.47
新北市,汐止區,福安里,2265,1194,1071,19,2284,5639,0,40.5,21.17
新北市,汐止區,秀山里,1673,923,750,16,1689,3952,0,42.74,23.36
新北市,汐止區,建成里,2130,1242,888,14,2144,4633,0,46.28,26.81
新北市,汐止區,城中里,1845,1082,763,17,1862,4091,0,45.51,26.45
新北市,汐止區,湖蓮里,1355,872,483,12,1367,2514,0,54.38,34.69
新北市,汐止區,保新里,1031,616,415,11,1042,2680,0,38.88,22.99
新北市,汐止區,合計,74963,40650,34313,712,75675,179909,205551,42.06,22.59
新北市,瑞芳區,龍潭里,304,164,140,2,306,728,0,42.03,22.53
新北市,瑞芳區,龍興里,782,415,367,11,793,1862,0,42.59,22.29
新北市,瑞芳區,龍鎮里,465,248,217,3,468,1203,0,38.9,20.62
新北市,瑞芳區,龍川里,588,315,273,6,594,1573,0,37.76,20.03
新北市,瑞芳區,龍山里,477,277,200,8,485,1281,0,37.86,21.62
新北市,瑞芳區,龍安里,218,133,85,4,222,598,0,37.12,22.24
新北市,瑞芳區,爪峯里,1291,639,652,17,1308,3539,0,36.96,18.06
新北市,瑞芳區,柑坪里,368,162,206,3,371,1041,0,35.64,15.56
新北市,瑞芳區,東和里,563,276,287,6,569,1589,0,35.81,17.37
新北市,瑞芳區,上天里,466,237,229,6,472,1272,0,37.11,18.63
新北市,瑞芳區,吉慶里,561,318,243,5,566,1680,0,33.69,18.93
新北市,瑞芳區,吉安里,980,519,461,11,991,2918,0,33.96,17.79
新北市,瑞芳區,傑魚里,662,290,372,8,670,1891,0,35.43,15.34
新北市,瑞芳區,猴硐里,142,65,77,0,142,434,0,32.72,14.98
新北市,瑞芳區,光復里,91,39,52,3,94,241,0,39.0,16.18
新北市,瑞芳區,弓橋里,116,39,77,3,119,264,0,45.08,14.77
新北市,瑞芳區,碩仁里,72,37,35,1,73,138,0,52.9,26.81
新北市,瑞芳區,基山里,180,82,98,3,183,417,0,43.88,19.66
新北市,瑞芳區,永慶里,128,57,71,0,128,408,0,31.37,13.97
新北市,瑞芳區,崇文里,115,53,62,1,116,296,0,39.19,17.91
新北市,瑞芳區,福住里,69,42,27,2,71,164,0,43.29,25.61
新北市,瑞芳區,頌德里,120,59,61,0,120,326,0,36.81,18.1
新北市,瑞芳區,新山里,105,57,48,4,109,339,0,32.15,16.81
新北市,瑞芳區,瓜山里,74,48,26,0,74,164,0,45.12,29.27
新北市,瑞芳區,銅山里,79,37,42,3,82,186,0,44.09,19.89
新北市,瑞芳區,石山里,109,65,44,1,110,321,0,34.27,20.25
新北市,瑞芳區,濓新里,79,34,45,1,80,286,0,27.97,11.89
新北市,瑞芳區,濓洞里,167,102,65,3,170,459,0,37.04,22.22
新北市,瑞芳區,海濱里,332,203,129,6,338,1241,0,27.24,16.36
新北市,瑞芳區,瑞濱里,590,314,276,6,596,1905,0,31.29,16.48
新北市,瑞芳區,深澳里,363,219,144,4,367,1290,0,28.45,16.98
新北市,瑞芳區,南雅里,120,53,67,0,120,264,0,45.45,20.08
新北市,瑞芳區,鼻頭里,264,113,151,6,270,853,0,31.65,13.25
新北市,瑞芳區,新峰里,905,491,414,12,917,3060,0,29.97,16.05
新北市,瑞芳區,合計,11945,6202,5743,149,12094,34231,38764,35.33,18.12
新北市,土城區,埤塘里,1288,591,697,9,1297,5065,0,25.61,11.67
新北市,土城區,土城里,740,369,371,13,753,1838,0,40.97,20.08
新北市,土城區,員林里,2585,1331,1254,18,2603,6368,0,40.88,20.9
新北市,土城區,員仁里,1843,903,940,19,1862,4879,0,38.16,18.51
新北市,土城區,長風里,993,728,265,5,998,1844,0,54.12,39.48
新北市,土城區,日新里,1715,771,944,21,1736,4107,0,42.27,18.77
新北市,土城區,日和里,2377,1047,1330,16,2393,5788,0,41.34,18.09
新北市,土城區,貨饒里,1615,705,910,7,1622,3999,0,40.56,17.63
新北市,土城區,柑林里,1322,652,670,15,1337,3209,0,41.66,20.32
新北市,土城區,埤林里,3174,1602,1572,19,3193,7337,0,43.52,21.83
新北市,土城區,瑞興里,1075,443,632,10,1085,2741,0,39.58,16.16
新北市,土城區,清水里,2811,1309,1502,17,2828,7167,0,39.46,18.26
新北市,土城區,清和里,1974,880,1094,27,2001,5572,0,35.91,15.79
新北市,土城區,永豐里,1487,771,716,17,1504,3780,0,39.79,20.4
新北市,土城區,清化里,579,214,365,4,583,1455,0,40.07,14.71
新北市,土城區,清溪里,2430,1230,1200,24,2454,6034,0,40.67,20.38
新北市,土城區,峯廷里,2371,1069,1302,24,2395,6492,0,36.89,16.47
新北市,土城區,平和里,2471,1102,1369,26,2497,6188,0,40.35,17.81
新北市,土城區,廷寮里,1741,770,971,12,1753,4348,0,40.32,17.71
新北市,土城區,大安里,1857,885,972,15,1872,4345,0,43.08,20.37
新北市,土城區,永寧里,2686,1322,1364,21,2707,7273,0,37.22,18.18
新北市,土城區,沛陂里,1732,804,928,23,1755,4244,0,41.35,18.94
新北市,土城區,頂埔里,1720,851,869,23,1743,4447,0,39.19,19.14
新北市,土城區,頂福里,1794,890,904,21,1815,4672,0,38.85,19.05
新北市,土城區,頂新里,1153,723,430,9,1162,2561,0,45.37,28.23
新北市,土城區,祖田里,571,217,354,3,574,1476,0,38.89,14.7
新北市,土城區,樂利里,1832,852,980,26,1858,4491,0,41.37,18.97
新北市,土城區,廣福里,2205,1129,1076,20,2225,4980,0,44.68,22.67
新北市,土城區,學府里,1268,595,673,18,1286,3076,0,41.81,19.34
新北市,土城區,延壽里,1526,735,791,8,1534,3907,0,39.26,18.81
新北市,土城區,安和里,1816,824,992,14,1830,4353,0,42.04,18.93
新北市,土城區,青雲里,1168,556,612,10,1178,2751,0,42.82,20.21
新北市,土城區,員福里,1936,947,989,18,1954,4879,0,40.05,19.41
新北市,土城區,延吉里,1436,624,812,13,1449,3854,0,37.6,16.19
新北市,土城區,復興里,1627,778,849,18,1645,3997,0,41.16,19.46
新北市,土城區,裕生里,1979,879,1100,14,1993,4880,0,40.84,18.01
新北市,土城區,員信里,1438,725,713,13,1451,3873,0,37.46,18.72
新北市,土城區,永富里,1816,863,953,14,1830,4972,0,36.81,17.36
新北市,土城區,學成里,1299,558,741,3,1302,2895,0,44.97,19.27
新北市,土城區,延和里,2356,1135,1221,23,2379,5897,0,40.34,19.25
新北市,土城區,中正里,1212,620,592,12,1224,2851,0,42.93,21.75
新北市,土城區,學士里,1875,952,923,17,1892,4214,0,44.9,22.59
新北市,土城區,明德里,2198,1137,1061,23,2221,5145,0,43.17,22.1
新北市,土城區,廣興里,1241,622,619,13,1254,3049,0,41.13,20.4
新北市,土城區,青山里,1078,488,590,5,1083,2621,0,41.32,18.62
新北市,土城區,金城里,1994,1116,878,16,2010,5390,0,37.29,20.71
新北市,土城區,延祿里,1302,578,724,7,1309,3708,0,35.3,15.59
新北市,土城區,合計,80706,38892,41814,723,81429,203012,238020,40.11,19.16
新北市,蘆洲區,正義里,4819,2192,2627,43,4862,11581,0,41.98,18.93
新北市,蘆洲區,中原里,2053,883,1170,12,2065,5216,0,39.59,16.93
新北市,蘆洲區,中路里,1451,618,833,15,1466,3615,0,40.55,17.1
新北市,蘆洲區,光華里,1923,826,1097,10,1933,4716,0,40.99,17.51
新北市,蘆洲區,保佑里,1276,552,724,15,1291,3348,0,38.56,16.49
新北市,蘆洲區,水湳里,3648,1513,2135,33,3681,9167,0,40.15,16.5
新北市,蘆洲區,樓厝里,2464,1125,1339,20,2484,5872,0,42.3,19.16
新北市,蘆洲區,鷺江里,1943,804,1139,13,1956,4812,0,40.65,16.71
新北市,蘆洲區,恆德里,2238,1025,1213,21,2259,5571,0,40.55,18.4
新北市,蘆洲區,溪墘里,1233,467,766,10,1243,2798,0,44.42,16.69
新北市,蘆洲區,樹德里,1297,552,745,14,1311,2888,0,45.39,19.11
新北市,蘆洲區,保和里,940,385,555,12,952,2322,0,41.0,16.58
新北市,蘆洲區,仁復里,734,288,446,5,739,1885,0,39.2,15.28
新北市,蘆洲區,得勝里,1182,489,693,9,1191,2972,0,40.07,16.45
新北市,蘆洲區,南港里,1922,773,1149,16,1938,5162,0,37.54,14.97
新北市,蘆洲區,永樂里,2138,918,1220,18,2156,5439,0,39.64,16.88
新北市,蘆洲區,永康里,2244,892,1352,28,2272,5948,0,38.2,15.0
新北市,蘆洲區,信義里,1396,546,850,15,1411,3564,0,39.59,15.32
新北市,蘆洲區,玉清里,2201,965,1236,14,2215,5243,0,42.25,18.41
新北市,蘆洲區,復興里,1360,508,852,7,1367,3166,0,43.18,16.05
新北市,蘆洲區,水河里,3209,1278,1931,39,3248,8441,0,38.48,15.14
新北市,蘆洲區,仁愛里,1885,747,1138,19,1904,4663,0,40.83,16.02
新北市,蘆洲區,忠義里,1022,419,603,11,1033,2855,0,36.18,14.68
新北市,蘆洲區,九芎里,1858,796,1062,12,1870,4834,0,38.68,16.47
新北市,蘆洲區,中華里,1253,493,760,12,1265,2975,0,42.52,16.57
新北市,蘆洲區,得仁里,1234,507,727,16,1250,2688,0,46.5,18.86
新北市,蘆洲區,仁德里,1963,791,1172,20,1983,4838,0,40.99,16.35
新北市,蘆洲區,仁義里,1592,670,922,13,1605,4916,0,32.65,13.63
新北市,蘆洲區,光明里,1710,685,1025,14,1724,4262,0,40.45,16.07
新北市,蘆洲區,保新里,1317,549,768,21,1338,3431,0,39.0,16.0
新北市,蘆洲區,長安里,1622,580,1042,13,1635,4622,0,35.37,12.55
新北市,蘆洲區,民和里,1011,444,567,9,1020,2400,0,42.5,18.5
新北市,蘆洲區,忠孝里,874,311,563,7,881,2171,0,40.58,14.33
新北市,蘆洲區,福安里,1213,487,726,11,1224,2886,0,42.41,16.87
新北市,蘆洲區,永安里,1842,694,1148,13,1855,4625,0,40.11,15.01
新北市,蘆洲區,延平里,1478,586,892,15,1493,3685,0,40.52,15.9
新北市,蘆洲區,成功里,2590,1024,1566,26,2616,6695,0,39.07,15.29
新北市,蘆洲區,永德里,1412,573,839,13,1425,4010,0,35.54,14.29
新北市,蘆洲區,合計,67547,27955,39592,614,68161,170282,202131,40.03,16.42
新北市,五股區,興珍里,1735,619,1116,16,1751,4197,0,41.72,14.75
新北市,五股區,更寮里,487,130,357,5,492,1073,0,45.85,12.12
新北市,五股區,集福里,1483,610,873,13,1496,3475,0,43.05,17.55
新北市,五股區,觀音里,496,140,356,3,499,1260,0,39.6,11.11
新北市,五股區,成州里,1974,774,1200,17,1991,5457,0,36.49,14.18
新北市,五股區,成功里,2414,963,1451,15,2429,6462,0,37.59,14.9
新北市,五股區,五龍里,522,136,386,5,527,1245,0,42.33,10.92
新北市,五股區,五股里,1389,607,782,14,1403,3885,0,36.11,15.62
新北市,五股區,五福里,1238,541,697,11,1249,3097,0,40.33,17.47
新北市,五股區,德音里,1942,945,997,26,1968,4718,0,41.71,20.03
新北市,五股區,陸一里,1047,841,206,12,1059,2315,0,45.75,36.33
新北市,五股區,貿商里,1241,874,367,19,1260,2648,0,47.58,33.01
新北市,五股區,德泰里,1548,769,779,20,1568,3948,0,39.72,19.48
新北市,五股區,成德里,1113,472,641,7,1120,3009,0,37.22,15.69
新北市,五股區,六福里,1358,674,684,16,1374,3460,0,39.71,19.48
新北市,五股區,集賢里,1492,579,913,10,1502,3661,0,41.03,15.82
新北市,五股區,民義里,1302,608,694,9,1311,3192,0,41.07,19.05
新北市,五股區,成泰里,3541,1575,1966,20,3561,9533,0,37.35,16.52
新北市,五股區,水碓里,2738,1149,1589,24,2762,7004,0,39.43,16.4
新北市,五股區,福德里,1020,450,570,11,1031,3018,0,34.16,14.91
新北市,五股區,合計,30080,13456,16624,273,30353,76657,90027,39.6,17.55
新北市,泰山區,大科里,325,134,191,3,328,822,0,39.9,16.3
新北市,泰山區,黎明里,1225,598,627,7,1232,3030,0,40.66,19.74
新北市,泰山區,山腳里,2242,1058,1184,15,2257,5956,0,37.89,17.76
新北市,泰山區,福泰里,987,466,521,16,1003,2521,0,39.79,18.48
新北市,泰山區,楓樹里,1538,757,781,18,1556,3870,0,40.21,19.56
新北市,泰山區,同榮里,1508,774,734,14,1522,3617,0,42.08,21.4
新北市,泰山區,義學里,1668,778,890,15,1683,4172,0,40.34,18.65
新北市,泰山區,明志里,1440,680,760,18,1458,3385,0,43.07,20.09
新北市,泰山區,貴子里,1570,739,831,9,1579,3571,0,44.22,20.69
新北市,泰山區,貴和里,1815,863,952,17,1832,4404,0,41.6,19.6
新北市,泰山區,同興里,1376,585,791,12,1388,3234,0,42.92,18.09
新北市,泰山區,義仁里,2888,1352,1536,20,2908,7169,0,40.56,18.86
新北市,泰山區,泰友里,767,375,392,6,773,1857,0,41.63,20.19
新北市,泰山區,新明里,1147,536,611,10,1157,2868,0,40.34,18.69
新北市,泰山區,貴賢里,1532,766,766,12,1544,3300,0,46.79,23.21
新北市,泰山區,福興里,1257,647,610,12,1269,3114,0,40.75,20.78
新北市,泰山區,全興里,2928,1447,1481,25,2953,7587,0,38.92,19.07
新北市,泰山區,合計,26213,12555,13658,229,26442,64477,77862,41.01,19.47
新北市,林口區,東林里,1224,518,706,14,1238,3528,0,35.09,14.68
新北市,林口區,林口里,1728,829,899,19,1747,4811,0,36.31,17.23
新北市,林口區,西林里,3756,1934,1822,26,3782,9419,0,40.15,20.53
新北市,林口區,菁湖里,1650,716,934,18,1668,3771,0,44.23,18.99
新北市,林口區,中湖里,1552,720,832,12,1564,4170,0,37.51,17.27
新北市,林口區,湖北里,613,227,386,10,623,1384,0,45.01,16.4
新北市,林口區,湖南里,8367,4693,3674,58,8425,20700,0,40.7,22.67
新北市,林口區,南勢里,8653,4745,3908,74,8727,20299,0,42.99,23.38
新北市,林口區,東勢里,2725,1502,1223,26,2751,6489,0,42.39,23.15
新北市,林口區,頂福里,357,107,250,3,360,1010,0,35.64,10.59
新北市,林口區,下福里,450,203,247,7,457,1229,0,37.18,16.52
新北市,林口區,嘉寶里,395,135,260,6,401,911,0,44.02,14.82
新北市,林口區,瑞平里,262,94,168,1,263,763,0,34.47,12.32
新北市,林口區,太平里,462,153,309,4,466,1461,0,31.9,10.47
新北市,林口區,仁愛里,2514,1436,1078,22,2536,6006,0,42.22,23.91
新北市,林口區,麗林里,3144,1820,1324,33,3177,7589,0,41.86,23.98
新北市,林口區,麗園里,1554,797,757,18,1572,3627,0,43.34,21.97
新北市,林口區,合計,39406,20629,18777,351,39757,97167,123095,40.92,21.23
新北市,深坑區,深坑里,1328,647,681,9,1337,3097,0,43.17,20.89
新北市,深坑區,萬順里,955,465,490,9,964,2316,0,41.62,20.08
新北市,深坑區,土庫里,1141,587,554,12,1153,2749,0,41.94,21.35
新北市,深坑區,昇高里,901,513,388,9,910,1926,0,47.25,26.64
新北市,深坑區,阿柔里,234,109,125,4,238,558,0,42.65,19.53
新北市,深坑區,埔新里,2432,1338,1094,15,2447,5654,0,43.28,23.66
新北市,深坑區,萬福里,1045,530,515,6,1051,2486,0,42.28,21.32
新北市,深坑區,賴仲里,966,574,392,6,972,2115,0,45.96,27.14
新北市,深坑區,合計,9002,4763,4239,70,9072,20901,23730,43.4,22.79
新北市,石碇區,石碇里,142,58,84,1,143,365,0,39.18,15.89
新北市,石碇區,潭邊里,293,154,139,1,294,798,0,36.84,19.3
新北市,石碇區,隆盛里,235,98,137,5,240,668,0,35.93,14.67
新北市,石碇區,烏塗里,242,88,154,3,245,607,0,40.36,14.5
新北市,石碇區,彭山里,104,49,55,2,106,296,0,35.81,16.55
新北市,石碇區,豐田里,184,79,105,1,185,387,0,47.8,20.41
新北市,石碇區,永定里,204,80,124,1,205,589,0,34.8,13.58
新北市,石碇區,中民里,249,98,151,2,251,717,0,35.01,13.67
新北市,石碇區,光明里,106,32,74,1,107,261,0,41.0,12.26
新北市,石碇區,豐林里,124,57,67,0,124,302,0,41.06,18.87
新北市,石碇區,永安里,313,104,209,6,319,809,0,39.43,12.86
新北市,石碇區,格頭里,411,138,273,3,414,991,0,41.78,13.93
新北市,石碇區,合計,2607,1035,1572,26,2633,6790,7487,38.78,15.24
新北市,坪林區,粗窟里,322,138,184,5,327,853,0,38.34,16.18
新北市,坪林區,坪林里,499,210,289,3,502,1290,0,38.91,16.28
新北市,坪林區,大林里,441,131,310,3,444,1167,0,38.05,11.23
新北市,坪林區,石𥕢里,136,44,92,3,139,420,0,33.1,10.48
新北市,坪林區,上德里,278,128,150,6,284,836,0,33.97,15.31
新北市,坪林區,水德里,212,83,129,0,212,631,0,33.6,13.15
新北市,坪林區,漁光里,310,95,215,6,316,860,0,36.74,11.05
新北市,坪林區,合計,2198,829,1369,26,2224,6057,6670,36.72,13.69
新北市,三芝區,八賢里,106,29,77,1,107,311,0,34.41,9.32
新北市,三芝區,埔頭里,1555,814,741,12,1567,4787,0,32.73,17.0
新北市,三芝區,古庄里,381,196,185,3,384,1113,0,34.5,17.61
新北市,三芝區,新庄里,271,143,128,5,276,776,0,35.57,18.43
新北市,三芝區,埔坪里,1893,1023,870,27,1920,6124,0,31.35,16.7
新北市,三芝區,茂長里,276,139,137,3,279,604,0,46.19,23.01
新北市,三芝區,橫山里,160,92,68,2,162,477,0,33.96,19.29
新北市,三芝區,錫板里,281,127,154,4,285,661,0,43.12,19.21
新北市,三芝區,後厝里,776,461,315,4,780,2030,0,38.42,22.71
新北市,三芝區,福德里,302,155,147,2,304,762,0,39.9,20.34
新北市,三芝區,圓山里,155,92,63,3,158,532,0,29.7,17.29
新北市,三芝區,店子里,191,75,116,1,192,580,0,33.1,12.93
新北市,三芝區,興華里,434,172,262,7,441,1170,0,37.69,14.7
新北市,三芝區,合計,6781,3518,3263,74,6855,19927,22460,34.4,17.65
新北市,石門區,德茂里,334,157,177,8,342,1087,0,31.46,14.44
新北市,石門區,富基里,483,250,233,5,488,1316,0,37.08,19.0
新北市,石門區,老梅里,623,310,313,13,636,2052,0,30.99,15.11
新北市,石門區,山溪里,264,129,135,6,270,867,0,31.14,14.88
新北市,石門區,石門里,515,296,219,10,525,1496,0,35.09,19.79
新北市,石門區,尖鹿里,425,211,214,8,433,1452,0,29.82,14.53
新北市,石門區,乾華里,98,53,45,2,100,315,0,31.75,16.83
新北市,石門區,茂林里,193,94,99,1,194,589,0,32.94,15.96
新北市,石門區,草里里,258,135,123,3,261,915,0,28.52,14.75
新北市,石門區,合計,3193,1635,1558,56,3249,10089,11303,32.2,16.21
新北市,八里區,龍源里,2781,1381,1400,20,2801,6740,0,41.56,20.49
新北市,八里區,米倉里,1191,596,595,8,1199,3256,0,36.82,18.3
新北市,八里區,大崁里,1208,534,674,6,1214,3091,0,39.28,17.28
新北市,八里區,埤頭里,1411,631,780,15,1426,3745,0,38.08,16.85
新北市,八里區,頂罟里,779,382,397,8,787,2139,0,36.79,17.86
新北市,八里區,舊城里,2321,1069,1252,20,2341,6501,0,36.01,16.44
新北市,八里區,訊塘里,1469,676,793,9,1478,4113,0,35.93,16.44
新北市,八里區,荖阡里,560,249,311,5,565,1639,0,34.47,15.19
新北市,八里區,長坑里,507,224,283,8,515,1521,0,33.86,14.73
新北市,八里區,下罟里,494,254,240,7,501,1476,0,33.94,17.21
新北市,八里區,合計,12721,5996,6725,106,12827,34221,39799,37.48,17.52
新北市,平溪區,薯榔里,132,53,79,2,134,361,0,37.12,14.68
新北市,平溪區,菁桐里,84,50,34,1,85,226,0,37.61,22.12
新北市,平溪區,白石里,97,40,57,0,97,229,0,42.36,17.47
新北市,平溪區,石底里,160,58,102,2,162,417,0,38.85,13.91
新北市,平溪區,平溪里,102,64,38,0,102,247,0,41.3,25.91
新北市,平溪區,嶺腳里,179,88,91,1,180,586,0,30.72,15.02
新北市,平溪區,東勢里,157,72,85,3,160,406,0,39.41,17.73
新北市,平溪區,望古里,58,25,33,0,58,154,0,37.66,16.23
新北市,平溪區,南山里,120,54,66,4,124,337,0,36.8,16.02
新北市,平溪區,平湖里,72,31,41,0,72,164,0,43.9,18.9
新北市,平溪區,十分里,250,120,130,10,260,798,0,32.58,15.04
新北市,平溪區,新寮里,40,21,19,0,40,151,0,26.49,13.91
新北市,平溪區,合計,1451,676,775,23,1474,4076,4354,36.16,16.58
新北市,雙溪區,雙溪里,176,101,75,3,179,444,0,40.32,22.75
新北市,雙溪區,共和里,131,55,76,3,134,363,0,36.91,15.15
新北市,雙溪區,新基里,295,157,138,9,304,713,0,42.64,22.02
新北市,雙溪區,魚行里,229,103,126,5,234,678,0,34.51,15.19
新北市,雙溪區,三港里,122,54,68,2,124,345,0,35.94,15.65
新北市,雙溪區,牡丹里,492,233,259,10,502,1416,0,35.45,16.45
新北市,雙溪區,三貂里,107,50,57,1,108,319,0,33.86,15.67
新北市,雙溪區,平林里,330,180,150,2,332,860,0,38.6,20.93
新北市,雙溪區,上林里,203,86,117,8,211,593,0,35.58,14.5
新北市,雙溪區,外柑里,162,80,82,1,163,394,0,41.37,20.3
新北市,雙溪區,長源里,109,35,74,0,109,351,0,31.05,9.97
新北市,雙溪區,泰平里,331,162,169,5,336,1129,0,29.76,14.35
新北市,雙溪區,合計,2687,1296,1391,49,2736,7605,8307,35.98,17.04
新北市,貢寮區,貢寮里,317,139,178,3,320,823,0,38.88,16.89
新北市,貢寮區,吉林里,158,55,103,4,162,462,0,35.06,11.9
新北市,貢寮區,雙玉里,240,82,158,6,246,631,0,38.99,13.0
新北市,貢寮區,龍崗里,146,52,94,2,148,398,0,37.19,13.07
新北市,貢寮區,龍門里,280,72,208,4,284,630,0,45.08,11.43
新北市,貢寮區,福隆里,590,240,350,5,595,1599,0,37.21,15.01
新北市,貢寮區,仁里里,734,250,484,7,741,1652,0,44.85,15.13
新北市,貢寮區,真理里,736,157,579,13,749,1987,0,37.7,7.9
新北市,貢寮區,福連里,319,92,227,2,321,886,0,36.23,10.38
新北市,貢寮區,美豐里,291,94,197,8,299,716,0,41.76,13.13
新北市,貢寮區,和美里,338,90,248,3,341,981,0,34.76,9.17
新北市,貢寮區,合計,4149,1323,2826,57,4206,10765,11658,39.07,12.29
新北市,金山區,和平里,190,99,91,1,191,456,0,41.89,21.71
新北市,金山區,大同里,243,124,119,3,246,712,0,34.55,17.42
新北市,金山區,豐漁里,195,85,110,0,195,502,0,38.84,16.93
新北市,金山區,磺港里,626,210,416,4,630,1719,0,36.65,12.22
新北市,金山區,美田里,1306,619,687,14,1320,3777,0,34.95,16.39
新北市,金山區,五湖里,598,292,306,7,605,1641,0,36.87,17.79
新北市,金山區,重和里,400,155,245,6,406,1182,0,34.35,13.11
新北市,金山區,兩湖里,121,55,66,2,123,377,0,32.63,14.59
新北市,金山區,六股里,237,87,150,7,244,643,0,37.95,13.53
新北市,金山區,三界里,232,89,143,5,237,619,0,38.29,14.38
新北市,金山區,清泉里,250,110,140,4,254,801,0,31.71,13.73
新北市,金山區,萬壽里,162,54,108,4,166,443,0,37.47,12.19
新北市,金山區,西湖里,72,34,38,1,73,177,0,41.24,19.21
新北市,金山區,永興里,178,71,107,4,182,570,0,31.93,12.46
新北市,金山區,金美里,1688,793,895,17,1705,4954,0,34.42,16.01
新北市,金山區,合計,6498,2877,3621,79,6577,18573,20926,35.41,15.49
新北市,萬里區,萬里里,1469,736,733,16,1485,4232,0,35.09,17.39
新北市,萬里區,龜吼里,766,383,383,3,769,2548,0,30.18,15.03
新北市,萬里區,野柳里,1023,485,538,9,1032,3153,0,32.73,15.38
新北市,萬里區,大鵬里,943,449,494,16,959,2681,0,35.77,16.75
新北市,萬里區,磺潭里,183,93,90,2,185,574,0,32.23,16.2
新北市,萬里區,雙興里,325,136,189,5,330,966,0,34.16,14.08
新北市,萬里區,溪底里,201,71,130,3,204,659,0,30.96,10.77
新北市,萬里區,崁脚里,148,50,98,0,148,403,0,36.72,12.41
新北市,萬里區,中幅里,353,173,180,6,359,1107,0,32.43,15.63
新北市,萬里區,北基里,924,501,423,8,932,2751,0,33.88,18.21
新北市,萬里區,合計,6335,3077,3258,68,6403,19074,21542,33.57,16.13
新北市,烏來區,烏來里,774,447,327,12,786,2348,0,33.48,19.04
新北市,烏來區,忠治里,534,326,208,4,538,1572,0,34.22,20.74
新北市,烏來區,福山里,152,122,30,6,158,606,0,26.07,20.13
新北市,烏來區,信賢里,156,77,79,1,157,504,0,31.15,15.28
新北市,烏來區,孝義里,67,26,41,1,68,231,0,29.44,11.26
新北市,烏來區,合計,1683,998,685,24,1707,5261,6343,32.45,18.97
新北市,合計,合計,1443145,725556,717589,13320,1456465,3427162,4021398,42.5,21.17
桃園市,桃園區,文化里,485,239,246,2,487,1024,0,47.56,23.34
桃園市,桃園區,文明里,691,342,349,4,695,1396,0,49.79,24.5
桃園市,桃園區,武陵里,621,297,324,6,627,1628,0,38.51,18.24
桃園市,桃園區,大林里,2539,1215,1324,21,2560,6940,0,36.89,17.51
桃園市,桃園區,忠義里,1361,761,600,16,1377,3581,0,38.45,21.25
桃園市,桃園區,會稽里,3773,2174,1599,23,3796,9791,0,38.77,22.2
桃園市,桃園區,長美里,466,161,305,5,471,1005,0,46.87,16.02
桃園市,桃園區,民生里,680,329,351,6,686,1649,0,41.6,19.95
桃園市,桃園區,永興里,748,306,442,4,752,1820,0,41.32,16.81
桃園市,桃園區,汴洲里,2588,1140,1448,27,2615,6542,0,39.97,17.43
桃園市,桃園區,永安里,2060,893,1167,26,2086,4520,0,46.15,19.76
桃園市,桃園區,東埔里,1877,827,1050,17,1894,4602,0,41.16,17.97
桃園市,桃園區,東門里,1360,684,676,8,1368,3019,0,45.31,22.66
桃園市,桃園區,東山里,807,373,434,10,817,1896,0,43.09,19.67
桃園市,桃園區,萬壽里,392,159,233,2,394,924,0,42.64,17.21
桃園市,桃園區,長安里,1481,656,825,11,1492,3527,0,42.3,18.6
桃園市,桃園區,中埔里,978,374,604,8,986,2382,0,41.39,15.7
桃園市,桃園區,西埔里,1328,517,811,17,1345,3082,0,43.64,16.77
桃園市,桃園區,西門里,640,310,330,4,644,1626,0,39.61,19.07
桃園市,桃園區,中和里,617,260,357,5,622,1307,0,47.59,19.89
桃園市,桃園區,文昌里,380,140,240,4,384,778,0,49.36,17.99
桃園市,桃園區,新埔里,4194,2337,1857,40,4234,9814,0,43.14,23.81
桃園市,桃園區,中山里,2881,1525,1356,16,2897,6789,0,42.67,22.46
桃園市,桃園區,慈文里,2445,1212,1233,20,2465,6329,0,38.95,19.15
桃園市,桃園區,西湖里,633,317,316,5,638,1430,0,44.62,22.17
桃園市,桃園區,南門里,2466,1221,1245,33,2499,5908,0,42.3,20.67
桃園市,桃園區,南華里,604,241,363,11,615,1365,0,45.05,17.66
桃園市,桃園區,玉山里,2061,956,1105,19,2080,4880,0,42.62,19.59
桃園市,桃園區,中成里,2265,1066,1199,12,2277,5722,0,39.79,18.63
桃園市,桃園區,中正里,2880,1565,1315,11,2891,6550,0,44.14,23.89
桃園市,桃園區,北門里,730,312,418,3,733,1710,0,42.87,18.25
桃園市,桃園區,雲林里,2627,1339,1288,23,2650,6053,0,43.78,22.12
桃園市,桃園區,福林里,2636,1342,1294,34,2670,5943,0,44.93,22.58
桃園市,桃園區,光興里,2135,954,1181,15,2150,4548,0,47.27,20.98
桃園市,桃園區,龍山里,1291,689,602,13,1304,3479,0,37.48,19.8
桃園市,桃園區,龍岡里,2320,1322,998,26,2346,5803,0,40.43,22.78
桃園市,桃園區,成功里,1806,963,843,15,1821,3846,0,47.35,25.04
桃園市,桃園區,青溪里,1827,773,1054,20,1847,4213,0,43.84,18.35
桃園市,桃園區,朝陽里,891,411,480,13,904,1970,0,45.89,20.86
桃園市,桃園區,中興里,2461,1151,1310,15,2476,5681,0,43.58,20.26
桃園市,桃園區,豐林里,2836,1422,1414,19,2855,6243,0,45.73,22.78
桃園市,桃園區,建國里,2214,1128,1086,31,2245,5129,0,43.77,21.99
桃園市,桃園區,大豐里,2044,990,1054,13,2057,4911,0,41.89,20.16
桃園市,桃園區,福安里,1753,887,866,13,1766,4122,0,42.84,21.52
桃園市,桃園區,三民里,1964,1138,826,16,1980,4162,0,47.57,27.34
桃園市,桃園區,大興里,1982,926,1056,20,2002,5398,0,37.09,17.15
桃園市,桃園區,春日里,2238,1094,1144,27,2265,6093,0,37.17,17.96
桃園市,桃園區,信光里,2770,1322,1448,27,2797,6914,0,40.45,19.12
桃園市,桃園區,中寧里,2415,1335,1080,11,2426,6089,0,39.84,21.92
桃園市,桃園區,同安里,3886,1953,1933,24,3910,9540,0,40.99,20.47
桃園市,桃園區,莊敬里,3698,2114,1584,30,3728,8779,0,42.46,24.08
桃園市,桃園區,文中里,1763,923,840,14,1777,3991,0,44.53,23.13
桃園市,桃園區,泰山里,1634,854,780,18,1652,3653,0,45.22,23.38
桃園市,桃園區,中路里,1603,833,770,17,1620,3883,0,41.72,21.45
桃園市,桃園區,中德里,2670,1365,1305,27,2697,6452,0,41.8,21.16
桃園市,桃園區,龍祥里,1821,1080,741,16,1837,4939,0,37.19,21.87
桃園市,桃園區,大有里,2396,1357,1039,18,2414,6433,0,37.53,21.09
桃園市,桃園區,寶山里,3155,1704,1451,24,3179,8491,0,37.44,20.07
桃園市,桃園區,龍鳳里,2978,1588,1390,22,3000,9776,0,30.69,16.24
桃園市,桃園區,龍安里,2101,1136,965,16,2117,5408,0,39.15,21.01
桃園市,桃園區,自強里,3229,1732,1497,26,3255,7355,0,44.26,23.55
桃園市,桃園區,中信里,2210,1161,1049,16,2226,5612,0,39.67,20.69
桃園市,桃園區,長德里,2200,1044,1156,11,2211,4931,0,44.84,21.17
桃園市,桃園區,中平里,1958,1077,881,14,1972,4612,0,42.76,23.35
桃園市,桃園區,中原里,2018,1135,883,15,2033,4570,0,44.49,24.84
桃園市,桃園區,中泰里,1828,1054,774,14,1842,4145,0,44.44,25.43
桃園市,桃園區,南埔里,2100,1047,1053,18,2118,4872,0,43.47,21.49
桃園市,桃園區,寶慶里,2560,1386,1174,24,2584,6169,0,41.89,22.47
桃園市,桃園區,北埔里,1911,1046,865,18,1929,4734,0,40.75,22.1
桃園市,桃園區,中聖里,2308,1373,935,23,2331,5481,0,42.53,25.05
桃園市,桃園區,龍壽里,2462,1252,1210,27,2489,6540,0,38.06,19.14
桃園市,桃園區,同德里,2587,1468,1119,17,2604,6061,0,42.96,24.22
桃園市,桃園區,明德里,1448,767,681,10,1458,3179,0,45.86,24.13
桃園市,桃園區,寶安里,3097,1688,1409,22,3119,8113,0,38.44,20.81
桃園市,桃園區,瑞慶里,2258,1202,1056,19,2277,5936,0,38.36,20.25
桃園市,桃園區,三元里,1529,801,728,14,1543,3791,0,40.7,21.13
桃園市,桃園區,大樹里,1494,732,762,9,1503,3881,0,38.73,18.86
桃園市,桃園區,大業里,1999,1057,942,18,2017,5006,0,40.29,21.11
桃園市,桃園區,福元里,1827,1005,822,12,1839,4546,0,40.45,22.11
桃園市,桃園區,合計,153969,79029,74940,1300,155269,375012,458824,41.4,21.07
桃園市,中壢區,龍平里,1286,992,294,15,1301,2898,0,44.89,34.23
桃園市,中壢區,龍昌里,2243,1433,810,15,2258,5428,0,41.6,26.4
桃園市,中壢區,仁德里,1275,811,464,18,1293,3064,0,42.2,26.47
桃園市,中壢區,永興里,392,196,196,4,396,914,0,43.33,21.44
桃園市,中壢區,內壢里,912,572,340,13,925,2196,0,42.12,26.05
桃園市,中壢區,成功里,1744,1023,721,16,1760,4380,0,40.18,23.36
桃園市,中壢區,光明里,2385,1367,1018,21,2406,5320,0,45.23,25.7
桃園市,中壢區,自立里,2329,1921,408,29,2358,5087,0,46.35,37.76
桃園市,中壢區,自強里,1529,1036,493,11,1540,3497,0,44.04,29.63
桃園市,中壢區,中堅里,1504,1003,501,13,1517,3778,0,40.15,26.55
桃園市,中壢區,龍興里,1778,1019,759,25,1803,4305,0,41.88,23.67
桃園市,中壢區,仁美里,2206,1334,872,14,2220,5566,0,39.89,23.97
桃園市,中壢區,仁愛里,1294,734,560,7,1301,3006,0,43.28,24.42
桃園市,中壢區,新街里,974,525,449,13,987,2310,0,42.73,22.73
桃園市,中壢區,中央里,1639,865,774,8,1647,3407,0,48.34,25.39
桃園市,中壢區,普仁里,1616,941,675,14,1630,4240,0,38.44,22.19
桃園市,中壢區,普義里,1733,1049,684,15,1748,5599,0,31.22,18.74
桃園市,中壢區,忠義里,1575,855,720,12,1587,3943,0,40.25,21.68
桃園市,中壢區,中正里,1980,1258,722,17,1997,5241,0,38.1,24.0
桃園市,中壢區,興仁里,1276,753,523,10,1286,3393,0,37.9,22.19
桃園市,中壢區,東興里,1485,775,710,10,1495,3315,0,45.1,23.38
桃園市,中壢區,洽溪里,2805,1360,1445,23,2828,6960,0,40.63,19.54
桃園市,中壢區,篤行里,1003,603,400,7,1010,2660,0,37.97,22.67
桃園市,中壢區,新明里,1579,742,837,14,1593,3765,0,42.31,19.71
桃園市,中壢區,新興里,1542,835,707,12,1554,3646,0,42.62,22.9
桃園市,中壢區,中原里,1559,844,715,9,1568,3654,0,42.91,23.1
桃園市,中壢區,內定里,2454,1128,1326,16,2470,6882,0,35.89,16.39
桃園市,中壢區,中壢里,294,147,147,1,295,674,0,43.77,21.81
桃園市,中壢區,龍岡里,2000,1317,683,23,2023,4607,0,43.91,28.59
桃園市,中壢區,仁祥里,1064,719,345,8,1072,2813,0,38.11,25.56
桃園市,中壢區,水尾里,1499,706,793,16,1515,3634,0,41.69,19.43
桃園市,中壢區,青埔里,2625,1335,1290,20,2645,6486,0,40.78,20.58
桃園市,中壢區,復興里,3481,1995,1486,28,3509,9665,0,36.31,20.64
桃園市,中壢區,文化里,3401,1807,1594,20,3421,8837,0,38.71,20.45
桃園市,中壢區,興國里,855,404,451,8,863,1888,0,45.71,21.4
桃園市,中壢區,忠福里,3160,1721,1439,27,3187,7822,0,40.74,22.0
桃園市,中壢區,信義里,1982,1142,840,9,1991,4334,0,45.94,26.35
桃園市,中壢區,石頭里,701,330,371,6,707,1585,0,44.61,20.82
桃園市,中壢區,龍東里,2061,1588,473,22,2083,4952,0,42.06,32.07
桃園市,中壢區,中建里,448,199,249,3,451,991,0,45.51,20.08
桃園市,中壢區,興南里,1277,729,548,15,1292,3012,0,42.9,24.2
桃園市,中壢區,後寮里,1830,1052,778,17,1847,4849,0,38.09,21.7
桃園市,中壢區,過嶺里,3012,1444,1568,25,3037,7935,0,38.27,18.2
桃園市,中壢區,五權里,2547,1270,1277,24,2571,6137,0,41.89,20.69
桃園市,中壢區,舊明里,702,323,379,11,713,1460,0,48.84,22.12
桃園市,中壢區,芝芭里,1711,863,848,14,1725,4196,0,41.11,20.57
桃園市,中壢區,月眉里,2101,730,1371,19,2120,5631,0,37.65,12.96
桃園市,中壢區,三民里,1267,573,694,9,1276,3254,0,39.21,17.61
桃園市,中壢區,山東里,1470,502,968,18,1488,3746,0,39.72,13.4
桃園市,中壢區,中榮里,383,181,202,3,386,827,0,46.67,21.89
桃園市,中壢區,內厝里,2040,846,1194,20,2060,4787,0,43.03,17.67
桃園市,中壢區,振興里,2103,1233,870,17,2120,4813,0,44.05,25.62
桃園市,中壢區,普慶里,1149,690,459,5,1154,2583,0,44.68,26.71
桃園市,中壢區,興和里,1224,542,682,10,1234,2700,0,45.7,20.07
桃園市,中壢區,永光里,2221,1146,1075,15,2236,5435,0,41.14,21.09
桃園市,中壢區,復華里,2224,1251,973,21,2245,5563,0,40.36,22.49
桃園市,中壢區,忠孝里,1867,1117,750,20,1887,4591,0,41.1,24.33
桃園市,中壢區,福德里,1214,689,525,9,1223,2834,0,43.15,24.31
桃園市,中壢區,和平里,1005,558,447,4,1009,2525,0,39.96,22.1
桃園市,中壢區,普忠里,1451,826,625,8,1459,3252,0,44.86,25.4
桃園市,中壢區,普強里,1690,1035,655,9,1699,3683,0,46.13,28.1
桃園市,中壢區,明德里,2036,1149,887,9,2045,4693,0,43.58,24.48
桃園市,中壢區,至善里,1422,960,462,12,1434,3713,0,38.62,25.86
桃園市,中壢區,五福里,1487,724,763,14,1501,3620,0,41.46,20.0
桃園市,中壢區,龍德里,1775,1119,656,12,1787,4104,0,43.54,27.27
桃園市,中壢區,正義里,1914,1055,859,11,1925,4282,0,44.96,24.64
桃園市,中壢區,龍安里,1016,797,219,4,1020,2050,0,49.76,38.88
桃園市,中壢區,中山里,1830,1178,652,15,1845,4761,0,38.75,24.74
桃園市,中壢區,德義里,1131,631,500,9,1140,2501,0,45.58,25.23
桃園市,中壢區,仁義里,1591,854,737,18,1609,3783,0,42.53,22.57
桃園市,中壢區,華勛里,1482,1058,424,15,1497,3965,0,37.76,26.68
桃園市,中壢區,仁福里,1841,1210,631,17,1858,4804,0,38.68,25.19
桃園市,中壢區,幸福里,2446,1343,1103,19,2465,6095,0,40.44,22.03
桃園市,中壢區,永福里,2429,1243,1186,17,2446,5469,0,44.72,22.73
桃園市,中壢區,仁和里,1381,856,525,19,1400,3582,0,39.08,23.9
桃園市,中壢區,華愛里,1356,879,477,15,1371,3555,0,38.57,24.73
桃園市,中壢區,莊敬里,1611,1235,376,29,1640,3413,0,48.05,36.19
桃園市,中壢區,自治里,1655,1235,420,12,1667,3620,0,46.05,34.12
桃園市,中壢區,健行里,1912,1118,794,15,1927,4454,0,43.26,25.1
桃園市,中壢區,興平里,1153,516,637,3,1156,2395,0,48.27,21.54
桃園市,中壢區,中興里,1351,890,461,11,1362,3376,0,40.34,26.36
桃園市,中壢區,龍慈里,2009,1332,677,13,2022,4787,0,42.24,27.83
桃園市,中壢區,自信里,2291,1458,833,20,2311,5590,0,41.34,26.08
桃園市,中壢區,林森里,1702,1009,693,11,1713,3821,0,44.83,26.41
桃園市,中壢區,金華里,2077,1292,785,15,2092,4035,0,51.85,32.02
桃園市,中壢區,合計,143054,82125,60929,1200,144254,347023,422582,41.57,23.67
桃園市,大溪區,興和里,671,247,424,5,676,1435,0,47.11,17.21
桃園市,大溪區,福仁里,452,162,290,5,457,963,0,47.46,16.82
桃園市,大溪區,一心里,1819,809,1010,15,1834,4760,0,38.53,17.0
桃園市,大溪區,一德里,1996,788,1208,27,2023,5582,0,36.24,14.12
桃園市,大溪區,月眉里,476,149,327,8,484,1237,0,39.13,12.05
桃園市,大溪區,永福里,433,122,311,3,436,964,0,45.23,12.66
桃園市,大溪區,美華里,1234,449,785,11,1245,3069,0,40.57,14.63
桃園市,大溪區,福安里,894,303,591,13,907,2222,0,40.82,13.64
桃園市,大溪區,復興里,348,121,227,5,353,859,0,41.09,14.09
桃園市,大溪區,新峰里,304,111,193,5,309,808,0,38.24,13.74
桃園市,大溪區,康安里,579,173,406,8,587,1300,0,45.15,13.31
桃園市,大溪區,義和里,724,256,468,7,731,1752,0,41.72,14.61
桃園市,大溪區,瑞興里,998,383,615,15,1013,2714,0,37.32,14.11
桃園市,大溪區,中新里,672,232,440,8,680,1519,0,44.77,15.27
桃園市,大溪區,仁義里,1053,759,294,25,1078,2831,0,38.08,26.81
桃園市,大溪區,僑愛里,1089,913,176,9,1098,2488,0,44.13,36.7
桃園市,大溪區,仁善里,1780,914,866,13,1793,4490,0,39.93,20.36
桃園市,大溪區,仁愛里,1948,970,978,20,1968,5178,0,38.01,18.73
桃園市,大溪區,仁武里,1265,700,565,12,1277,3244,0,39.36,21.58
桃園市,大溪區,員林里,599,306,293,4,603,1577,0,38.24,19.4
桃園市,大溪區,南興里,1781,802,979,26,1807,5101,0,35.42,15.72
桃園市,大溪區,瑞源里,1451,638,813,9,1460,3734,0,39.1,17.09
桃園市,大溪區,光明里,924,583,341,18,942,2437,0,38.65,23.92
桃園市,大溪區,三元里,1201,795,406,12,1213,3012,0,40.27,26.39
桃園市,大溪區,田心里,1843,733,1110,22,1865,4436,0,42.04,16.52
桃園市,大溪區,仁文里,1473,813,660,14,1487,3897,0,38.16,20.86
桃園市,大溪區,仁和里,1818,936,882,15,1833,4772,0,38.41,19.61
桃園市,大溪區,仁美里,1241,679,562,14,1255,3309,0,37.93,20.52
桃園市,大溪區,合計,31066,14846,16220,348,31414,79690,95240,39.42,18.63
桃園市,楊梅區,楊梅里,1576,936,640,8,1584,3845,0,41.2,24.34
桃園市,楊梅區,楊江里,468,287,181,6,474,1054,0,44.97,27.23
桃園市,楊梅區,紅梅里,1088,653,435,12,1100,2595,0,42.39,25.16
桃園市,楊梅區,永寧里,2463,1409,1054,19,2482,7481,0,33.18,18.83
桃園市,楊梅區,大平里,1135,706,429,9,1144,3148,0,36.34,22.43
桃園市,楊梅區,東流里,987,451,536,7,994,2934,0,33.88,15.37
桃園市,楊梅區,水美里,1602,804,798,18,1620,4097,0,39.54,19.62
桃園市,楊梅區,上田里,974,456,518,8,982,2632,0,37.31,17.33
桃園市,楊梅區,梅新里,794,461,333,8,802,1933,0,41.49,23.85
桃園市,楊梅區,大同里,1430,876,554,14,1444,3487,0,41.41,25.12
桃園市,楊梅區,埔心里,656,317,339,14,670,1355,0,49.45,23.39
桃園市,楊梅區,金龍里,565,400,165,8,573,1396,0,41.05,28.65
桃園市,楊梅區,瑞塘里,2153,1183,970,18,2171,5757,0,37.71,20.55
桃園市,楊梅區,四維里,1900,1163,737,18,1918,4609,0,41.61,25.23
桃園市,楊梅區,梅溪里,1460,866,594,11,1471,4143,0,35.51,20.9
桃園市,楊梅區,高山里,1251,751,500,11,1262,3760,0,33.56,19.97
桃園市,楊梅區,高榮里,1372,665,707,15,1387,3518,0,39.43,18.9
桃園市,楊梅區,仁美里,1653,961,692,15,1668,3818,0,43.69,25.17
桃園市,楊梅區,光華里,1305,824,481,17,1322,3153,0,41.93,26.13
桃園市,楊梅區,富岡里,697,404,293,6,703,1787,0,39.34,22.61
桃園市,楊梅區,豐野里,1457,798,659,10,1467,3873,0,37.88,20.6
桃園市,楊梅區,員本里,1048,564,484,22,1070,2859,0,37.43,19.73
桃園市,楊梅區,瑞原里,1186,663,523,23,1209,3757,0,32.18,17.65
桃園市,楊梅區,三湖里,974,497,477,3,977,2794,0,34.97,17.79
桃園市,楊梅區,上湖里,1952,1109,843,16,1968,5853,0,33.62,18.95
桃園市,楊梅區,中山里,1209,720,489,6,1215,2986,0,40.69,24.11
桃園市,楊梅區,楊明里,2749,1603,1146,15,2764,7742,0,35.7,20.71
桃園市,楊梅區,金溪里,1644,1037,607,19,1663,4048,0,41.08,25.62
桃園市,楊梅區,裕成里,1479,898,581,11,1490,3286,0,45.34,27.33
桃園市,楊梅區,秀才里,1328,702,626,16,1344,3311,0,40.59,21.2
桃園市,楊梅區,青山里,1430,865,565,11,1441,4482,0,32.15,19.3
桃園市,楊梅區,新榮里,1420,730,690,13,1433,3453,0,41.5,21.14
桃園市,楊梅區,雙榮里,1415,732,683,14,1429,3233,0,44.2,22.64
桃園市,楊梅區,瑞坪里,2090,1272,818,14,2104,5934,0,35.46,21.44
桃園市,楊梅區,永平里,742,441,301,7,749,1966,0,38.1,22.43
桃園市,楊梅區,瑞溪里,1183,704,479,10,1193,3639,0,32.78,19.35
桃園市,楊梅區,高上里,971,510,461,8,979,2766,0,35.39,18.44
桃園市,楊梅區,富豐里,1024,537,487,9,1033,3030,0,34.09,17.72
桃園市,楊梅區,裕新里,853,543,310,2,855,2486,0,34.39,21.84
桃園市,楊梅區,三民里,1196,725,471,5,1201,3449,0,34.82,21.02
桃園市,楊梅區,頭湖里,1021,589,432,9,1030,2900,0,35.52,20.31
桃園市,楊梅區,合計,53900,30812,23088,485,54385,144349,176189,37.68,21.35
桃園市,蘆竹區,新興里,1244,420,824,14,1258,2950,0,42.64,14.24
桃園市,蘆竹區,中福里,1651,590,1061,17,1668,4062,0,41.06,14.52
桃園市,蘆竹區,新莊里,1992,830,1162,18,2010,5043,0,39.86,16.46
桃園市,蘆竹區,大竹里,1934,918,1016,16,1950,4969,0,39.24,18.47
桃園市,蘆竹區,蘆竹里,1573,564,1009,15,1588,4036,0,39.35,13.97
桃園市,蘆竹區,南崁里,1536,747,789,13,1549,3675,0,42.15,20.33
桃園市,蘆竹區,錦興里,1612,771,841,8,1620,3906,0,41.47,19.74
桃園市,蘆竹區,五福里,1019,527,492,7,1026,2425,0,42.31,21.73
桃園市,蘆竹區,內厝里,917,333,584,7,924,2595,0,35.61,12.83
桃園市,蘆竹區,山鼻里,595,242,353,8,603,1778,0,33.91,13.61
桃園市,蘆竹區,山腳里,1309,454,855,18,1327,3579,0,37.08,12.69
桃園市,蘆竹區,外社里,619,156,463,11,630,1486,0,42.4,10.5
桃園市,蘆竹區,坑子里,616,175,441,8,624,1673,0,37.3,10.46
桃園市,蘆竹區,坑口里,979,349,630,6,985,2501,0,39.38,13.95
桃園市,蘆竹區,海湖里,927,439,488,12,939,2969,0,31.63,14.79
桃園市,蘆竹區,南榮里,1526,723,803,15,1541,3532,0,43.63,20.47
桃園市,蘆竹區,南興里,2191,1167,1024,13,2204,5162,0,42.7,22.61
桃園市,蘆竹區,長興里,863,405,458,6,869,2582,0,33.66,15.69
桃園市,蘆竹區,錦中里,1325,616,709,9,1334,3128,0,42.65,19.69
桃園市,蘆竹區,富竹里,575,146,429,6,581,1327,0,43.78,11.0
桃園市,蘆竹區,上竹里,1428,636,792,12,1440,3516,0,40.96,18.09
桃園市,蘆竹區,宏竹里,1159,471,688,20,1179,2982,0,39.54,15.79
桃園市,蘆竹區,瓦窯里,1276,703,573,14,1290,3360,0,38.39,20.92
桃園市,蘆竹區,營盤里,1934,1033,901,20,1954,4886,0,39.99,21.14
桃園市,蘆竹區,羊稠里,1911,955,956,17,1928,4459,0,43.24,21.42
桃園市,蘆竹區,順興里,1518,765,753,6,1524,3985,0,38.24,19.2
桃園市,蘆竹區,福昌里,1960,1095,865,13,1973,5062,0,38.98,21.63
桃園市,蘆竹區,福興里,1346,692,654,12,1358,3442,0,39.45,20.1
桃園市,蘆竹區,蘆興里,593,255,338,8,601,1633,0,36.8,15.62
桃園市,蘆竹區,長壽里,2343,1289,1054,17,2360,5584,0,42.26,23.08
桃園市,蘆竹區,吉祥里,1757,968,789,14,1771,3690,0,47.99,26.23
桃園市,蘆竹區,中山里,1224,649,575,12,1236,3243,0,38.11,20.01
桃園市,蘆竹區,福祿里,1175,571,604,9,1184,3227,0,36.69,17.69
桃園市,蘆竹區,興榮里,1231,648,583,9,1240,2793,0,44.4,23.2
桃園市,蘆竹區,中興里,1815,912,903,10,1825,5074,0,35.97,17.97
桃園市,蘆竹區,上興里,1372,655,717,7,1379,3380,0,40.8,19.38
桃園市,蘆竹區,營福里,1280,658,622,11,1291,3296,0,39.17,19.96
桃園市,蘆竹區,正興里,1514,705,809,6,1520,4443,0,34.21,15.87
桃園市,蘆竹區,濱海里,757,338,419,15,772,2532,0,30.49,13.35
桃園市,蘆竹區,合計,52596,24570,28026,459,53055,133965,166690,39.6,18.34
桃園市,大園區,大園里,2341,1066,1275,16,2357,6107,0,38.6,17.46
桃園市,大園區,田心里,2512,1087,1425,25,2537,6972,0,36.39,15.59
桃園市,大園區,溪海里,1472,625,847,18,1490,4705,0,31.67,13.28
桃園市,大園區,和平里,642,230,412,4,646,1612,0,40.07,14.27
桃園市,大園區,橫峰里,4553,2179,2374,50,4603,11610,0,39.65,18.77
桃園市,大園區,五權里,1983,703,1280,15,1998,5222,0,38.26,13.46
桃園市,大園區,埔心里,2155,914,1241,13,2168,5896,0,36.77,15.5
桃園市,大園區,大海里,654,358,296,8,662,1650,0,40.12,21.7
桃園市,大園區,三石里,1202,506,696,13,1215,2851,0,42.62,17.75
桃園市,大園區,菓林里,2489,1120,1369,26,2515,7202,0,34.92,15.55
桃園市,大園區,竹圍里,1193,567,626,7,1200,3212,0,37.36,17.65
桃園市,大園區,海口里,602,318,284,5,607,1863,0,32.58,17.07
桃園市,大園區,沙崙里,878,506,372,11,889,2595,0,34.26,19.5
桃園市,大園區,後厝里,817,373,444,5,822,2523,0,32.58,14.78
桃園市,大園區,圳頭里,945,399,546,9,954,2566,0,37.18,15.55
桃園市,大園區,內海里,757,309,448,5,762,2154,0,35.38,14.35
桃園市,大園區,北港里,955,371,584,15,970,2912,0,33.31,12.74
桃園市,大園區,南港里,1737,850,887,9,1746,5701,0,30.63,14.91
桃園市,大園區,合計,27887,12481,15406,254,28141,77353,93663,36.38,16.14
桃園市,龜山區,楓樹里,1700,757,943,11,1711,3984,0,42.95,19.0
桃園市,龜山區,龜山里,2587,1275,1312,18,2605,6579,0,39.6,19.38
桃園市,龜山區,兔坑里,1559,737,822,12,1571,4492,0,34.97,16.41
桃園市,龜山區,大同里,2221,1112,1109,17,2238,5834,0,38.36,19.06
桃園市,龜山區,山福里,1262,619,643,19,1281,3262,0,39.27,18.98
桃園市,龜山區,山頂里,1958,1002,956,17,1975,5439,0,36.31,18.42
桃園市,龜山區,陸光里,1771,1544,227,30,1801,3606,0,49.94,42.82
桃園市,龜山區,精忠里,2149,1436,713,34,2183,5179,0,42.15,27.73
桃園市,龜山區,公西里,627,286,341,6,633,1298,0,48.77,22.03
桃園市,龜山區,樂善里,1922,855,1067,14,1936,5523,0,35.05,15.48
桃園市,龜山區,南上里,793,338,455,7,800,1874,0,42.69,18.04
桃園市,龜山區,大坑里,728,343,385,4,732,1975,0,37.06,17.37
桃園市,龜山區,中興里,1792,994,798,20,1812,4708,0,38.49,21.11
桃園市,龜山區,山德里,1982,910,1072,18,2000,4790,0,41.75,19.0
桃園市,龜山區,新路里,2286,1100,1186,29,2315,5265,0,43.97,20.89
桃園市,龜山區,嶺頂里,1507,685,822,19,1526,4034,0,37.83,16.98
桃園市,龜山區,龍壽里,689,214,475,8,697,1760,0,39.6,12.16
桃園市,龜山區,舊路里,1144,567,577,17,1161,2636,0,44.04,21.51
桃園市,龜山區,大崗里,1397,647,750,19,1416,4111,0,34.44,15.74
桃園市,龜山區,文化里,2729,1330,1399,23,2752,6959,0,39.55,19.11
桃園市,龜山區,南美里,910,435,475,8,918,2303,0,39.86,18.89
桃園市,龜山區,幸福里,1682,870,812,25,1707,5268,0,32.4,16.51
桃園市,龜山區,福源里,783,403,380,9,792,1960,0,40.41,20.56
桃園市,龜山區,龍華里,1338,601,737,12,1350,3423,0,39.44,17.56
桃園市,龜山區,迴龍里,2342,1156,1186,27,2369,6098,0,38.85,18.96
桃園市,龜山區,新嶺里,1401,680,721,16,1417,3965,0,35.74,17.15
桃園市,龜山區,大湖里,2046,1041,1005,10,2056,5410,0,38.0,19.24
桃園市,龜山區,大華里,3528,1701,1827,25,3553,8945,0,39.72,19.02
桃園市,龜山區,長庚里,1768,801,967,11,1779,4161,0,42.75,19.25
桃園市,龜山區,新興里,928,602,326,14,942,3071,0,30.67,19.6
桃園市,龜山區,文青里,3128,1751,1377,22,3150,7571,0,41.61,23.13
桃園市,龜山區,楓福里,1373,703,670,8,1381,3109,0,44.42,22.61
桃園市,龜山區,合計,54030,27495,26535,529,54559,138592,165716,39.37,19.84
桃園市,八德區,興仁里,2938,1571,1367,22,2960,9275,0,31.91,16.94
桃園市,八德區,福興里,3358,1774,1584,33,3391,9960,0,34.05,17.81
桃園市,八德區,瑞豐里,1669,939,730,9,1678,4926,0,34.06,19.06
桃園市,八德區,瑞發里,1320,782,538,34,1354,3178,0,42.61,24.61
桃園市,八德區,瑞德里,1343,839,504,25,1368,3521,0,38.85,23.83
桃園市,八德區,瑞祥里,1299,890,409,22,1321,3201,0,41.27,27.8
桃園市,八德區,廣興里,1268,594,674,8,1276,3233,0,39.47,18.37
桃園市,八德區,廣隆里,1946,1078,868,19,1965,4536,0,43.32,23.77
桃園市,八德區,竹園里,1257,641,616,11,1268,3596,0,35.26,17.83
桃園市,八德區,霄裡里,822,405,417,14,836,2214,0,37.76,18.29
桃園市,八德區,茄苳里,921,400,521,10,931,2537,0,36.7,15.77
桃園市,八德區,高明里,1492,722,770,12,1504,3852,0,39.04,18.74
桃園市,八德區,白鷺里,1265,579,686,14,1279,3101,0,41.24,18.67
桃園市,八德區,大湳里,1471,660,811,12,1483,3930,0,37.74,16.79
桃園市,八德區,大安里,1372,620,752,15,1387,3486,0,39.79,17.79
桃園市,八德區,大興里,1511,782,729,13,1524,3792,0,40.19,20.62
桃園市,八德區,大和里,3004,1828,1176,34,3038,7352,0,41.32,24.86
桃園市,八德區,大同里,664,292,372,1,665,1505,0,44.19,19.4
桃園市,八德區,大成里,1423,694,729,14,1437,3312,0,43.39,20.95
桃園市,八德區,大義里,1452,835,617,14,1466,3738,0,39.22,22.34
桃園市,八德區,大忠里,711,399,312,9,720,1789,0,40.25,22.3
桃園市,八德區,大福里,2323,1216,1107,13,2336,5181,0,45.09,23.47
桃園市,八德區,大勇里,1688,854,834,14,1702,4113,0,41.38,20.76
桃園市,八德區,大信里,1274,704,570,25,1299,3515,0,36.96,20.03
桃園市,八德區,大華里,1060,574,486,10,1070,2531,0,42.28,22.68
桃園市,八德區,大仁里,1748,806,942,16,1764,4188,0,42.12,19.25
桃園市,八德區,大智里,1793,1108,685,12,1805,4256,0,42.41,26.03
桃園市,八德區,瑞泰里,1579,785,794,10,1589,4161,0,38.19,18.87
桃園市,八德區,大昌里,1185,626,559,20,1205,2848,0,42.31,21.98
桃園市,八德區,大正里,1626,852,774,17,1643,4290,0,38.3,19.86
桃園市,八德區,大強里,1341,589,752,9,1350,3074,0,43.92,19.16
桃園市,八德區,大發里,811,373,438,5,816,2030,0,40.2,18.37
桃園市,八德區,大明里,1452,682,770,21,1473,3632,0,40.56,18.78
桃園市,八德區,大竹里,598,251,347,12,610,1474,0,41.38,17.03
桃園市,八德區,大慶里,554,271,283,8,562,1414,0,39.75,19.17
桃園市,八德區,大千里,845,491,354,9,854,2222,0,38.43,22.1
桃園市,八德區,大榮里,765,387,378,10,775,1947,0,39.8,19.88
桃園市,八德區,茄明里,1766,936,830,24,1790,4778,0,37.46,19.59
桃園市,八德區,高城里,1236,654,582,8,1244,3114,0,39.95,21.0
桃園市,八德區,瑞興里,1119,502,617,14,1133,2788,0,40.64,18.01
桃園市,八德區,大愛里,1070,605,465,10,1080,2512,0,42.99,24.08
桃園市,八德區,大宏里,1788,1030,758,10,1798,4144,0,43.39,24.86
桃園市,八德區,大漢里,1537,878,659,9,1546,3923,0,39.41,22.38
桃園市,八德區,廣德里,1202,591,611,11,1213,2667,0,45.48,22.16
桃園市,八德區,龍友里,950,740,210,13,963,2166,0,44.46,34.16
桃園市,八德區,陸光里,1721,1370,351,37,1758,4338,0,40.53,31.58
桃園市,八德區,永豐里,1063,501,562,13,1076,2762,0,38.96,18.14
桃園市,八德區,大順里,1015,543,472,5,1020,2525,0,40.4,21.5
桃園市,八德區,合計,67615,36243,31372,710,68325,172627,209448,39.58,20.99
桃園市,龍潭區,黃唐里,1692,971,721,12,1704,4655,0,36.61,20.86
桃園市,龍潭區,中山里,2280,1300,980,35,2315,5884,0,39.34,22.09
桃園市,龍潭區,烏林里,1481,846,635,18,1499,4416,0,33.94,19.16
桃園市,龍潭區,高平里,1195,582,613,9,1204,3205,0,37.57,18.16
桃園市,龍潭區,凌雲里,1322,766,556,12,1334,3744,0,35.63,20.46
桃園市,龍潭區,八德里,1576,864,712,13,1589,4226,0,37.6,20.44
桃園市,龍潭區,三水里,280,85,195,3,283,652,0,43.4,13.04
桃園市,龍潭區,上林里,1718,946,772,9,1727,4406,0,39.2,21.47
桃園市,龍潭區,中正里,2149,1395,754,14,2163,5430,0,39.83,25.69
桃園市,龍潭區,龍潭里,835,423,412,7,842,1835,0,45.89,23.05
桃園市,龍潭區,高原里,1624,844,780,19,1643,4539,0,36.2,18.59
桃園市,龍潭區,九龍里,1440,890,550,12,1452,3741,0,38.81,23.79
桃園市,龍潭區,中興里,1567,967,600,17,1584,4232,0,37.43,22.85
桃園市,龍潭區,佳安里,1566,1063,503,17,1583,3420,0,46.29,31.08
桃園市,龍潭區,三和里,1185,733,452,9,1194,2574,0,46.39,28.48
桃園市,龍潭區,三坑里,607,276,331,7,614,1466,0,41.88,18.83
桃園市,龍潭區,大平里,1034,565,469,6,1040,2332,0,44.6,24.23
桃園市,龍潭區,三林里,1451,936,515,9,1460,3072,0,47.53,30.47
桃園市,龍潭區,永興里,1076,602,474,15,1091,2825,0,38.62,21.31
桃園市,龍潭區,烏樹林里,1013,534,479,6,1019,2613,0,39.0,20.44
桃園市,龍潭區,百年里,1962,1404,558,17,1979,4262,0,46.43,32.94
桃園市,龍潭區,龍祥里,1282,785,497,10,1292,3487,0,37.05,22.51
桃園市,龍潭區,聖德里,1138,561,577,7,1145,2995,0,38.23,18.73
桃園市,龍潭區,龍星里,1828,1081,747,23,1851,4094,0,45.21,26.4
桃園市,龍潭區,上華里,1386,883,503,13,1399,3238,0,43.21,27.27
桃園市,龍潭區,武漢里,553,344,209,9,562,1491,0,37.69,23.07
桃園市,龍潭區,東興里,1468,1014,454,17,1485,3992,0,37.2,25.4
桃園市,龍潭區,北興里,772,491,281,9,781,2314,0,33.75,21.22
桃園市,龍潭區,建林里,1783,1254,529,10,1793,3664,0,48.94,34.22
桃園市,龍潭區,富林里,1440,972,468,13,1453,3448,0,42.14,28.19
桃園市,龍潭區,祥和里,482,229,253,6,488,1583,0,30.83,14.47
桃園市,龍潭區,合計,41185,24606,16579,383,41568,103835,124481,40.03,23.7
桃園市,平鎮區,雙連里,1808,978,830,16,1824,4741,0,38.47,20.63
桃園市,平鎮區,高雙里,1906,927,979,13,1919,4288,0,44.75,21.62
桃園市,平鎮區,復旦里,2286,1311,975,15,2301,5412,0,42.52,24.22
桃園市,平鎮區,廣興里,2503,1342,1161,27,2530,5467,0,46.28,24.55
桃園市,平鎮區,義民里,2049,1163,886,18,2067,5228,0,39.54,22.25
桃園市,平鎮區,宋屋里,1669,910,759,16,1685,4332,0,38.9,21.01
桃園市,平鎮區,新勢里,1582,846,736,13,1595,3659,0,43.59,23.12
桃園市,平鎮區,新富里,2367,1331,1036,24,2391,6520,0,36.67,20.41
桃園市,平鎮區,北勢里,1160,579,581,10,1170,2424,0,48.27,23.89
桃園市,平鎮區,北興里,1578,799,779,10,1588,3911,0,40.6,20.43
桃園市,平鎮區,北貴里,1700,870,830,13,1713,3974,0,43.11,21.89
桃園市,平鎮區,平鎮里,1666,865,801,22,1688,4457,0,37.87,19.41
桃園市,平鎮區,南勢里,2265,1230,1035,14,2279,5771,0,39.49,21.31
桃園市,平鎮區,莊敬里,1894,1203,691,28,1922,4674,0,41.12,25.74
桃園市,平鎮區,山峰里,907,568,339,8,915,2330,0,39.27,24.38
桃園市,平鎮區,湧光里,2110,1199,911,26,2136,5189,0,41.16,23.11
桃園市,平鎮區,龍恩里,1116,744,372,13,1129,2791,0,40.45,26.66
桃園市,平鎮區,東社里,1301,860,441,15,1316,3322,0,39.61,25.89
桃園市,平鎮區,龍興里,1067,779,288,15,1082,2548,0,42.46,30.57
桃園市,平鎮區,貿易里,922,645,277,6,928,1945,0,47.71,33.16
桃園市,平鎮區,忠貞里,602,444,158,3,605,1318,0,45.9,33.69
桃園市,平鎮區,中正里,705,540,165,9,714,1650,0,43.27,32.73
桃園市,平鎮區,建安里,1721,884,837,16,1737,4292,0,40.47,20.6
桃園市,平鎮區,東勢里,2062,991,1071,13,2075,5410,0,38.35,18.32
桃園市,平鎮區,東安里,1012,662,350,11,1023,2812,0,36.38,23.54
桃園市,平鎮區,新安里,1595,965,630,21,1616,4358,0,37.08,22.14
桃園市,平鎮區,鎮興里,1201,573,628,14,1215,3084,0,39.4,18.58
桃園市,平鎮區,義興里,2956,1537,1419,19,2975,6850,0,43.43,22.44
桃園市,平鎮區,湧豐里,712,392,320,8,720,1755,0,41.03,22.34
桃園市,平鎮區,湧安里,1541,915,626,15,1556,4511,0,34.49,20.28
桃園市,平鎮區,廣達里,1701,815,886,18,1719,3871,0,44.41,21.05
桃園市,平鎮區,福林里,1437,766,671,12,1449,3429,0,42.26,22.34
桃園市,平鎮區,金星里,2436,1426,1010,24,2460,6586,0,37.35,21.65
桃園市,平鎮區,廣仁里,1533,812,721,8,1541,4222,0,36.5,19.23
桃園市,平鎮區,新貴里,1366,681,685,14,1380,3064,0,45.04,22.23
桃園市,平鎮區,北富里,1662,853,809,20,1682,3878,0,43.37,22.0
桃園市,平鎮區,新榮里,2244,1233,1011,24,2268,5110,0,44.38,24.13
桃園市,平鎮區,華安里,1513,977,536,23,1536,4282,0,35.87,22.82
桃園市,平鎮區,金陵里,1266,724,542,9,1275,2823,0,45.16,25.65
桃園市,平鎮區,北安里,733,335,398,3,736,1551,0,47.45,21.6
桃園市,平鎮區,北華里,1727,1027,700,9,1736,3758,0,46.19,27.33
桃園市,平鎮區,復興里,2192,1171,1021,25,2217,4904,0,45.21,23.88
桃園市,平鎮區,平興里,2181,1214,967,16,2197,5498,0,39.96,22.08
桃園市,平鎮區,新英里,1599,991,608,14,1613,3806,0,42.38,26.04
桃園市,平鎮區,平安里,2022,1082,940,25,2047,5085,0,40.26,21.28
桃園市,平鎮區,平南里,2619,1463,1156,22,2641,6707,0,39.38,21.81
桃園市,平鎮區,合計,76194,42622,33572,717,76911,187597,228672,41.0,22.72
桃園市,新屋區,新屋里,1135,574,561,13,1148,2883,0,39.82,19.91
桃園市,新屋區,新生里,1559,831,728,12,1571,3991,0,39.36,20.82
桃園市,新屋區,後湖里,537,274,263,6,543,1517,0,35.79,18.06
桃園市,新屋區,清華里,1451,743,708,9,1460,4096,0,35.64,18.14
桃園市,新屋區,頭洲里,1721,835,886,15,1736,4467,0,38.86,18.69
桃園市,新屋區,埔頂里,885,454,431,6,891,2563,0,34.76,17.71
桃園市,新屋區,九斗里,888,393,495,11,899,2292,0,39.22,17.15
桃園市,新屋區,社子里,536,230,306,4,540,1356,0,39.82,16.96
桃園市,新屋區,東明里,570,272,298,7,577,1466,0,39.36,18.55
桃園市,新屋區,石磊里,809,352,457,16,825,2076,0,39.74,16.96
桃園市,新屋區,下埔里,309,146,163,1,310,730,0,42.47,20.0
桃園市,新屋區,下田里,629,298,331,6,635,1727,0,36.77,17.26
桃園市,新屋區,石牌里,382,202,180,6,388,926,0,41.9,21.81
桃園市,新屋區,赤欄里,493,237,256,7,500,1310,0,38.17,18.09
桃園市,新屋區,永興里,416,186,230,6,422,1021,0,41.33,18.22
桃園市,新屋區,永安里,899,438,461,11,910,2201,0,41.34,19.9
桃園市,新屋區,笨港里,411,208,203,6,417,1020,0,40.88,20.39
桃園市,新屋區,深圳里,245,120,125,0,245,639,0,38.34,18.78
桃園市,新屋區,蚵間里,334,117,217,4,338,900,0,37.56,13.0
桃園市,新屋區,槺榔里,413,175,238,6,419,1072,0,39.09,16.32
桃園市,新屋區,後庄里,452,224,228,3,455,1098,0,41.44,20.4
桃園市,新屋區,大坡里,480,190,290,1,481,1294,0,37.17,14.68
桃園市,新屋區,望間里,514,224,290,3,517,1391,0,37.17,16.1
桃園市,新屋區,合計,16068,7723,8345,159,16227,42036,49237,38.6,18.37
桃園市,觀音區,觀音里,994,477,517,9,1003,2767,0,36.25,17.24
桃園市,觀音區,白玉里,371,97,274,4,375,875,0,42.86,11.09
桃園市,觀音區,廣興里,483,235,248,8,491,1310,0,37.48,17.94
桃園市,觀音區,大潭里,798,340,458,14,812,1899,0,42.76,17.9
桃園市,觀音區,武威里,375,168,207,5,380,912,0,41.67,18.42
桃園市,觀音區,保生里,813,365,448,9,822,2180,0,37.71,16.74
桃園市,觀音區,三和里,373,179,194,2,375,854,0,43.91,20.96
桃園市,觀音區,新興里,297,136,161,3,300,705,0,42.55,19.29
桃園市,觀音區,坑尾里,606,270,336,5,611,1831,0,33.37,14.75
桃園市,觀音區,金湖里,927,395,532,8,935,2633,0,35.51,15.0
桃園市,觀音區,藍埔里,1046,432,614,6,1052,2621,0,40.14,16.48
桃園市,觀音區,大同里,1191,451,740,18,1209,3116,0,38.8,14.47
桃園市,觀音區,大堀里,543,208,335,5,548,1484,0,36.93,14.02
桃園市,觀音區,崙坪里,1921,734,1187,6,1927,4757,0,40.51,15.43
桃園市,觀音區,富源里,1480,739,741,11,1491,3918,0,38.06,18.86
桃園市,觀音區,上大里,970,423,547,12,982,2458,0,39.95,17.21
桃園市,觀音區,新坡里,1132,451,681,6,1138,2971,0,38.3,15.18
桃園市,觀音區,廣福里,921,356,565,9,930,2482,0,37.47,14.34
桃園市,觀音區,塔腳里,340,140,200,5,345,1021,0,33.79,13.71
桃園市,觀音區,保障里,775,246,529,8,783,1950,0,40.15,12.62
桃園市,觀音區,草漯里,979,396,583,14,993,2935,0,33.83,13.49
桃園市,觀音區,樹林里,1235,579,656,19,1254,4468,0,28.07,12.96
桃園市,觀音區,富林里,650,285,365,8,658,1926,0,34.16,14.8
桃園市,觀音區,草新里,1883,894,989,19,1902,5720,0,33.25,15.63
桃園市,觀音區,合計,21103,8996,12107,213,21316,57793,69326,36.88,15.57
桃園市,復興區,三民里,668,354,314,13,681,2041,0,33.37,17.34
桃園市,復興區,澤仁里,434,308,126,5,439,1426,0,30.79,21.6
桃園市,復興區,義盛里,218,183,35,5,223,745,0,29.93,24.56
桃園市,復興區,霞雲里,165,135,30,0,165,631,0,26.15,21.39
桃園市,復興區,長興里,157,116,41,3,160,660,0,24.24,17.58
桃園市,復興區,三光里,127,112,15,3,130,683,0,19.03,16.4
桃園市,復興區,奎輝里,203,164,39,3,206,764,0,26.96,21.47
桃園市,復興區,華陵里,289,165,124,1,290,1265,0,22.92,13.04
桃園市,復興區,羅浮里,334,246,88,3,337,1067,0,31.58,23.06
桃園市,復興區,高義里,123,92,31,0,123,754,0,16.31,12.2
桃園市,復興區,合計,2718,1875,843,36,2754,10036,12391,27.44,18.68
桃園市,合計,合計,741385,393423,347962,6793,748178,1869908,2272459,40.01,21.04
臺中市,中區,繼光里,645,268,377,1,646,1436,0,44.99,18.66
臺中市,中區,大墩里,826,390,436,2,828,1946,0,42.55,20.04
臺中市,中區,綠川里,680,303,377,7,687,1572,0,43.7,19.27
臺中市,中區,公園里,574,267,307,9,583,1353,0,43.09,19.73
臺中市,中區,光復里,847,409,438,5,852,1913,0,44.54,21.38
臺中市,中區,柳川里,704,334,370,10,714,1884,0,37.9,17.73
臺中市,中區,大誠里,992,444,548,11,1003,2244,0,44.7,19.79
臺中市,中區,中華里,760,383,377,8,768,1847,0,41.58,20.74
臺中市,中區,合計,6028,2798,3230,53,6081,14195,17930,42.84,19.71
臺中市,東區,新庄里,1170,508,662,6,1176,2974,0,39.54,17.08
臺中市,東區,振興里,1419,589,830,24,1443,3053,0,47.26,19.29
臺中市,東區,東橋里,1698,638,1060,18,1716,3732,0,45.98,17.1
臺中市,東區,東興里,1244,534,710,14,1258,2791,0,45.07,19.13
臺中市,東區,干城里,910,435,475,12,922,1889,0,48.81,23.03
臺中市,東區,泉源里,928,406,522,8,936,2030,0,46.11,20.0
臺中市,東區,旱溪里,1179,520,659,10,1189,2499,0,47.58,20.81
臺中市,東區,樂成里,966,410,556,8,974,2244,0,43.4,18.27
臺中市,東區,東門里,3033,1253,1780,30,3063,6693,0,45.76,18.72
臺中市,東區,十甲里,2086,989,1097,19,2105,4732,0,44.48,20.9
臺中市,東區,東南里,1648,880,768,12,1660,3682,0,45.08,23.9
臺中市,東區,東勢里,1077,560,517,12,1089,2651,0,41.08,21.12
臺中市,東區,合作里,1675,1066,609,14,1689,3985,0,42.38,26.75
臺中市,東區,富台里,760,511,249,7,767,1703,0,45.04,30.01
臺中市,東區,富仁里,1837,1253,584,21,1858,4044,0,45.94,30.98
臺中市,東區,東信里,3988,1759,2229,48,4036,8763,0,46.06,20.07
臺中市,東區,東英里,3201,1463,1738,27,3228,7152,0,45.13,20.46
臺中市,東區,合計,28819,13774,15045,290,29109,64617,75468,45.05,21.32
臺中市,南區,城隍里,1607,742,865,12,1619,3502,0,46.23,21.19
臺中市,南區,國光里,1676,736,940,19,1695,3745,0,45.26,19.65
臺中市,南區,南門里,1629,762,867,11,1640,3412,0,48.07,22.33
臺中市,南區,德義里,1347,684,663,15,1362,2840,0,47.96,24.08
臺中市,南區,積善里,1149,511,638,9,1158,2506,0,46.21,20.39
臺中市,南區,江川里,1325,657,668,17,1342,2714,0,49.45,24.21
臺中市,南區,新榮里,1902,1015,887,13,1915,4415,0,43.37,22.99
臺中市,南區,福興里,1822,911,911,9,1831,3817,0,47.97,23.87
臺中市,南區,福平里,2316,1123,1193,17,2333,5297,0,44.04,21.2
臺中市,南區,和平里,1555,770,785,13,1568,4091,0,38.33,18.82
臺中市,南區,永興里,3510,1854,1656,29,3539,7871,0,44.96,23.55
臺中市,南區,樹義里,5046,2509,2537,41,5087,11718,0,43.41,21.41
臺中市,南區,樹德里,3748,1993,1755,40,3788,8372,0,45.25,23.81
臺中市,南區,西川里,1908,997,911,15,1923,4215,0,45.62,23.65
臺中市,南區,長春里,894,419,475,11,905,1865,0,48.53,22.47
臺中市,南區,長榮里,1159,553,606,15,1174,2394,0,49.04,23.1
臺中市,南區,福順里,2414,1217,1197,22,2436,5566,0,43.77,21.86
臺中市,南區,平和里,1506,694,812,16,1522,3459,0,44.0,20.06
臺中市,南區,南和里,2985,1613,1372,20,3005,7374,0,40.75,21.87
臺中市,南區,永和里,1953,970,983,10,1963,4610,0,42.58,21.04
臺中市,南區,工學里,2850,1492,1358,15,2865,6608,0,43.36,22.58
臺中市,南區,崇倫里,2443,1188,1255,22,2465,5361,0,45.98,22.16
臺中市,南區,合計,46744,23410,23334,391,47135,105752,126574,44.57,22.14
臺中市,西區,民生里,800,405,395,6,806,1694,0,47.58,23.91
臺中市,西區,利民里,622,362,260,8,630,1340,0,47.01,27.01
臺中市,西區,三民里,806,419,387,0,806,2306,0,34.95,18.17
臺中市,西區,東昇里,1099,561,538,8,1107,2250,0,49.2,24.93
臺中市,西區,廣民里,607,294,313,6,613,1370,0,44.74,21.46
臺中市,西區,平和里,807,432,375,4,811,1840,0,44.08,23.48
臺中市,西區,公民里,2248,1071,1177,19,2267,4767,0,47.56,22.47
臺中市,西區,藍興里,1842,936,906,24,1866,3884,0,48.04,24.1
臺中市,西區,公舘里,2514,1194,1320,19,2533,5582,0,45.38,21.39
臺中市,西區,和龍里,984,433,551,13,997,2244,0,44.43,19.3
臺中市,西區,民龍里,1509,810,699,17,1526,3397,0,44.92,23.84
臺中市,西區,後龍里,1486,701,785,14,1500,3447,0,43.52,20.34
臺中市,西區,安龍里,1370,667,703,14,1384,2776,0,49.86,24.03
臺中市,西區,吉龍里,2963,1534,1429,19,2982,6405,0,46.56,23.95
臺中市,西區,昇平里,2507,1180,1327,19,2526,5634,0,44.83,20.94
臺中市,西區,忠明里,2677,1263,1414,22,2699,5653,0,47.74,22.34
臺中市,西區,公正里,2914,1460,1454,28,2942,6172,0,47.67,23.66
臺中市,西區,土庫里,2566,1197,1369,24,2590,5619,0,46.09,21.3
臺中市,西區,忠誠里,2476,1173,1303,21,2497,5548,0,45.01,21.14
臺中市,西區,公益里,1262,557,705,14,1276,2725,0,46.83,20.44
臺中市,西區,中興里,1711,739,972,16,1727,3518,0,49.09,21.01
臺中市,西區,公平里,2119,1119,1000,14,2133,4905,0,43.49,22.81
臺中市,西區,公德里,1865,946,919,19,1884,4170,0,45.18,22.69
臺中市,西區,双龍里,1240,645,595,10,1250,2712,0,46.09,23.78
臺中市,西區,大忠里,2125,1096,1029,18,2143,4315,0,49.66,25.4
臺中市,西區,合計,43119,21194,21925,376,43495,94273,113744,46.14,22.48
臺中市,北區,光大里,838,390,448,14,852,2049,0,41.58,19.03
臺中市,北區,文莊里,1615,1013,602,23,1638,3331,0,49.17,30.41
臺中市,北區,五常里,563,231,332,6,569,1343,0,42.37,17.2
臺中市,北區,新興里,614,357,257,7,621,1453,0,42.74,24.57
臺中市,北區,新北里,774,371,403,7,781,1655,0,47.19,22.42
臺中市,北區,樂英里,1150,892,258,12,1162,2490,0,46.67,35.82
臺中市,北區,錦村里,1504,780,724,10,1514,3071,0,49.3,25.4
臺中市,北區,建成里,2294,1136,1158,20,2314,5570,0,41.54,20.39
臺中市,北區,錦洲里,1452,822,630,16,1468,3236,0,45.36,25.4
臺中市,北區,金華里,1174,652,522,9,1183,2501,0,47.3,26.07
臺中市,北區,金龍里,1847,964,883,12,1859,4247,0,43.77,22.7
臺中市,北區,邱厝里,991,507,484,9,1000,2256,0,44.33,22.47
臺中市,北區,建興里,2459,1190,1269,14,2473,5454,0,45.34,21.82
臺中市,北區,頂厝里,1860,986,874,23,1883,4109,0,45.83,24.0
臺中市,北區,賴厝里,1712,966,746,12,1724,5017,0,34.36,19.25
臺中市,北區,賴村里,1923,884,1039,17,1940,4300,0,45.12,20.56
臺中市,北區,育德里,1657,847,810,10,1667,3585,0,46.5,23.63
臺中市,北區,淡溝里,2260,1122,1138,19,2279,5018,0,45.42,22.36
臺中市,北區,中達里,1138,577,561,11,1149,2573,0,44.66,22.43
臺中市,北區,錦祥里,1964,1089,875,14,1978,4459,0,44.36,24.42
臺中市,北區,健行里,3057,1412,1645,26,3083,6438,0,47.89,21.93
臺中市,北區,明德里,2314,1171,1143,22,2336,5217,0,44.78,22.45
臺中市,北區,長青里,2565,1269,1296,24,2589,5993,0,43.2,21.17
臺中市,北區,賴明里,1574,867,707,13,1587,3763,0,42.17,23.04
臺中市,北區,賴興里,1643,941,702,12,1655,3730,0,44.37,25.23
臺中市,北區,中正里,574,224,350,4,578,1309,0,44.16,17.11
臺中市,北區,六合里,675,258,417,4,679,1727,0,39.32,14.94
臺中市,北區,大湖里,818,325,493,8,826,2153,0,38.37,15.1
臺中市,北區,錦平里,778,361,417,5,783,1840,0,42.55,19.62
臺中市,北區,建德里,1558,820,738,15,1573,3229,0,48.71,25.39
臺中市,北區,崇德里,1449,735,714,6,1455,3417,0,42.58,21.51
臺中市,北區,賴旺里,1657,875,782,9,1666,4259,0,39.12,20.54
臺中市,北區,明新里,1157,623,534,21,1178,2661,0,44.27,23.41
臺中市,北區,立人里,1552,852,700,11,1563,3755,0,41.62,22.69
臺中市,北區,梅川里,1395,731,664,11,1406,3190,0,44.08,22.92
臺中市,北區,賴福里,1839,965,874,11,1850,3762,0,49.18,25.65
臺中市,北區,合計,54394,28205,26189,467,54861,124160,145438,44.19,22.72
臺中市,西屯區,西安里,2256,1143,1113,21,2277,5165,0,44.09,22.13
臺中市,西屯區,西墩里,2430,1171,1259,18,2448,5884,0,41.6,19.9
臺中市,西屯區,潮洋里,2272,1126,1146,24,2296,6268,0,36.63,17.96
臺中市,西屯區,龍潭里,408,158,250,8,416,833,0,49.94,18.97
臺中市,西屯區,惠來里,6210,3281,2929,53,6263,14638,0,42.79,22.41
臺中市,西屯區,上石里,1972,1056,916,21,1993,5016,0,39.73,21.05
臺中市,西屯區,逢甲里,1752,933,819,9,1761,4314,0,40.82,21.63
臺中市,西屯區,鵬程里,1240,1061,179,17,1257,2619,0,48.0,40.51
臺中市,西屯區,何安里,2191,1071,1120,25,2216,5075,0,43.67,21.1
臺中市,西屯區,何厝里,1353,631,722,8,1361,3200,0,42.53,19.72
臺中市,西屯區,大河里,1795,769,1026,19,1814,3726,0,48.68,20.64
臺中市,西屯區,大石里,1020,868,152,21,1041,2082,0,50.0,41.69
臺中市,西屯區,大福里,1361,781,580,12,1373,3255,0,42.18,23.99
臺中市,西屯區,大鵬里,1994,1118,876,13,2007,4745,0,42.3,23.56
臺中市,西屯區,港尾里,2124,1025,1099,18,2142,4944,0,43.33,20.73
臺中市,西屯區,廣福里,1045,439,606,8,1053,2324,0,45.31,18.89
臺中市,西屯區,林厝里,1428,760,668,14,1442,3398,0,42.44,22.37
臺中市,西屯區,永安里,4984,2657,2327,47,5031,12696,0,39.63,20.93
臺中市,西屯區,福安里,1349,700,649,14,1363,2940,0,46.36,23.81
臺中市,西屯區,協和里,1931,892,1039,18,1949,4642,0,41.99,19.22
臺中市,西屯區,何仁里,2654,1303,1351,22,2676,6083,0,43.99,21.42
臺中市,西屯區,何德里,1566,784,782,19,1585,3633,0,43.63,21.58
臺中市,西屯區,何源里,2865,1539,1326,29,2894,6639,0,43.59,23.18
臺中市,西屯區,西平里,1965,1197,768,14,1979,4807,0,41.17,24.9
臺中市,西屯區,何南里,1964,1048,916,17,1981,4097,0,48.35,25.58
臺中市,西屯區,至善里,1896,1011,885,31,1927,4381,0,43.99,23.08
臺中市,西屯區,上安里,2299,1210,1089,25,2324,5223,0,44.5,23.17
臺中市,西屯區,上德里,1867,1046,821,19,1886,4120,0,45.78,25.39
臺中市,西屯區,逢福里,2434,1344,1090,16,2450,5257,0,46.6,25.57
臺中市,西屯區,何明里,1688,833,855,10,1698,3558,0,47.72,23.41
臺中市,西屯區,何成里,3064,1538,1526,26,3090,7080,0,43.64,21.72
臺中市,西屯區,何福里,1959,943,1016,15,1974,4322,0,45.67,21.82
臺中市,西屯區,福和里,1759,737,1022,19,1778,4278,0,41.56,17.23
臺中市,西屯區,福中里,1378,702,676,11,1389,3203,0,43.37,21.92
臺中市,西屯區,福恩里,2241,1250,991,28,2269,4778,0,47.49,26.16
臺中市,西屯區,福聯里,1111,616,495,19,1130,3166,0,35.69,19.46
臺中市,西屯區,福瑞里,1116,666,450,13,1129,2980,0,37.89,22.35
臺中市,西屯區,福林里,3358,1857,1501,38,3396,7655,0,44.36,24.26
臺中市,西屯區,福雅里,2464,1347,1117,16,2480,5769,0,42.99,23.35
臺中市,西屯區,合計,80763,42611,38152,775,81538,188793,231415,43.19,22.57
臺中市,南屯區,南屯里,3790,1871,1919,41,3831,8528,0,44.92,21.94
臺中市,南屯區,豐樂里,5222,2572,2650,44,5266,11358,0,46.36,22.64
臺中市,南屯區,楓樹里,2807,1309,1498,26,2833,5891,0,48.09,22.22
臺中市,南屯區,中和里,1857,774,1083,19,1876,4324,0,43.39,17.9
臺中市,南屯區,春社里,2463,1318,1145,22,2485,6534,0,38.03,20.17
臺中市,南屯區,春安里,490,260,230,7,497,1366,0,36.38,19.03
臺中市,南屯區,文山里,4270,2059,2211,37,4307,11272,0,38.21,18.27
臺中市,南屯區,新生里,913,437,476,6,919,2301,0,39.94,18.99
臺中市,南屯區,永定里,2137,943,1194,19,2156,5105,0,42.23,18.47
臺中市,南屯區,三厝里,2978,1547,1431,34,3012,7137,0,42.2,21.68
臺中市,南屯區,溝墘里,2627,1348,1279,22,2649,5220,0,50.75,25.82
臺中市,南屯區,田心里,2758,1308,1450,29,2787,6268,0,44.46,20.87
臺中市,南屯區,黎明里,1953,1167,786,17,1970,4151,0,47.46,28.11
臺中市,南屯區,鎮平里,580,213,367,9,589,1357,0,43.4,15.7
臺中市,南屯區,大同里,2274,1088,1186,12,2286,4877,0,46.87,22.31
臺中市,南屯區,文心里,1723,888,835,24,1747,3803,0,45.94,23.35
臺中市,南屯區,同心里,2237,1156,1081,29,2266,5223,0,43.39,22.13
臺中市,南屯區,向心里,2155,1084,1071,27,2182,5433,0,40.16,19.95
臺中市,南屯區,大誠里,1644,827,817,11,1655,3609,0,45.86,22.91
臺中市,南屯區,大興里,1991,955,1036,20,2011,4436,0,45.33,21.53
臺中市,南屯區,大業里,3023,1538,1485,14,3037,6517,0,46.6,23.6
臺中市,南屯區,惠中里,3381,1767,1614,27,3408,7565,0,45.05,23.36
臺中市,南屯區,寶山里,2061,1017,1044,13,2074,5266,0,39.38,19.31
臺中市,南屯區,三和里,3784,2142,1642,37,3821,8478,0,45.07,25.27
臺中市,南屯區,三義里,2907,1617,1290,20,2927,6493,0,45.08,24.9
臺中市,南屯區,合計,62025,31205,30820,566,62591,142512,176754,43.92,21.9
臺中市,北屯區,北興里,1430,763,667,11,1441,3133,0,45.99,24.35
臺中市,北屯區,北屯里,1477,821,656,4,1481,3392,0,43.66,24.2
臺中市,北屯區,三光里,3042,1681,1361,26,3068,6954,0,44.12,24.17
臺中市,北屯區,平田里,2393,1276,1117,24,2417,5705,0,42.37,22.37
臺中市,北屯區,平和里,2095,1170,925,11,2106,5097,0,41.32,22.95
臺中市,北屯區,東光里,1945,1012,933,15,1960,4595,0,42.66,22.02
臺中市,北屯區,舊社里,2928,1483,1445,24,2952,7211,0,40.94,20.57
臺中市,北屯區,水景里,5911,2942,2969,40,5951,13462,0,44.21,21.85
臺中市,北屯區,軍功里,5435,2629,2806,60,5495,12347,0,44.5,21.29
臺中市,北屯區,和平里,4746,2347,2399,35,4781,11410,0,41.9,20.57
臺中市,北屯區,東山里,922,375,547,7,929,2030,0,45.76,18.47
臺中市,北屯區,民政里,374,174,200,3,377,1008,0,37.4,17.26
臺中市,北屯區,廍子里,5445,2885,2560,47,5492,14177,0,38.74,20.35
臺中市,北屯區,大坑里,890,434,456,28,918,2160,0,42.5,20.09
臺中市,北屯區,民德里,356,170,186,3,359,905,0,39.67,18.78
臺中市,北屯區,松竹里,3872,2145,1727,29,3901,8784,0,44.41,24.42
臺中市,北屯區,仁和里,3502,1846,1656,31,3533,9231,0,38.27,20.0
臺中市,北屯區,仁美里,4000,2043,1957,17,4017,9374,0,42.85,21.79
臺中市,北屯區,四民里,690,347,343,7,697,1525,0,45.7,22.75
臺中市,北屯區,后庄里,4316,2566,1750,41,4357,9850,0,44.23,26.05
臺中市,北屯區,同榮里,2407,1281,1126,18,2425,5327,0,45.52,24.05
臺中市,北屯區,仁愛里,479,273,206,3,482,1046,0,46.08,26.1
臺中市,北屯區,水湳里,2965,1547,1418,37,3002,6614,0,45.39,23.39
臺中市,北屯區,陳平里,1930,1104,826,14,1944,4564,0,42.59,24.19
臺中市,北屯區,新平里,1742,1023,719,16,1758,4248,0,41.38,24.08
臺中市,北屯區,平安里,2360,1181,1179,17,2377,5130,0,46.34,23.02
臺中市,北屯區,平順里,1395,707,688,9,1404,3146,0,44.63,22.47
臺中市,北屯區,平德里,2616,1385,1231,11,2627,6176,0,42.54,22.43
臺中市,北屯區,松安里,2058,1045,1013,21,2079,4780,0,43.49,21.86
臺中市,北屯區,松茂里,2252,1290,962,18,2270,5241,0,43.31,24.61
臺中市,北屯區,大德里,2257,1306,951,21,2278,4863,0,46.84,26.86
臺中市,北屯區,松強里,2722,1416,1306,18,2740,6705,0,40.87,21.12
臺中市,北屯區,松勇里,2247,1228,1019,25,2272,5153,0,44.09,23.83
臺中市,北屯區,北京里,1450,703,747,17,1467,3180,0,46.13,22.11
臺中市,北屯區,平心里,2008,1079,929,19,2027,4765,0,42.54,22.64
臺中市,北屯區,平福里,1595,893,702,20,1615,3560,0,45.37,25.08
臺中市,北屯區,松和里,2474,1318,1156,20,2494,6410,0,38.91,20.56
臺中市,北屯區,平陽里,2068,1122,946,14,2082,4887,0,42.6,22.96
臺中市,北屯區,平興里,2722,1439,1283,24,2746,6741,0,40.74,21.35
臺中市,北屯區,平昌里,1879,978,901,11,1890,4376,0,43.19,22.35
臺中市,北屯區,三和里,2479,1393,1086,24,2503,5662,0,44.21,24.6
臺中市,北屯區,忠平里,1702,1021,681,15,1717,3906,0,43.96,26.14
臺中市,北屯區,合計,101576,53841,47735,855,102431,238830,289830,42.89,22.54
臺中市,豐原區,豐原里,986,530,456,13,999,2243,0,44.54,23.63
臺中市,豐原區,頂街里,421,166,255,2,423,919,0,46.03,18.06
臺中市,豐原區,中山里,404,177,227,2,406,795,0,51.07,22.26
臺中市,豐原區,豐榮里,514,213,301,7,521,1106,0,47.11,19.26
臺中市,豐原區,下街里,297,135,162,4,301,744,0,40.46,18.15
臺中市,豐原區,富春里,384,157,227,4,388,720,0,53.89,21.81
臺中市,豐原區,葫蘆里,301,124,177,3,304,607,0,50.08,20.43
臺中市,豐原區,豐西里,758,363,395,2,760,1595,0,47.65,22.76
臺中市,豐原區,西安里,2179,1024,1155,16,2195,4781,0,45.91,21.42
臺中市,豐原區,西勢里,1045,476,569,11,1056,2152,0,49.07,22.12
臺中市,豐原區,東勢里,663,295,368,7,670,1433,0,46.76,20.59
臺中市,豐原區,民生里,469,181,288,3,472,1119,0,42.18,16.18
臺中市,豐原區,大湳里,1098,494,604,7,1105,2494,0,44.31,19.81
臺中市,豐原區,北湳里,1286,667,619,13,1299,2882,0,45.07,23.14
臺中市,豐原區,東湳里,1663,641,1022,13,1676,3976,0,42.15,16.12
臺中市,豐原區,西湳里,3824,1666,2158,51,3875,9125,0,42.47,18.26
臺中市,豐原區,圳寮里,592,252,340,8,600,1231,0,48.74,20.47
臺中市,豐原區,豐圳里,1494,731,763,14,1508,3367,0,44.79,21.71
臺中市,豐原區,社皮里,3887,1860,2027,38,3925,9864,0,39.79,18.86
臺中市,豐原區,三村里,2790,1284,1506,27,2817,6283,0,44.84,20.44
臺中市,豐原區,中興里,1238,699,539,12,1250,2877,0,43.45,24.3
臺中市,豐原區,田心里,2486,1177,1309,24,2510,6296,0,39.87,18.69
臺中市,豐原區,豐田里,4256,1889,2367,36,4292,10193,0,42.11,18.53
臺中市,豐原區,鎌村里,2001,905,1096,22,2023,4633,0,43.67,19.53
臺中市,豐原區,南陽里,4401,2134,2267,24,4425,10538,0,41.99,20.25
臺中市,豐原區,陽明里,1164,567,597,11,1175,2631,0,44.66,21.55
臺中市,豐原區,北陽里,5438,2611,2827,45,5483,12989,0,42.21,20.1
臺中市,豐原區,中陽里,2258,1092,1166,18,2276,5045,0,45.11,21.65
臺中市,豐原區,東陽里,727,297,430,10,737,1574,0,46.82,18.87
臺中市,豐原區,南村里,2320,1014,1306,22,2342,5234,0,44.75,19.37
臺中市,豐原區,南田里,1389,578,811,19,1408,3175,0,44.35,18.2
臺中市,豐原區,南嵩里,1437,607,830,20,1457,3377,0,43.14,17.97
臺中市,豐原區,翁明里,980,484,496,6,986,2265,0,43.53,21.37
臺中市,豐原區,翁子里,1329,637,692,13,1342,3221,0,41.66,19.78
臺中市,豐原區,翁社里,951,399,552,14,965,2049,0,47.1,19.47
臺中市,豐原區,朴子里,1355,524,831,14,1369,3287,0,41.65,15.94
臺中市,豐原區,合計,58785,27050,31735,555,59340,136820,165529,43.37,19.77
臺中市,東勢區,北興里,490,318,172,10,500,1297,0,38.55,24.52
臺中市,東勢區,中寧里,365,236,129,6,371,833,0,44.54,28.33
臺中市,東勢區,東安里,431,255,176,2,433,996,0,43.47,25.6
臺中市,東勢區,南平里,808,540,268,4,812,1754,0,46.29,30.79
臺中市,東勢區,延平里,909,511,398,8,917,2138,0,42.89,23.9
臺中市,東勢區,上新里,424,265,159,1,425,951,0,44.69,27.87
臺中市,東勢區,廣興里,571,346,225,8,579,1403,0,41.27,24.66
臺中市,東勢區,泰昌里,1445,904,541,16,1461,3402,0,42.95,26.57
臺中市,東勢區,中嵙里,667,394,273,11,678,1835,0,36.95,21.47
臺中市,東勢區,福隆里,1459,848,611,22,1481,3709,0,39.93,22.86
臺中市,東勢區,隆興里,487,279,208,4,491,1418,0,34.63,19.68
臺中市,東勢區,新盛里,1891,1009,882,17,1908,4812,0,39.65,20.97
臺中市,東勢區,詒福里,665,324,341,13,678,1616,0,41.96,20.05
臺中市,東勢區,上城里,429,234,195,8,437,963,0,45.38,24.3
臺中市,東勢區,下城里,363,184,179,9,372,832,0,44.71,22.12
臺中市,東勢區,慶東里,691,313,378,20,711,1825,0,38.96,17.15
臺中市,東勢區,慶福里,371,204,167,9,380,1233,0,30.82,16.55
臺中市,東勢區,東新里,857,520,337,9,866,1954,0,44.32,26.61
臺中市,東勢區,粵寧里,836,453,383,15,851,2023,0,42.07,22.39
臺中市,東勢區,下新里,650,343,307,17,667,1651,0,40.4,20.78
臺中市,東勢區,興隆里,457,202,255,3,460,1172,0,39.25,17.24
臺中市,東勢區,茂興里,621,352,269,6,627,1817,0,34.51,19.37
臺中市,東勢區,泰興里,227,120,107,1,228,701,0,32.52,17.12
臺中市,東勢區,埤頭里,283,109,174,8,291,657,0,44.29,16.59
臺中市,東勢區,明正里,457,208,249,13,470,1365,0,34.43,15.24
臺中市,東勢區,合計,16854,9471,7383,240,17094,42357,48747,40.36,22.36
臺中市,大甲區,朝陽里,574,259,315,8,582,1331,0,43.73,19.46
臺中市,大甲區,大甲里,429,192,237,9,438,991,0,44.2,19.37
臺中市,大甲區,順天里,684,319,365,3,687,1532,0,44.84,20.82
臺中市,大甲區,孔門里,288,150,138,2,290,748,0,38.77,20.05
臺中市,大甲區,平安里,788,367,421,8,796,2008,0,39.64,18.28
臺中市,大甲區,庄美里,889,403,486,5,894,2055,0,43.5,19.61
臺中市,大甲區,新美里,1331,675,656,14,1345,3394,0,39.63,19.89
臺中市,大甲區,岷山里,772,376,396,7,779,2042,0,38.15,18.41
臺中市,大甲區,中山里,1716,897,819,20,1736,4515,0,38.45,19.87
臺中市,大甲區,南陽里,326,160,166,5,331,813,0,40.71,19.68
臺中市,大甲區,薰風里,396,177,219,6,402,860,0,46.74,20.58
臺中市,大甲區,義和里,1141,558,583,9,1150,3232,0,35.58,17.26
臺中市,大甲區,武陵里,452,252,200,4,456,1160,0,39.31,21.72
臺中市,大甲區,文曲里,356,131,225,0,356,1073,0,33.18,12.21
臺中市,大甲區,武曲里,700,346,354,5,705,1810,0,38.95,19.12
臺中市,大甲區,文武里,2069,1044,1025,18,2087,5206,0,40.09,20.05
臺中市,大甲區,奉化里,795,433,362,5,800,1996,0,40.08,21.69
臺中市,大甲區,德化里,632,274,358,6,638,1755,0,36.35,15.61
臺中市,大甲區,江南里,466,229,237,2,468,1356,0,34.51,16.89
臺中市,大甲區,頂店里,1672,790,882,17,1689,4450,0,37.96,17.75
臺中市,大甲區,太白里,426,187,239,11,437,1233,0,35.44,15.17
臺中市,大甲區,孟春里,1369,631,738,16,1385,3909,0,35.43,16.14
臺中市,大甲區,幸福里,847,363,484,17,864,2515,0,34.35,14.43
臺中市,大甲區,日南里,1807,864,943,22,1829,5476,0,33.4,15.78
臺中市,大甲區,龍泉里,575,273,302,8,583,1475,0,39.53,18.51
臺中市,大甲區,西岐里,592,294,298,9,601,1649,0,36.45,17.83
臺中市,大甲區,銅安里,432,209,223,9,441,1340,0,32.91,15.6
臺中市,大甲區,福德里,373,195,178,3,376,1111,0,33.84,17.55
臺中市,大甲區,建興里,435,190,245,10,445,1446,0,30.77,13.14
臺中市,大甲區,合計,23332,11238,12094,258,23590,62481,75819,37.76,17.99
臺中市,清水區,鰲峰里,456,209,247,13,469,1063,0,44.12,19.66
臺中市,清水區,靈泉里,466,214,252,0,466,930,0,50.11,23.01
臺中市,清水區,清水里,915,418,497,6,921,2049,0,44.95,20.4
臺中市,清水區,文昌里,308,143,165,6,314,661,0,47.5,21.63
臺中市,清水區,南寧里,763,350,413,4,767,1743,0,44.0,20.08
臺中市,清水區,西寧里,660,274,386,3,663,1553,0,42.69,17.64
臺中市,清水區,北寧里,328,149,179,3,331,673,0,49.18,22.14
臺中市,清水區,中興里,207,89,118,4,211,391,0,53.96,22.76
臺中市,清水區,西社里,955,415,540,11,966,2191,0,44.09,18.94
臺中市,清水區,南社里,4116,1985,2131,27,4143,9925,0,41.74,20.0
臺中市,清水區,裕嘉里,539,239,300,5,544,1448,0,37.57,16.51
臺中市,清水區,臨江里,592,291,301,7,599,1505,0,39.8,19.34
臺中市,清水區,秀水里,1751,867,884,12,1763,4370,0,40.34,19.84
臺中市,清水區,武鹿里,1244,533,711,8,1252,3341,0,37.47,15.95
臺中市,清水區,海濱里,791,338,453,14,805,2104,0,38.26,16.06
臺中市,清水區,槺榔里,2296,1019,1277,18,2314,6655,0,34.77,15.31
臺中市,清水區,中社里,1186,839,347,6,1192,2801,0,42.56,29.95
臺中市,清水區,高西里,397,236,161,5,402,1278,0,31.46,18.47
臺中市,清水區,高南里,447,198,249,4,451,1330,0,33.91,14.89
臺中市,清水區,高東里,412,178,234,7,419,1234,0,33.95,14.42
臺中市,清水區,高北里,335,149,186,2,337,1155,0,29.18,12.9
臺中市,清水區,高美里,446,220,226,6,452,1309,0,34.53,16.81
臺中市,清水區,國姓里,662,229,433,6,668,2039,0,32.76,11.23
臺中市,清水區,菁埔里,893,368,525,11,904,2252,0,40.14,16.34
臺中市,清水區,頂湳里,594,276,318,10,604,1765,0,34.22,15.64
臺中市,清水區,田寮里,806,298,508,12,818,2488,0,32.88,11.98
臺中市,清水區,橋頭里,2939,1257,1682,36,2975,7404,0,40.18,16.98
臺中市,清水區,下湳里,1070,478,592,7,1077,2764,0,38.97,17.29
臺中市,清水區,東山里,423,221,202,8,431,1197,0,36.01,18.46
臺中市,清水區,楊厝里,436,181,255,4,440,1156,0,38.06,15.66
臺中市,清水區,海風里,496,242,254,7,503,1390,0,36.19,17.41
臺中市,清水區,吳厝里,565,261,304,9,574,1465,0,39.18,17.82
臺中市,清水區,合計,28494,13164,15330,281,28775,73629,88227,39.08,17.88
臺中市,沙鹿區,居仁里,607,280,327,4,611,1364,0,44.79,20.53
臺中市,沙鹿區,洛泉里,1028,502,526,7,1035,1976,0,52.38,25.4
臺中市,沙鹿區,沙鹿里,464,185,279,5,469,893,0,52.52,20.72
臺中市,沙鹿區,美仁里,234,114,120,4,238,489,0,48.67,23.31
臺中市,沙鹿區,興仁里,1080,512,568,6,1086,2409,0,45.08,21.25
臺中市,沙鹿區,斗抵里,1981,965,1016,20,2001,4364,0,45.85,22.11
臺中市,沙鹿區,鹿峰里,2326,1047,1279,27,2353,5345,0,44.02,19.59
臺中市,沙鹿區,鹿寮里,3126,1273,1853,26,3152,6799,0,46.36,18.72
臺中市,沙鹿區,竹林里,3074,1597,1477,41,3115,7344,0,42.42,21.75
臺中市,沙鹿區,犁分里,475,211,264,3,478,1089,0,43.89,19.38
臺中市,沙鹿區,北勢里,1868,967,901,19,1887,4904,0,38.48,19.72
臺中市,沙鹿區,福興里,1612,830,782,10,1622,3843,0,42.21,21.6
臺中市,沙鹿區,晉江里,767,361,406,16,783,1748,0,44.79,20.65
臺中市,沙鹿區,六路里,2214,1066,1148,14,2228,5388,0,41.35,19.78
臺中市,沙鹿區,南勢里,1402,744,658,17,1419,3381,0,41.97,22.01
臺中市,沙鹿區,埔子里,2505,1335,1170,28,2533,5682,0,44.58,23.5
臺中市,沙鹿區,公明里,1801,1051,750,22,1823,4396,0,41.47,23.91
臺中市,沙鹿區,清泉里,1016,588,428,14,1030,2331,0,44.19,25.23
臺中市,沙鹿區,西勢里,855,479,376,9,864,2130,0,40.56,22.49
臺中市,沙鹿區,興安里,1446,652,794,18,1464,3365,0,43.51,19.38
臺中市,沙鹿區,三鹿里,3016,1633,1383,33,3049,7321,0,41.65,22.31
臺中市,沙鹿區,合計,32897,16392,16505,343,33240,76561,95562,43.42,21.41
臺中市,梧棲區,頂寮里,1427,676,751,13,1440,3632,0,39.65,18.61
臺中市,梧棲區,下寮里,835,384,451,8,843,1967,0,42.86,19.52
臺中市,梧棲區,中正里,1491,771,720,15,1506,3879,0,38.82,19.88
臺中市,梧棲區,中和里,223,104,119,3,226,484,0,46.69,21.49
臺中市,梧棲區,文化里,487,242,245,7,494,1161,0,42.55,20.84
臺中市,梧棲區,安仁里,331,149,182,1,332,780,0,42.56,19.1
臺中市,梧棲區,草湳里,2413,1173,1240,23,2436,6132,0,39.73,19.13
臺中市,梧棲區,南簡里,1975,866,1109,21,1996,5294,0,37.7,16.36
臺中市,梧棲區,福德里,1754,806,948,15,1769,4953,0,35.72,16.27
臺中市,梧棲區,大庄里,2874,1376,1498,42,2916,7509,0,38.83,18.32
臺中市,梧棲區,大村里,2190,1036,1154,24,2214,5687,0,38.93,18.22
臺中市,梧棲區,興農里,828,379,449,9,837,2322,0,36.05,16.32
臺中市,梧棲區,永寧里,860,378,482,11,871,2298,0,37.9,16.45
臺中市,梧棲區,永安里,927,419,508,9,936,2493,0,37.55,16.81
臺中市,梧棲區,合計,18615,8759,9856,201,18816,48591,59487,38.72,18.03
臺中市,后里區,廣福里,775,516,259,20,795,2076,0,38.29,24.86
臺中市,后里區,仁里里,388,197,191,5,393,1031,0,38.12,19.11
臺中市,后里區,義里里,1187,707,480,17,1204,3086,0,39.01,22.91
臺中市,后里區,后里里,1559,783,776,18,1577,3652,0,43.18,21.44
臺中市,后里區,厚里里,831,408,423,8,839,2136,0,39.28,19.1
臺中市,后里區,墩東里,1921,1005,916,17,1938,4739,0,40.89,21.21
臺中市,后里區,墩西里,764,323,441,3,767,1917,0,40.01,16.85
臺中市,后里區,墩南里,1326,623,703,16,1342,3347,0,40.1,18.61
臺中市,后里區,墩北里,1428,626,802,17,1445,3538,0,40.84,17.69
臺中市,后里區,中和里,935,406,529,16,951,2376,0,40.03,17.09
臺中市,后里區,舊社里,816,409,407,14,830,2187,0,37.95,18.7
臺中市,后里區,聯合里,613,275,338,9,622,1559,0,39.9,17.64
臺中市,后里區,太平里,707,344,363,5,712,2131,0,33.41,16.14
臺中市,后里區,眉山里,1140,574,566,16,1156,3198,0,36.15,17.95
臺中市,后里區,泰安里,519,235,284,7,526,1393,0,37.76,16.87
臺中市,后里區,公館里,734,327,407,16,750,2139,0,35.06,15.29
臺中市,后里區,月眉里,769,306,463,12,781,1956,0,39.93,15.64
臺中市,后里區,義德里,963,563,400,17,980,2591,0,37.82,21.73
臺中市,后里區,合計,17375,8627,8748,233,17608,45052,54126,39.08,19.15
臺中市,神岡區,神岡里,1231,608,623,17,1248,3173,0,39.33,19.16
臺中市,神岡區,庄前里,957,440,517,8,965,2296,0,42.03,19.16
臺中市,神岡區,北庄里,1059,456,603,5,1064,2611,0,40.75,17.46
臺中市,神岡區,庄後里,937,350,587,8,945,2220,0,42.57,15.77
臺中市,神岡區,社口里,2840,1225,1615,18,2858,7481,0,38.2,16.37
臺中市,神岡區,社南里,2093,806,1287,19,2112,5257,0,40.18,15.33
臺中市,神岡區,三角里,1083,415,668,5,1088,2555,0,42.58,16.24
臺中市,神岡區,岸裡里,1183,437,746,14,1197,2845,0,42.07,15.36
臺中市,神岡區,大社里,1682,762,920,15,1697,4465,0,38.01,17.07
臺中市,神岡區,豐洲里,2785,1167,1618,30,2815,7152,0,39.36,16.32
臺中市,神岡區,神洲里,1077,398,679,17,1094,2539,0,43.09,15.68
臺中市,神岡區,溪洲里,1107,478,629,21,1128,2800,0,40.29,17.07
臺中市,神岡區,圳前里,887,426,461,18,905,2268,0,39.9,18.78
臺中市,神岡區,新庄里,1456,563,893,15,1471,4135,0,35.57,13.62
臺中市,神岡區,圳堵里,799,393,406,9,808,2090,0,38.66,18.8
臺中市,神岡區,山皮里,412,152,260,4,416,1016,0,40.94,14.96
臺中市,神岡區,合計,21588,9076,12512,223,21811,54903,65143,39.73,16.53
臺中市,潭子區,潭陽里,4316,2074,2242,36,4352,10990,0,39.6,18.87
臺中市,潭子區,潭秀里,595,230,365,7,602,1262,0,47.7,18.23
臺中市,潭子區,潭北里,1020,524,496,5,1025,2378,0,43.1,22.04
臺中市,潭子區,福仁里,4195,2175,2020,27,4222,10488,0,40.26,20.74
臺中市,潭子區,頭家里,2275,1191,1084,21,2296,5345,0,42.96,22.28
臺中市,潭子區,甘蔗里,3867,1999,1868,27,3894,9332,0,41.73,21.42
臺中市,潭子區,東寶里,5007,2360,2647,51,5058,12018,0,42.09,19.64
臺中市,潭子區,大富里,1219,558,661,9,1228,2801,0,43.84,19.92
臺中市,潭子區,大豐里,2549,1180,1369,27,2576,6066,0,42.47,19.45
臺中市,潭子區,栗林里,2109,887,1222,26,2135,4733,0,45.11,18.74
臺中市,潭子區,嘉仁里,1613,709,904,15,1628,3997,0,40.73,17.74
臺中市,潭子區,新田里,663,252,411,4,667,1536,0,43.42,16.41
臺中市,潭子區,聚興里,1569,734,835,26,1595,4262,0,37.42,17.22
臺中市,潭子區,頭家東里,1764,895,869,10,1774,4319,0,41.07,20.72
臺中市,潭子區,家興里,2890,1536,1354,25,2915,6933,0,42.05,22.15
臺中市,潭子區,家福里,1988,1021,967,23,2011,4575,0,43.96,22.32
臺中市,潭子區,合計,37639,18325,19314,339,37978,91035,109158,41.72,20.13
臺中市,大雅區,大雅里,1785,870,915,18,1803,4325,0,41.69,20.12
臺中市,大雅區,員林里,3621,1699,1922,31,3652,9201,0,39.69,18.47
臺中市,大雅區,六寶里,2396,1305,1091,29,2425,6208,0,39.06,21.02
臺中市,大雅區,秀山里,1340,598,742,16,1356,3353,0,40.44,17.83
臺中市,大雅區,忠義里,1298,950,348,15,1313,3594,0,36.53,26.43
臺中市,大雅區,橫山里,1699,822,877,19,1718,4313,0,39.83,19.06
臺中市,大雅區,三和里,2035,992,1043,29,2064,5252,0,39.3,18.89
臺中市,大雅區,西寶里,1750,813,937,19,1769,4779,0,37.02,17.01
臺中市,大雅區,上楓里,2294,1053,1241,22,2316,6244,0,37.09,16.86
臺中市,大雅區,二和里,2313,1192,1121,17,2330,5915,0,39.39,20.15
臺中市,大雅區,四德里,1926,1008,918,14,1940,4622,0,41.97,21.81
臺中市,大雅區,上雅里,2273,1085,1188,22,2295,6037,0,38.02,17.97
臺中市,大雅區,文雅里,2344,1217,1127,22,2366,6021,0,39.3,20.21
臺中市,大雅區,大楓里,1951,963,988,19,1970,5029,0,39.17,19.15
臺中市,大雅區,雅楓里,1329,681,648,10,1339,3545,0,37.77,19.21
臺中市,大雅區,合計,30354,15248,15106,302,30656,78438,95800,39.08,19.44
臺中市,新社區,新社里,1368,741,627,19,1387,3261,0,42.53,22.72
臺中市,新社區,復盛里,606,338,268,7,613,1835,0,33.41,18.42
臺中市,新社區,中正里,537,275,262,6,543,1342,0,40.46,20.49
臺中市,新社區,月湖里,381,152,229,8,389,986,0,39.45,15.42
臺中市,新社區,崑山里,467,162,305,5,472,1156,0,40.83,14.01
臺中市,新社區,大南里,720,383,337,17,737,1879,0,39.22,20.38
臺中市,新社區,永源里,1157,480,677,21,1178,2983,0,39.49,16.09
臺中市,新社區,中興里,265,203,62,2,267,582,0,45.88,34.88
臺中市,新社區,協成里,1099,495,604,16,1115,2927,0,38.09,16.91
臺中市,新社區,東興里,492,299,193,6,498,1187,0,41.95,25.19
臺中市,新社區,慶西里,318,130,188,8,326,885,0,36.84,14.69
臺中市,新社區,中和里,223,167,56,9,232,575,0,40.35,29.04
臺中市,新社區,福興里,413,227,186,9,422,1112,0,37.95,20.41
臺中市,新社區,合計,8046,4052,3994,133,8179,20710,23859,39.49,19.57
臺中市,石岡區,石岡里,440,229,211,6,446,1210,0,36.86,18.93
臺中市,石岡區,萬安里,641,321,320,15,656,1518,0,43.21,21.15
臺中市,石岡區,九房里,522,271,251,4,526,1204,0,43.69,22.51
臺中市,石岡區,金星里,459,215,244,10,469,1232,0,38.07,17.45
臺中市,石岡區,龍興里,262,130,132,1,263,638,0,41.22,20.38
臺中市,石岡區,萬興里,628,319,309,9,637,1443,0,44.14,22.11
臺中市,石岡區,梅子里,749,404,345,15,764,1794,0,42.59,22.52
臺中市,石岡區,土牛里,417,245,172,3,420,1002,0,41.92,24.45
臺中市,石岡區,德興里,573,337,236,8,581,1408,0,41.26,23.93
臺中市,石岡區,和盛里,528,318,210,5,533,1230,0,43.33,25.85
臺中市,石岡區,合計,5219,2789,2430,76,5295,12679,14532,41.76,22.0
臺中市,外埔區,永豐里,388,213,175,2,390,1099,0,35.49,19.38
臺中市,外埔區,六分里,774,431,343,6,780,2193,0,35.57,19.65
臺中市,外埔區,三崁里,621,324,297,6,627,1887,0,33.23,17.17
臺中市,外埔區,大同里,1761,991,770,20,1781,4680,0,38.06,21.18
臺中市,外埔區,水美里,1256,636,620,13,1269,3392,0,37.41,18.75
臺中市,外埔區,大東里,2334,1231,1103,28,2362,6342,0,37.24,19.41
臺中市,外埔區,馬鳴里,477,238,239,4,481,1384,0,34.75,17.2
臺中市,外埔區,中山里,521,290,231,5,526,1210,0,43.47,23.97
臺中市,外埔區,鐵山里,707,389,318,4,711,2115,0,33.62,18.39
臺中市,外埔區,土城里,594,244,350,5,599,1581,0,37.89,15.43
臺中市,外埔區,廍子里,349,165,184,6,355,1158,0,30.66,14.25
臺中市,外埔區,合計,9782,5152,4630,99,9881,27041,31790,36.54,19.05
臺中市,大安區,南埔里,357,122,235,5,362,1055,0,34.31,11.56
臺中市,大安區,南庄里,355,164,191,2,357,1023,0,34.9,16.03
臺中市,大安區,中庄里,858,387,471,10,868,2624,0,33.08,14.75
臺中市,大安區,龜壳里,521,254,267,7,528,1502,0,35.15,16.91
臺中市,大安區,福興里,396,170,226,4,400,1149,0,34.81,14.8
臺中市,大安區,東安里,448,195,253,2,450,1199,0,37.53,16.26
臺中市,大安區,頂安里,337,164,173,9,346,889,0,38.92,18.45
臺中市,大安區,永安里,560,267,293,10,570,1753,0,32.52,15.23
臺中市,大安區,福住里,335,156,179,3,338,1037,0,32.59,15.04
臺中市,大安區,海墘里,449,243,206,5,454,1385,0,32.78,17.55
臺中市,大安區,西安里,610,309,301,11,621,1738,0,35.73,17.78
臺中市,大安區,松雅里,440,190,250,3,443,966,0,45.86,19.67
臺中市,大安區,合計,5666,2621,3045,71,5737,16320,18688,35.15,16.06
臺中市,烏日區,烏日里,4118,1946,2172,43,4161,8638,0,48.17,22.53
臺中市,烏日區,湖日里,1150,523,627,15,1165,2486,0,46.86,21.04
臺中市,烏日區,三和里,2498,1264,1234,26,2524,5768,0,43.76,21.91
臺中市,烏日區,榮泉里,2457,1304,1153,20,2477,5795,0,42.74,22.5
臺中市,烏日區,學田里,1141,604,537,9,1150,2612,0,44.03,23.12
臺中市,烏日區,九德里,5796,2852,2944,34,5830,12829,0,45.44,22.23
臺中市,烏日區,仁德里,3567,1750,1817,28,3595,7556,0,47.58,23.16
臺中市,烏日區,前竹里,797,335,462,10,807,1621,0,49.78,20.67
臺中市,烏日區,五光里,753,345,408,10,763,1676,0,45.53,20.58
臺中市,烏日區,光明里,942,411,531,7,949,2095,0,45.3,19.62
臺中市,烏日區,東園里,973,433,540,11,984,2196,0,44.81,19.72
臺中市,烏日區,溪埧里,1921,892,1029,23,1944,4327,0,44.93,20.61
臺中市,烏日區,螺潭里,1075,498,577,8,1083,2158,0,50.19,23.08
臺中市,烏日區,北里里,754,320,434,7,761,1651,0,46.09,19.38
臺中市,烏日區,南里里,653,361,292,6,659,1350,0,48.81,26.74
臺中市,烏日區,溪尾里,364,214,150,6,370,829,0,44.63,25.81
臺中市,烏日區,合計,28959,14052,14907,263,29222,63587,76907,45.96,22.1
臺中市,大肚區,王田里,1738,798,940,19,1757,4325,0,40.62,18.45
臺中市,大肚區,中和里,412,201,211,3,415,865,0,47.98,23.24
臺中市,大肚區,福山里,1490,694,796,13,1503,3486,0,43.12,19.91
臺中市,大肚區,營埔里,640,315,325,8,648,1505,0,43.06,20.93
臺中市,大肚區,社腳里,1100,603,497,6,1106,2438,0,45.37,24.73
臺中市,大肚區,新興里,1128,576,552,6,1134,2601,0,43.6,22.15
臺中市,大肚區,大東里,1363,725,638,17,1380,3003,0,45.95,24.14
臺中市,大肚區,大肚里,1092,571,521,12,1104,2165,0,50.99,26.37
臺中市,大肚區,永和里,400,220,180,3,403,819,0,49.21,26.86
臺中市,大肚區,磺溪里,727,356,371,7,734,1699,0,43.2,20.95
臺中市,大肚區,永順里,767,342,425,9,776,1688,0,45.97,20.26
臺中市,大肚區,成功里,368,207,161,6,374,943,0,39.66,21.95
臺中市,大肚區,山陽里,574,285,289,10,584,1310,0,44.58,21.76
臺中市,大肚區,頂街里,3197,1688,1509,33,3230,7418,0,43.54,22.76
臺中市,大肚區,瑞井里,2056,971,1085,17,2073,5061,0,40.96,19.19
臺中市,大肚區,蔗廍里,1943,805,1138,10,1953,4958,0,39.39,16.24
臺中市,大肚區,自強里,1496,811,685,20,1516,3471,0,43.68,23.37
臺中市,大肚區,合計,20491,10168,10323,199,20690,47755,56669,43.33,21.29
臺中市,龍井區,竹坑里,1234,628,606,10,1244,3019,0,41.21,20.8
臺中市,龍井區,龍東里,1159,579,580,6,1165,2849,0,40.89,20.32
臺中市,龍井區,龍西里,771,404,367,13,784,1822,0,43.03,22.17
臺中市,龍井區,田中里,1576,756,820,18,1594,3624,0,43.98,20.86
臺中市,龍井區,福田里,376,200,176,7,383,1043,0,36.72,19.18
臺中市,龍井區,麗水里,927,529,398,7,934,2271,0,41.13,23.29
臺中市,龍井區,龍津里,1980,862,1118,28,2008,5015,0,40.04,17.19
臺中市,龍井區,三德里,1035,427,608,14,1049,2952,0,35.54,14.46
臺中市,龍井區,忠和里,1967,839,1128,20,1987,4892,0,40.62,17.15
臺中市,龍井區,山腳里,2187,1021,1166,25,2212,5745,0,38.5,17.77
臺中市,龍井區,龍泉里,3085,1545,1540,35,3120,7612,0,40.99,20.3
臺中市,龍井區,龍崗里,1074,523,551,13,1087,2640,0,41.17,19.81
臺中市,龍井區,新庄里,2526,1238,1288,23,2549,6354,0,40.12,19.48
臺中市,龍井區,南寮里,704,313,391,7,711,1558,0,45.64,20.09
臺中市,龍井區,新東里,2073,1091,982,23,2096,4747,0,44.15,22.98
臺中市,龍井區,東海里,3827,2255,1572,31,3858,8616,0,44.78,26.17
臺中市,龍井區,合計,26501,13210,13291,280,26781,64759,78039,41.35,20.4
臺中市,霧峰區,桐林里,540,257,283,6,546,1194,0,45.73,21.52
臺中市,霧峰區,吉峰里,3995,2007,1988,29,4024,9381,0,42.9,21.39
臺中市,霧峰區,甲寅里,1971,1032,939,15,1986,4671,0,42.52,22.09
臺中市,霧峰區,本鄉里,1090,519,571,9,1099,2320,0,47.37,22.37
臺中市,霧峰區,中正里,1000,509,491,3,1003,2025,0,49.53,25.14
臺中市,霧峰區,錦榮里,562,298,264,6,568,1224,0,46.41,24.35
臺中市,霧峰區,萊園里,489,210,279,7,496,1045,0,47.46,20.1
臺中市,霧峰區,本堂里,2656,1437,1219,20,2676,5783,0,46.27,24.85
臺中市,霧峰區,坑口里,1336,692,644,9,1345,2918,0,46.09,23.71
臺中市,霧峰區,北柳里,1752,784,968,17,1769,3965,0,44.62,19.77
臺中市,霧峰區,南柳里,912,418,494,10,922,1860,0,49.57,22.47
臺中市,霧峰區,四德里,1027,461,566,11,1038,2470,0,42.02,18.66
臺中市,霧峰區,五福里,1192,572,620,19,1211,2651,0,45.68,21.58
臺中市,霧峰區,萬豐里,1103,502,601,9,1112,2577,0,43.15,19.48
臺中市,霧峰區,舊正里,879,418,461,11,890,2046,0,43.5,20.43
臺中市,霧峰區,峰谷里,433,173,260,3,436,1104,0,39.49,15.67
臺中市,霧峰區,六股里,1112,438,674,15,1127,2352,0,47.92,18.62
臺中市,霧峰區,丁台里,1070,432,638,18,1088,2284,0,47.64,18.91
臺中市,霧峰區,北勢里,951,563,388,3,954,2071,0,46.06,27.18
臺中市,霧峰區,南勢里,557,273,284,3,560,1307,0,42.85,20.89
臺中市,霧峰區,合計,24627,11995,12632,223,24850,55248,64801,44.98,21.71
臺中市,太平區,太平里,2167,921,1246,32,2199,5378,0,40.89,17.13
臺中市,太平區,長億里,2407,1188,1219,27,2434,6193,0,39.3,19.18
臺中市,太平區,中平里,1588,702,886,14,1602,4030,0,39.75,17.42
臺中市,太平區,中興里,1320,558,762,20,1340,3192,0,41.98,17.48
臺中市,太平區,建國里,1120,529,591,18,1138,2873,0,39.61,18.41
臺中市,太平區,東平里,1524,692,832,19,1543,4108,0,37.56,16.85
臺中市,太平區,宜欣里,2311,1059,1252,26,2337,6203,0,37.68,17.07
臺中市,太平區,中山里,1271,717,554,10,1281,3727,0,34.37,19.24
臺中市,太平區,坪林里,1443,828,615,15,1458,3294,0,44.26,25.14
臺中市,太平區,光華里,2081,1149,932,22,2103,5188,0,40.54,22.15
臺中市,太平區,新坪里,2775,1493,1282,17,2792,7707,0,36.23,19.37
臺中市,太平區,新光里,3077,1497,1580,37,3114,7600,0,40.97,19.7
臺中市,太平區,新福里,2740,1422,1318,20,2760,6669,0,41.39,21.32
臺中市,太平區,頭汴里,658,328,330,7,665,1767,0,37.63,18.56
臺中市,太平區,東汴里,403,165,238,4,407,1199,0,33.94,13.76
臺中市,太平區,興隆里,1180,574,606,16,1196,3227,0,37.06,17.79
臺中市,太平區,光隆里,1182,437,745,13,1195,3052,0,39.15,14.32
臺中市,太平區,德隆里,1770,743,1027,22,1792,4742,0,37.79,15.67
臺中市,太平區,黃竹里,246,100,146,7,253,649,0,38.98,15.41
臺中市,太平區,永成里,2531,1162,1369,23,2554,6807,0,37.52,17.07
臺中市,太平區,永平里,1535,706,829,8,1543,4018,0,38.4,17.57
臺中市,太平區,成功里,1453,599,854,14,1467,3985,0,36.81,15.03
臺中市,太平區,東和里,1023,496,527,9,1032,2818,0,36.62,17.6
臺中市,太平區,中政里,1391,636,755,13,1404,3701,0,37.94,17.18
臺中市,太平區,平安里,870,384,486,10,880,2204,0,39.93,17.42
臺中市,太平區,建興里,1002,461,541,7,1009,2894,0,34.87,15.93
臺中市,太平區,新興里,2245,1106,1139,20,2265,5508,0,41.12,20.08
臺中市,太平區,新高里,3237,1647,1590,28,3265,8031,0,40.65,20.51
臺中市,太平區,新吉里,2195,1182,1013,25,2220,5692,0,39.0,20.77
臺中市,太平區,新城里,1943,1037,906,21,1964,5664,0,34.68,18.31
臺中市,太平區,宜佳里,2304,1205,1099,19,2323,6055,0,38.36,19.9
臺中市,太平區,宜昌里,1399,625,774,17,1416,3821,0,37.06,16.36
臺中市,太平區,光明里,1504,866,638,10,1514,3832,0,39.51,22.6
臺中市,太平區,豐年里,1911,1053,858,14,1925,4323,0,44.53,24.36
臺中市,太平區,大興里,931,446,485,8,939,2539,0,36.98,17.57
臺中市,太平區,勤益里,898,538,360,12,910,2139,0,42.54,25.15
臺中市,太平區,聖和里,586,275,311,8,594,1536,0,38.67,17.9
臺中市,太平區,福隆里,1456,667,789,9,1465,3631,0,40.35,18.37
臺中市,太平區,永隆里,898,429,469,9,907,2486,0,36.48,17.26
臺中市,太平區,合計,62575,30622,31953,630,63205,162482,195494,38.9,18.85
臺中市,大里區,大里里,1534,725,809,19,1553,3731,0,41.62,19.43
臺中市,大里區,新里里,4234,2012,2222,37,4271,10438,0,40.92,19.28
臺中市,大里區,樹王里,1557,603,954,14,1571,3621,0,43.39,16.65
臺中市,大里區,東興里,2910,1349,1561,19,2929,6901,0,42.44,19.55
臺中市,大里區,祥興里,3086,1372,1714,35,3121,7279,0,42.88,18.85
臺中市,大里區,日新里,1815,899,916,19,1834,4162,0,44.07,21.6
臺中市,大里區,西榮里,2198,1031,1167,24,2222,5520,0,40.25,18.68
臺中市,大里區,內新里,3383,1742,1641,23,3406,8350,0,40.79,20.86
臺中市,大里區,東昇里,1411,674,737,20,1431,3400,0,42.09,19.82
臺中市,大里區,立仁里,1967,878,1089,27,1994,5356,0,37.23,16.39
臺中市,大里區,新仁里,3232,1449,1783,32,3264,7841,0,41.63,18.48
臺中市,大里區,大元里,1872,822,1050,21,1893,4167,0,45.43,19.73
臺中市,大里區,夏田里,463,172,291,6,469,982,0,47.76,17.52
臺中市,大里區,仁化里,3125,1373,1752,30,3155,8402,0,37.55,16.34
臺中市,大里區,健民里,1701,751,950,14,1715,4704,0,36.46,15.97
臺中市,大里區,塗城里,3193,1430,1763,33,3226,8359,0,38.59,17.11
臺中市,大里區,瑞城里,4482,2140,2342,37,4519,11593,0,38.98,18.46
臺中市,大里區,金城里,3744,1772,1972,30,3774,9507,0,39.7,18.64
臺中市,大里區,東湖里,4013,1966,2047,42,4055,10403,0,38.98,18.9
臺中市,大里區,西湖里,1164,513,651,15,1179,2803,0,42.06,18.3
臺中市,大里區,國光里,2447,1262,1185,21,2468,5719,0,43.15,22.07
臺中市,大里區,大明里,1670,779,891,17,1687,4144,0,40.71,18.8
臺中市,大里區,永隆里,4415,2320,2095,34,4449,9667,0,46.02,24.0
臺中市,大里區,長榮里,3803,1919,1884,39,3842,8636,0,44.49,22.22
臺中市,大里區,中新里,2121,1077,1044,22,2143,5389,0,39.77,19.99
臺中市,大里區,立德里,3022,1407,1615,23,3045,7712,0,39.48,18.24
臺中市,大里區,仁德里,2320,1056,1264,15,2335,5865,0,39.81,18.01
臺中市,大里區,合計,70882,33493,37389,668,71550,174651,212710,40.97,19.18
臺中市,和平區,南勢里,645,416,229,15,660,1883,0,35.05,22.09
臺中市,和平區,天輪里,142,76,66,3,145,456,0,31.8,16.67
臺中市,和平區,博愛里,529,391,138,6,535,1641,0,32.6,23.83
臺中市,和平區,中坑里,192,135,57,3,195,461,0,42.3,29.28
臺中市,和平區,自由里,420,319,101,5,425,1081,0,39.32,29.51
臺中市,和平區,達觀里,419,300,119,3,422,1107,0,38.12,27.1
臺中市,和平區,梨山里,429,275,154,4,433,1939,0,22.33,14.18
臺中市,和平區,平等里,208,158,50,4,212,868,0,24.42,18.2
臺中市,和平區,合計,2984,2070,914,43,3027,9436,10841,32.08,21.94
臺中市,合計,合計,975133,484612,490521,9433,984566,2337667,2819081,42.12,20.73
臺南市,新營區,忠政里,1945,1025,920,10,1955,4561,0,42.86,22.47
臺南市,新營區,民權里,911,410,501,6,917,2212,0,41.46,18.54
臺南市,新營區,三仙里,1151,476,675,5,1156,2807,0,41.18,16.96
臺南市,新營區,大宏里,1174,494,680,6,1180,2795,0,42.22,17.67
臺南市,新營區,王公里,1578,715,863,11,1589,4010,0,39.63,17.83
臺南市,新營區,中營里,472,190,282,5,477,1131,0,42.18,16.8
臺南市,新營區,土庫里,569,187,382,8,577,1430,0,40.35,13.08
臺南市,新營區,南興里,886,407,479,5,891,2371,0,37.58,17.17
臺南市,新營區,興業里,734,344,390,8,742,1734,0,42.79,19.84
臺南市,新營區,民生里,1197,473,724,15,1212,3194,0,37.95,14.81
臺南市,新營區,民榮里,1648,657,991,13,1661,4405,0,37.71,14.91
臺南市,新營區,埤寮里,639,228,411,15,654,1632,0,40.07,13.97
臺南市,新營區,護鎮里,512,171,341,4,516,1333,0,38.71,12.83
臺南市,新營區,太南里,596,168,428,9,605,1724,0,35.09,9.74
臺南市,新營區,太北里,655,193,462,7,662,1696,0,39.03,11.38
臺南市,新營區,南紙里,1321,575,746,14,1335,3665,0,36.43,15.69
臺南市,新營區,嘉芳里,659,237,422,6,665,1880,0,35.37,12.61
臺南市,新營區,五興里,609,166,443,6,615,1555,0,39.55,10.68
臺南市,新營區,姑爺里,343,106,237,4,347,897,0,38.68,11.82
臺南市,新營區,新北里,1880,868,1012,16,1896,4874,0,38.9,17.81
臺南市,新營區,新南里,2040,896,1144,16,2056,5086,0,40.42,17.62
臺南市,新營區,新東里,2504,1244,1260,19,2523,6401,0,39.42,19.43
臺南市,新營區,永平里,1133,468,665,8,1141,2599,0,43.9,18.01
臺南市,新營區,合計,25156,10698,14458,216,25372,63992,76027,39.65,16.72
臺南市,鹽水區,水秀里,590,201,389,4,594,1549,0,38.35,12.98
臺南市,鹽水區,橋南里,1294,478,816,15,1309,3724,0,35.15,12.84
臺南市,鹽水區,汫水里,310,45,265,14,324,875,0,37.03,5.14
臺南市,鹽水區,岸內里,1442,531,911,21,1463,3815,0,38.35,13.92
臺南市,鹽水區,歡雅里,603,189,414,11,614,1621,0,37.88,11.66
臺南市,鹽水區,津城里,611,229,382,4,615,1413,0,43.52,16.21
臺南市,鹽水區,月港里,650,286,364,3,653,1575,0,41.46,18.16
臺南市,鹽水區,三明里,621,150,471,6,627,1519,0,41.28,9.87
臺南市,鹽水區,義中里,562,154,408,8,570,1545,0,36.89,9.97
臺南市,鹽水區,文昌里,367,103,264,2,369,981,0,37.61,10.5
臺南市,鹽水區,竹林里,435,109,326,9,444,1073,0,41.38,10.16
臺南市,鹽水區,三和里,366,111,255,10,376,900,0,41.78,12.33
臺南市,鹽水區,坔頭港里,467,130,337,8,475,1360,0,34.93,9.56
臺南市,鹽水區,合計,8318,2716,5602,115,8433,21950,24892,38.42,12.37
臺南市,白河區,白河里,670,214,456,4,674,1688,0,39.93,12.68
臺南市,白河區,永安里,1271,433,838,6,1277,2937,0,43.48,14.74
臺南市,白河區,外角里,546,184,362,4,550,1364,0,40.32,13.49
臺南市,白河區,庄內里,643,212,431,9,652,1596,0,40.85,13.28
臺南市,白河區,秀祐里,336,116,220,6,342,874,0,39.13,13.27
臺南市,白河區,河東里,545,177,368,9,554,1334,0,41.53,13.27
臺南市,白河區,虎山里,175,62,113,3,178,440,0,40.45,14.09
臺南市,白河區,大林里,181,40,141,2,183,560,0,32.68,7.14
臺南市,白河區,崁頭里,120,39,81,3,123,369,0,33.33,10.57
臺南市,白河區,六溪里,160,34,126,2,162,487,0,33.26,6.98
臺南市,白河區,仙草里,381,139,242,7,388,1178,0,32.94,11.8
臺南市,白河區,關嶺里,334,92,242,3,337,1001,0,33.67,9.19
臺南市,白河區,大竹里,491,158,333,7,498,1380,0,36.09,11.45
臺南市,白河區,竹門里,318,112,206,7,325,836,0,38.88,13.4
臺南市,白河區,崎內里,193,86,107,1,194,705,0,27.52,12.2
臺南市,白河區,昇安里,477,143,334,6,483,1303,0,37.07,10.97
臺南市,白河區,汴頭里,279,66,213,6,285,707,0,40.31,9.34
臺南市,白河區,內角里,254,82,172,3,257,657,0,39.12,12.48
臺南市,白河區,詔豐里,743,209,534,12,755,1930,0,39.12,10.83
臺南市,白河區,廣蓮里,580,162,418,10,590,1458,0,40.47,11.11
臺南市,白河區,馬稠後里,438,133,305,14,452,1318,0,34.29,10.09
臺南市,白河區,合計,9135,2893,6242,124,9259,24122,26978,38.38,11.99
臺南市,柳營區,士林里,707,234,473,14,721,1825,0,39.51,12.82
臺南市,柳營區,光福里,706,251,455,2,708,1608,0,44.03,15.61
臺南市,柳營區,中埕里,445,163,282,8,453,1107,0,40.92,14.72
臺南市,柳營區,東昇里,1090,382,708,12,1102,2722,0,40.48,14.03
臺南市,柳營區,八翁里,508,174,334,3,511,1368,0,37.35,12.72
臺南市,柳營區,人和里,298,110,188,0,298,727,0,40.99,15.13
臺南市,柳營區,太康里,602,209,393,14,616,1454,0,42.37,14.37
臺南市,柳營區,重溪里,643,185,458,9,652,1738,0,37.51,10.64
臺南市,柳營區,篤農里,468,147,321,7,475,1275,0,37.25,11.53
臺南市,柳營區,大農里,254,63,191,4,258,652,0,39.57,9.66
臺南市,柳營區,神農里,482,140,342,8,490,1337,0,36.65,10.47
臺南市,柳營區,果毅里,437,127,310,4,441,1192,0,37.0,10.65
臺南市,柳營區,旭山里,502,169,333,5,507,1517,0,33.42,11.14
臺南市,柳營區,合計,7142,2354,4788,90,7232,18522,20733,39.05,12.71
臺南市,後壁區,後壁里,690,277,413,7,697,1620,0,43.02,17.1
臺南市,後壁區,侯伯里,505,156,349,6,511,1264,0,40.43,12.34
臺南市,後壁區,嘉苳里,478,150,328,7,485,1275,0,38.04,11.76
臺南市,後壁區,土溝里,524,140,384,8,532,1304,0,40.8,10.74
臺南市,後壁區,竹新里,576,129,447,5,581,1336,0,43.49,9.66
臺南市,後壁區,新東里,604,186,418,9,613,1610,0,38.07,11.55
臺南市,後壁區,頂安里,483,183,300,8,491,1223,0,40.15,14.96
臺南市,後壁區,長安里,507,198,309,6,513,1216,0,42.19,16.28
臺南市,後壁區,福安里,685,239,446,5,690,1753,0,39.36,13.63
臺南市,後壁區,菁寮里,565,193,372,6,571,1379,0,41.41,14.0
臺南市,後壁區,新嘉里,301,81,220,6,307,966,0,31.78,8.39
臺南市,後壁區,長短樹里,817,255,562,17,834,1961,0,42.53,13.0
臺南市,後壁區,上茄苳里,863,240,623,10,873,2164,0,40.34,11.09
臺南市,後壁區,菁豐里,451,148,303,5,456,1194,0,38.19,12.4
臺南市,後壁區,合計,8049,2575,5474,105,8154,20265,22532,40.24,12.71
臺南市,東山區,東山里,475,200,275,7,482,1400,0,34.43,14.29
臺南市,東山區,東中里,871,333,538,4,875,2475,0,35.35,13.45
臺南市,東山區,東正里,468,143,325,4,472,1405,0,33.59,10.18
臺南市,東山區,三榮里,284,92,192,4,288,920,0,31.3,10.0
臺南市,東山區,大客里,295,98,197,3,298,1058,0,28.17,9.26
臺南市,東山區,科里里,417,142,275,7,424,1193,0,35.54,11.9
臺南市,東山區,東河里,291,79,212,9,300,826,0,36.32,9.56
臺南市,東山區,南溪里,115,27,88,3,118,420,0,28.1,6.43
臺南市,東山區,水雲里,106,31,75,0,106,376,0,28.19,8.24
臺南市,東山區,林安里,135,45,90,5,140,370,0,37.84,12.16
臺南市,東山區,東原里,620,236,384,8,628,2040,0,30.78,11.57
臺南市,東山區,嶺南里,147,54,93,1,148,647,0,22.87,8.35
臺南市,東山區,南勢里,277,83,194,3,280,1054,0,26.57,7.87
臺南市,東山區,青山里,300,113,187,4,304,1052,0,28.9,10.74
臺南市,東山區,高原里,218,113,105,3,221,877,0,25.2,12.88
臺南市,東山區,聖賢里,718,215,503,15,733,1847,0,39.69,11.64
臺南市,東山區,合計,5737,2004,3733,80,5817,17960,19922,32.39,11.16
臺南市,麻豆區,東角里,1124,379,745,9,1133,2562,0,44.22,14.79
臺南市,麻豆區,晋江里,1101,313,788,18,1119,2463,0,45.43,12.71
臺南市,麻豆區,巷口里,969,324,645,6,975,2086,0,46.74,15.53
臺南市,麻豆區,中興里,847,287,560,11,858,1936,0,44.32,14.82
臺南市,麻豆區,興農里,648,173,475,5,653,1433,0,45.57,12.07
臺南市,麻豆區,油車里,1588,431,1157,15,1603,3474,0,46.14,12.41
臺南市,麻豆區,北勢里,457,84,373,4,461,1093,0,42.18,7.69
臺南市,麻豆區,大埕里,1246,352,894,13,1259,2846,0,44.24,12.37
臺南市,麻豆區,南勢里,990,342,648,10,1000,2315,0,43.2,14.77
臺南市,麻豆區,寮廍里,746,148,598,5,751,1645,0,45.65,9.0
臺南市,麻豆區,埤頭里,951,183,768,12,963,2284,0,42.16,8.01
臺南市,麻豆區,海埔里,835,210,625,12,847,2089,0,40.55,10.05
臺南市,麻豆區,港尾里,516,133,383,8,524,1232,0,42.53,10.8
臺南市,麻豆區,麻口里,446,101,345,3,449,1171,0,38.34,8.63
臺南市,麻豆區,安業里,623,129,494,10,633,1297,0,48.8,9.95
臺南市,麻豆區,安正里,374,93,281,5,379,925,0,40.97,10.05
臺南市,麻豆區,新興里,795,197,598,10,805,1871,0,43.03,10.53
臺南市,麻豆區,謝厝寮里,773,156,617,15,788,1633,0,48.25,9.55
臺南市,麻豆區,井東里,751,181,570,9,760,1704,0,44.6,10.62
臺南市,麻豆區,清水里,618,170,448,7,625,1449,0,43.13,11.73
臺南市,麻豆區,合計,16398,4386,12012,187,16585,37508,43610,44.22,11.69
臺南市,下營區,下營里,615,251,364,6,621,1503,0,41.32,16.7
臺南市,下營區,仁里里,700,237,463,7,707,1925,0,36.73,12.31
臺南市,下營區,宅內里,606,237,369,8,614,1601,0,38.35,14.8
臺南市,下營區,後街里,612,239,373,3,615,1555,0,39.55,15.37
臺南市,下營區,新興里,680,253,427,6,686,1945,0,35.27,13.01
臺南市,下營區,營前里,806,284,522,12,818,2079,0,39.35,13.66
臺南市,下營區,開化里,729,214,515,6,735,1817,0,40.45,11.78
臺南市,下營區,西連里,392,98,294,5,397,866,0,45.84,11.32
臺南市,下營區,賀建里,424,127,297,3,427,1269,0,33.65,10.01
臺南市,下營區,茅營里,847,230,617,12,859,2146,0,40.03,10.72
臺南市,下營區,大吉里,563,211,352,11,574,1539,0,37.3,13.71
臺南市,下營區,紅甲里,852,213,639,15,867,2173,0,39.9,9.8
臺南市,下營區,合計,7826,2594,5232,94,7920,20418,23214,38.79,12.7
臺南市,六甲區,六甲里,1059,341,718,11,1070,2866,0,37.33,11.9
臺南市,六甲區,甲東里,956,296,660,15,971,2601,0,37.33,11.38
臺南市,六甲區,甲南里,547,185,362,5,552,1327,0,41.6,13.94
臺南市,六甲區,七甲里,697,204,493,7,704,1910,0,36.86,10.68
臺南市,六甲區,二甲里,1255,396,859,19,1274,3299,0,38.62,12.0
臺南市,六甲區,水林里,772,229,543,4,776,2062,0,37.63,11.11
臺南市,六甲區,中社里,616,206,410,8,624,1583,0,39.42,13.01
臺南市,六甲區,龜港里,473,174,299,7,480,1229,0,39.06,14.16
臺南市,六甲區,菁埔里,265,98,167,3,268,583,0,45.97,16.81
臺南市,六甲區,王爺里,194,56,138,2,196,719,0,27.26,7.79
臺南市,六甲區,大丘里,182,51,131,3,185,580,0,31.9,8.79
臺南市,六甲區,合計,7016,2236,4780,84,7100,18759,21572,37.85,11.92
臺南市,官田區,官田里,809,270,539,8,817,2045,0,39.95,13.2
臺南市,官田區,二鎮里,1316,300,1016,14,1330,3141,0,42.34,9.55
臺南市,官田區,大崎里,144,51,93,2,146,402,0,36.32,12.69
臺南市,官田區,隆田里,782,288,494,11,793,1948,0,40.71,14.78
臺南市,官田區,隆本里,1408,554,854,17,1425,3476,0,41.0,15.94
臺南市,官田區,南廍里,453,126,327,8,461,1243,0,37.09,10.14
臺南市,官田區,社子里,314,68,246,2,316,855,0,36.96,7.95
臺南市,官田區,烏山頭里,521,138,383,4,525,1197,0,43.86,11.53
臺南市,官田區,渡拔里,1081,333,748,19,1100,2498,0,44.04,13.33
臺南市,官田區,東西庄里,800,105,695,14,814,1798,0,45.27,5.84
臺南市,官田區,合計,7628,2233,5395,99,7727,18603,21123,41.54,12.0
臺南市,大內區,石湖里,384,125,259,5,389,992,0,39.21,12.6
臺南市,大內區,石林里,228,54,174,7,235,619,0,37.96,8.72
臺南市,大內區,石城里,519,131,388,10,529,1411,0,37.49,9.28
臺南市,大內區,內江里,329,130,199,1,330,885,0,37.29,14.69
臺南市,大內區,大內里,352,121,231,4,356,744,0,47.85,16.26
臺南市,大內區,內郭里,250,71,179,2,252,598,0,42.14,11.87
臺南市,大內區,頭社里,337,100,237,3,340,969,0,35.09,10.32
臺南市,大內區,環湖里,234,69,165,7,241,722,0,33.38,9.56
臺南市,大內區,二溪里,329,120,209,2,331,822,0,40.27,14.6
臺南市,大內區,曲溪里,224,54,170,2,226,550,0,41.09,9.82
臺南市,大內區,合計,3186,975,2211,43,3229,8312,9096,38.85,11.73
臺南市,佳里區,東寧里,998,352,646,9,1007,2192,0,45.94,16.06
臺南市,佳里區,忠仁里,1080,333,747,9,1089,2827,0,38.52,11.78
臺南市,佳里區,鎮山里,2158,704,1454,12,2170,5534,0,39.21,12.72
臺南市,佳里區,建南里,1599,548,1051,16,1615,4239,0,38.1,12.93
臺南市,佳里區,安西里,2275,804,1471,21,2296,5723,0,40.12,14.05
臺南市,佳里區,六安里,1570,608,962,20,1590,3989,0,39.86,15.24
臺南市,佳里區,佳化里,814,255,559,5,819,2115,0,38.72,12.06
臺南市,佳里區,海澄里,770,245,525,11,781,2153,0,36.27,11.38
臺南市,佳里區,民安里,664,168,496,3,667,1660,0,40.18,10.12
臺南市,佳里區,子龍里,984,251,733,14,998,2328,0,42.87,10.78
臺南市,佳里區,營溪里,400,135,265,8,408,1045,0,39.04,12.92
臺南市,佳里區,文新里,2023,797,1226,6,2029,5063,0,40.08,15.74
臺南市,佳里區,佳興里,899,249,650,9,908,2103,0,43.18,11.84
臺南市,佳里區,下營里,723,217,506,2,725,1786,0,40.59,12.15
臺南市,佳里區,塭內里,1055,261,794,14,1069,2729,0,39.17,9.56
臺南市,佳里區,南勢里,1692,543,1149,9,1701,4415,0,38.53,12.3
臺南市,佳里區,合計,19704,6470,13234,168,19872,49901,58600,39.82,12.97
臺南市,學甲區,仁得里,1584,490,1094,14,1598,3771,0,42.38,12.99
臺南市,學甲區,新榮里,883,257,626,7,890,2308,0,38.56,11.14
臺南市,學甲區,光華里,457,115,342,2,459,1207,0,38.03,9.53
臺南市,學甲區,宅港里,283,94,189,4,287,771,0,37.22,12.19
臺南市,學甲區,慈福里,776,284,492,6,782,1967,0,39.76,14.44
臺南市,學甲區,秀昌里,953,284,669,13,966,2463,0,39.22,11.53
臺南市,學甲區,明宜里,775,202,573,9,784,1887,0,41.55,10.7
臺南市,學甲區,豐和里,447,112,335,4,451,1175,0,38.38,9.53
臺南市,學甲區,平和里,372,69,303,5,377,1001,0,37.66,6.89
臺南市,學甲區,新達里,787,269,518,10,797,2054,0,38.8,13.1
臺南市,學甲區,大灣里,379,110,269,6,385,939,0,41.0,11.71
臺南市,學甲區,三慶里,474,147,327,9,483,1310,0,36.87,11.22
臺南市,學甲區,中洲里,469,140,329,4,473,1367,0,34.6,10.24
臺南市,學甲區,合計,8639,2573,6066,93,8732,22220,25121,39.3,11.58
臺南市,西港區,西港里,1235,381,854,20,1255,3112,0,40.33,12.24
臺南市,西港區,南海里,979,245,734,12,991,2413,0,41.07,10.15
臺南市,西港區,港東里,601,164,437,2,603,1625,0,37.11,10.09
臺南市,西港區,檨林里,544,141,403,6,550,1640,0,33.54,8.6
臺南市,西港區,後營里,498,113,385,9,507,1436,0,35.31,7.87
臺南市,西港區,營西里,473,127,346,3,476,1456,0,32.69,8.72
臺南市,西港區,金砂里,313,86,227,6,319,758,0,42.08,11.35
臺南市,西港區,劉厝里,493,146,347,8,501,1338,0,37.44,10.91
臺南市,西港區,竹林里,556,128,428,5,561,1342,0,41.8,9.54
臺南市,西港區,永樂里,539,129,410,4,543,1352,0,40.16,9.54
臺南市,西港區,新復里,279,114,165,7,286,805,0,35.53,14.16
臺南市,西港區,慶安里,1573,507,1066,12,1585,4193,0,37.8,12.09
臺南市,西港區,合計,8083,2281,5802,94,8177,21470,24521,38.09,10.62
臺南市,七股區,後港里,392,104,288,1,393,998,0,39.38,10.42
臺南市,七股區,大潭里,232,54,178,4,236,648,0,36.42,8.33
臺南市,七股區,篤加里,307,95,212,1,308,820,0,37.56,11.59
臺南市,七股區,頂山里,308,96,212,3,311,809,0,38.44,11.87
臺南市,七股區,西寮里,164,43,121,1,165,444,0,37.16,9.68
臺南市,七股區,塩埕里,155,31,124,0,155,410,0,37.8,7.56
臺南市,七股區,龍山里,611,132,479,5,616,1608,0,38.31,8.21
臺南市,七股區,溪南里,128,50,78,1,129,343,0,37.61,14.58
臺南市,七股區,七股里,342,80,262,5,347,861,0,40.3,9.29
臺南市,七股區,玉成里,276,82,194,5,281,775,0,36.26,10.58
臺南市,七股區,大埕里,882,224,658,10,892,2548,0,35.01,8.79
臺南市,七股區,樹林里,624,141,483,11,635,1894,0,33.53,7.44
臺南市,七股區,中寮里,235,61,174,4,239,683,0,34.99,8.93
臺南市,七股區,竹橋里,480,142,338,10,490,1214,0,40.36,11.7
臺南市,七股區,義合里,707,196,511,10,717,1858,0,38.59,10.55
臺南市,七股區,永吉里,344,120,224,4,348,992,0,35.08,12.1
臺南市,七股區,三股里,444,120,324,2,446,1329,0,33.56,9.03
臺南市,七股區,十份里,430,151,279,5,435,1361,0,31.96,11.09
臺南市,七股區,合計,7061,1922,5139,82,7143,19595,21996,36.45,9.81
臺南市,將軍區,長榮里,435,129,306,4,439,1136,0,38.64,11.36
臺南市,將軍區,玉山里,261,51,210,2,263,821,0,32.03,6.21
臺南市,將軍區,廣山里,183,65,118,4,187,636,0,29.4,10.22
臺南市,將軍區,長沙里,447,107,340,7,454,1312,0,34.6,8.16
臺南市,將軍區,平沙里,424,87,337,11,435,1171,0,37.15,7.43
臺南市,將軍區,鯤鯓里,653,131,522,9,662,1862,0,35.55,7.04
臺南市,將軍區,鯤溟里,268,56,212,10,278,946,0,29.39,5.92
臺南市,將軍區,巷埔里,470,107,363,3,473,1166,0,40.57,9.18
臺南市,將軍區,西甲里,914,255,659,6,920,2358,0,39.02,10.81
臺南市,將軍區,忠嘉里,844,251,593,17,861,2413,0,35.68,10.4
臺南市,將軍區,苓仔寮里,757,195,562,11,768,1964,0,39.1,9.93
臺南市,將軍區,將軍里,546,148,398,4,550,1528,0,35.99,9.69
臺南市,將軍區,合計,6202,1582,4620,88,6290,17313,18966,36.33,9.14
臺南市,北門區,保吉里,386,134,252,3,389,1309,0,29.72,10.24
臺南市,北門區,雙春里,146,54,92,3,149,451,0,33.04,11.97
臺南市,北門區,北門里,271,103,168,1,272,820,0,33.17,12.56
臺南市,北門區,錦湖里,249,93,156,2,251,909,0,27.61,10.23
臺南市,北門區,三光里,394,132,262,6,400,1152,0,34.72,11.46
臺南市,北門區,玉港里,242,73,169,5,247,702,0,35.19,10.4
臺南市,北門區,慈安里,199,67,132,2,201,726,0,27.69,9.23
臺南市,北門區,永隆里,280,102,178,5,285,843,0,33.81,12.1
臺南市,北門區,蚵寮里,430,143,287,2,432,1415,0,30.53,10.11
臺南市,北門區,文山里,430,111,319,10,440,1222,0,36.01,9.08
臺南市,北門區,合計,3027,1012,2015,39,3066,9549,10460,32.11,10.6
臺南市,新化區,武安里,1352,583,769,11,1363,3038,0,44.87,19.19
臺南市,新化區,東榮里,1581,649,932,13,1594,3973,0,40.12,16.34
臺南市,新化區,護國里,1078,444,634,10,1088,2724,0,39.94,16.3
臺南市,新化區,太平里,1834,695,1139,15,1849,4411,0,41.92,15.76
臺南市,新化區,協興里,1287,503,784,13,1300,3203,0,40.59,15.7
臺南市,新化區,唪口里,850,304,546,10,860,2153,0,39.94,14.12
臺南市,新化區,北勢里,563,210,353,3,566,1482,0,38.19,14.17
臺南市,新化區,豐榮里,1200,498,702,19,1219,3226,0,37.79,15.44
臺南市,新化區,全興里,1090,489,601,15,1105,2804,0,39.41,17.44
臺南市,新化區,崙頂里,847,270,577,11,858,2123,0,40.41,12.72
臺南市,新化區,知義里,835,298,537,7,842,2155,0,39.07,13.83
臺南市,新化區,山脚里,567,192,375,4,571,1679,0,34.01,11.44
臺南市,新化區,大坑里,161,36,125,1,162,425,0,38.12,8.47
臺南市,新化區,𦰡拔里,738,296,442,7,745,2087,0,35.7,14.18
臺南市,新化區,羊林里,355,136,219,2,357,899,0,39.71,15.13
臺南市,新化區,礁坑里,379,71,308,5,384,933,0,41.16,7.61
臺南市,新化區,合計,14717,5674,9043,146,14863,37315,43049,39.83,15.21
臺南市,善化區,東關里,436,179,257,8,444,1123,0,39.54,15.94
臺南市,善化區,坐駕里,1559,638,921,16,1575,3901,0,40.37,16.35
臺南市,善化區,光文里,2203,881,1322,26,2229,5414,0,41.17,16.27
臺南市,善化區,文昌里,1017,370,647,5,1022,2685,0,38.06,13.78
臺南市,善化區,南關里,732,236,496,8,740,1791,0,41.32,13.18
臺南市,善化區,文正里,631,204,427,1,632,1601,0,39.48,12.74
臺南市,善化區,胡家里,530,102,428,7,537,1235,0,43.48,8.26
臺南市,善化區,胡厝里,839,257,582,12,851,2010,0,42.34,12.79
臺南市,善化區,什乃里,497,145,352,1,498,1226,0,40.62,11.83
臺南市,善化區,溪美里,840,292,548,9,849,1944,0,43.67,15.02
臺南市,善化區,六分里,285,70,215,1,286,677,0,42.25,10.34
臺南市,善化區,六德里,392,96,296,5,397,1041,0,38.14,9.22
臺南市,善化區,田寮里,672,198,474,8,680,1684,0,40.38,11.76
臺南市,善化區,牛庄里,678,229,449,12,690,1608,0,42.91,14.24
臺南市,善化區,嘉北里,637,185,452,10,647,1587,0,40.77,11.66
臺南市,善化區,嘉南里,428,115,313,2,430,1068,0,40.26,10.77
臺南市,善化區,小新里,1673,605,1068,22,1695,4425,0,38.31,13.67
臺南市,善化區,頂街里,483,193,290,1,484,1117,0,43.33,17.28
臺南市,善化區,昌隆里,774,234,540,16,790,1945,0,40.62,12.03
臺南市,善化區,蓮潭里,1362,497,865,14,1376,3324,0,41.4,14.95
臺南市,善化區,合計,16668,5726,10942,184,16852,41406,51052,40.7,13.83
臺南市,新市區,新市里,1141,425,716,12,1153,2990,0,38.56,14.21
臺南市,新市區,新和里,2654,990,1664,23,2677,6488,0,41.26,15.26
臺南市,新市區,社內里,1113,334,779,7,1120,2768,0,40.46,12.07
臺南市,新市區,大洲里,313,93,220,5,318,714,0,44.54,13.03
臺南市,新市區,豐華里,318,94,224,2,320,870,0,36.78,10.8
臺南市,新市區,三舍里,607,205,402,6,613,1563,0,39.22,13.12
臺南市,新市區,大營里,1250,489,761,10,1260,3380,0,37.28,14.47
臺南市,新市區,大社里,1727,519,1208,13,1740,4530,0,38.41,11.46
臺南市,新市區,潭頂里,678,201,477,4,682,1790,0,38.1,11.23
臺南市,新市區,港墘里,1165,402,763,15,1180,3330,0,35.44,12.07
臺南市,新市區,永就里,1236,475,761,8,1244,2946,0,42.23,16.12
臺南市,新市區,合計,12202,4227,7975,105,12307,31369,37721,39.23,13.48
臺南市,安定區,蘇林里,907,247,660,17,924,2065,0,44.75,11.96
臺南市,安定區,蘇厝里,775,258,517,10,785,2038,0,38.52,12.66
臺南市,安定區,安定里,568,175,393,2,570,1381,0,41.27,12.67
臺南市,安定區,安加里,892,281,611,10,902,2194,0,41.11,12.81
臺南市,安定區,港尾里,588,193,395,4,592,1485,0,39.87,13.0
臺南市,安定區,中榮里,715,228,487,10,725,1715,0,42.27,13.29
臺南市,安定區,港口里,1189,412,777,12,1201,2901,0,41.4,14.2
臺南市,安定區,港南里,1094,328,766,8,1102,2658,0,41.46,12.34
臺南市,安定區,中沙里,315,96,219,2,317,715,0,44.34,13.43
臺南市,安定區,新吉里,978,276,702,6,984,2448,0,40.2,11.27
臺南市,安定區,海寮里,1032,332,700,14,1046,2574,0,40.64,12.9
臺南市,安定區,文科里,679,191,488,5,684,1609,0,42.51,11.87
臺南市,安定區,嘉同里,922,291,631,15,937,2380,0,39.37,12.23
臺南市,安定區,合計,10654,3308,7346,115,10769,26163,30286,41.16,12.64
臺南市,山上區,明和里,572,215,357,8,580,1662,0,34.9,12.94
臺南市,山上區,南洲里,640,221,419,11,651,1522,0,42.77,14.52
臺南市,山上區,山上里,338,132,206,9,347,961,0,36.11,13.74
臺南市,山上區,新莊里,302,92,210,5,307,930,0,33.01,9.89
臺南市,山上區,玉峯里,197,70,127,2,199,560,0,35.54,12.5
臺南市,山上區,平陽里,137,68,69,1,138,351,0,39.32,19.37
臺南市,山上區,豐德里,121,39,82,5,126,392,0,32.14,9.95
臺南市,山上區,合計,2307,837,1470,41,2348,6378,7053,36.81,13.12
臺南市,玉井區,玉井里,449,236,213,5,454,1202,0,37.77,19.63
臺南市,玉井區,玉田里,1266,648,618,14,1280,3556,0,36.0,18.22
臺南市,玉井區,中正里,485,213,272,6,491,1198,0,40.98,17.78
臺南市,玉井區,竹圍里,479,225,254,7,486,1398,0,34.76,16.09
臺南市,玉井區,沙田里,195,92,103,9,204,497,0,41.05,18.51
臺南市,玉井區,三埔里,175,56,119,2,177,490,0,36.12,11.43
臺南市,玉井區,三和里,290,115,175,5,295,731,0,40.36,15.73
臺南市,玉井區,望明里,494,232,262,7,501,1428,0,35.08,16.25
臺南市,玉井區,層林里,204,79,125,4,208,580,0,35.86,13.62
臺南市,玉井區,豐里里,316,136,180,8,324,945,0,34.29,14.39
臺南市,玉井區,合計,4353,2032,2321,67,4420,12025,13483,36.76,16.9
臺南市,楠西區,楠西里,585,333,252,9,594,1779,0,33.39,18.72
臺南市,楠西區,灣丘里,293,134,159,1,294,1071,0,27.45,12.51
臺南市,楠西區,密枝里,202,100,102,2,204,681,0,29.96,14.68
臺南市,楠西區,照興里,304,122,182,4,308,951,0,32.39,12.83
臺南市,楠西區,鹿田里,311,181,130,6,317,894,0,35.46,20.25
臺南市,楠西區,龜丹里,205,95,110,3,208,639,0,32.55,14.87
臺南市,楠西區,東勢里,730,371,359,10,740,2215,0,33.41,16.75
臺南市,楠西區,合計,2630,1336,1294,35,2665,8230,9115,32.38,16.23
臺南市,南化區,南化里,539,233,306,7,546,1343,0,40.66,17.35
臺南市,南化區,小崙里,216,98,118,3,219,764,0,28.66,12.83
臺南市,南化區,中坑里,118,57,61,1,119,404,0,29.46,14.11
臺南市,南化區,北平里,200,78,122,5,205,547,0,37.48,14.26
臺南市,南化區,東和里,175,76,99,1,176,620,0,28.39,12.26
臺南市,南化區,西埔里,211,99,112,0,211,725,0,29.1,13.66
臺南市,南化區,北寮里,344,178,166,3,347,1130,0,30.71,15.75
臺南市,南化區,玉山里,310,150,160,4,314,1027,0,30.57,14.61
臺南市,南化區,關山里,180,102,78,5,185,948,0,19.51,10.76
臺南市,南化區,合計,2293,1071,1222,29,2322,7508,8305,30.93,14.26
臺南市,左鎮區,光和里,126,55,71,0,126,359,0,35.1,15.32
臺南市,左鎮區,榮和里,228,72,156,3,231,612,0,37.75,11.76
臺南市,左鎮區,左鎮里,158,51,107,4,162,456,0,35.53,11.18
臺南市,左鎮區,中正里,233,112,121,3,236,717,0,32.91,15.62
臺南市,左鎮區,睦光里,117,47,70,4,121,333,0,36.34,14.11
臺南市,左鎮區,內庄里,147,72,75,4,151,355,0,42.54,20.28
臺南市,左鎮區,澄山里,167,35,132,3,170,488,0,34.84,7.17
臺南市,左鎮區,岡林里,137,49,88,0,137,407,0,33.66,12.04
臺南市,左鎮區,草山里,94,36,58,4,98,286,0,34.27,12.59
臺南市,左鎮區,二寮里,86,22,64,4,90,179,0,50.28,12.29
臺南市,左鎮區,合計,1493,551,942,29,1522,4192,4475,36.31,13.14
臺南市,仁德區,太子里,2398,721,1677,25,2423,5421,0,44.7,13.3
臺南市,仁德區,土庫里,1248,323,925,13,1261,2737,0,46.07,11.8
臺南市,仁德區,一甲里,1109,401,708,15,1124,2570,0,43.74,15.6
臺南市,仁德區,仁德里,3046,1252,1794,26,3072,7630,0,40.26,16.41
臺南市,仁德區,仁義里,3921,1524,2397,31,3952,9033,0,43.75,16.87
臺南市,仁德區,新田里,1471,519,952,8,1479,3381,0,43.74,15.35
臺南市,仁德區,後壁里,3799,1404,2395,27,3826,9317,0,41.06,15.07
臺南市,仁德區,上崙里,2350,807,1543,31,2381,6025,0,39.52,13.39
臺南市,仁德區,保安里,1076,381,695,12,1088,2705,0,40.22,14.09
臺南市,仁德區,成功里,2105,1095,1010,28,2133,4809,0,44.35,22.77
臺南市,仁德區,仁和里,690,556,134,9,699,1493,0,46.82,37.24
臺南市,仁德區,仁愛里,531,299,232,3,534,1211,0,44.1,24.69
臺南市,仁德區,二行里,814,302,512,11,825,2102,0,39.25,14.37
臺南市,仁德區,大甲里,881,275,606,14,895,2110,0,42.42,13.03
臺南市,仁德區,中洲里,1070,357,713,19,1089,2612,0,41.69,13.67
臺南市,仁德區,文賢里,918,340,578,17,935,2215,0,42.21,15.35
臺南市,仁德區,合計,27427,10556,16871,289,27716,65371,76229,42.4,16.15
臺南市,歸仁區,南保里,2431,821,1610,16,2447,5856,0,41.79,14.02
臺南市,歸仁區,六甲里,1376,437,939,12,1388,3838,0,36.16,11.39
臺南市,歸仁區,歸仁里,927,368,559,6,933,2285,0,40.83,16.11
臺南市,歸仁區,後市里,1347,462,885,7,1354,3225,0,41.98,14.33
臺南市,歸仁區,辜厝里,1339,498,841,8,1347,3248,0,41.47,15.33
臺南市,歸仁區,許厝里,1324,448,876,13,1337,3254,0,41.09,13.77
臺南市,歸仁區,看西里,926,306,620,13,939,2155,0,43.57,14.2
臺南市,歸仁區,看東里,762,282,480,10,772,1781,0,43.35,15.83
臺南市,歸仁區,崙頂里,1363,449,914,10,1373,3017,0,45.51,14.88
臺南市,歸仁區,沙崙里,276,82,194,3,279,692,0,40.32,11.85
臺南市,歸仁區,大潭里,745,206,539,7,752,1871,0,40.19,11.01
臺南市,歸仁區,武東里,646,232,414,5,651,1767,0,36.84,13.13
臺南市,歸仁區,八甲里,1178,391,787,9,1187,2678,0,44.32,14.6
臺南市,歸仁區,七甲里,1411,489,922,16,1427,3293,0,43.33,14.85
臺南市,歸仁區,媽廟里,843,245,598,9,852,1938,0,43.96,12.64
臺南市,歸仁區,西埔里,739,228,511,6,745,1652,0,45.1,13.8
臺南市,歸仁區,大廟里,1274,428,846,13,1287,3037,0,42.38,14.09
臺南市,歸仁區,南興里,1767,645,1122,20,1787,4221,0,42.34,15.28
臺南市,歸仁區,新厝里,970,316,654,4,974,2447,0,39.8,12.91
臺南市,歸仁區,歸南里,961,302,659,5,966,2218,0,43.55,13.62
臺南市,歸仁區,文化里,1223,447,776,10,1233,2952,0,41.77,15.14
臺南市,歸仁區,合計,23828,8082,15746,202,24030,57425,68074,41.85,14.07
臺南市,關廟區,關廟里,961,333,628,18,979,2249,0,43.53,14.81
臺南市,關廟區,山西里,855,279,576,5,860,2011,0,42.76,13.87
臺南市,關廟區,香洋里,1437,519,918,12,1449,3209,0,45.15,16.17
臺南市,關廟區,北勢里,1041,313,728,14,1055,2473,0,42.66,12.66
臺南市,關廟區,新埔里,368,112,256,7,375,1038,0,36.13,10.79
臺南市,關廟區,新光里,286,81,205,0,286,695,0,41.15,11.65
臺南市,關廟區,五甲里,1269,456,813,13,1282,3182,0,40.29,14.33
臺南市,關廟區,東勢里,1209,412,797,16,1225,3141,0,39.0,13.12
臺南市,關廟區,松腳里,755,222,533,9,764,1949,0,39.2,11.39
臺南市,關廟區,深坑里,592,215,377,6,598,1468,0,40.74,14.65
臺南市,關廟區,布袋里,473,136,337,8,481,1183,0,40.66,11.5
臺南市,關廟區,埤頭里,772,237,535,7,779,1936,0,40.24,12.24
臺南市,關廟區,下湖里,205,73,132,4,209,470,0,44.47,15.53
臺南市,關廟區,花園里,1383,427,956,15,1398,3442,0,40.62,12.41
臺南市,關廟區,南雄里,606,170,436,6,612,1494,0,40.96,11.38
臺南市,關廟區,合計,12212,3985,8227,140,12352,29940,33986,41.26,13.31
臺南市,龍崎區,崎頂里,372,130,242,8,380,990,0,38.38,13.13
臺南市,龍崎區,土崎里,211,64,147,2,213,601,0,35.44,10.65
臺南市,龍崎區,中坑里,53,20,33,0,53,152,0,34.87,13.16
臺南市,龍崎區,楠坑里,160,59,101,0,160,371,0,43.13,15.9
臺南市,龍崎區,牛埔里,129,52,77,1,130,300,0,43.33,17.33
臺南市,龍崎區,大坪里,125,65,60,1,126,286,0,44.06,22.73
臺南市,龍崎區,龍船里,120,67,53,2,122,416,0,29.33,16.11
臺南市,龍崎區,石𥕢里,135,50,85,3,138,429,0,32.17,11.66
臺南市,龍崎區,合計,1305,507,798,17,1322,3545,3720,37.29,14.3
臺南市,永康區,五王里,2208,902,1306,18,2226,5645,0,39.43,15.98
臺南市,永康區,網寮里,2739,1178,1561,26,2765,6942,0,39.83,16.97
臺南市,永康區,永康里,3073,1177,1896,23,3096,8806,0,35.16,13.37
臺南市,永康區,埔園里,2852,1050,1802,26,2878,7154,0,40.23,14.68
臺南市,永康區,大橋里,2330,988,1342,20,2350,5595,0,42.0,17.66
臺南市,永康區,王行里,1002,319,683,12,1014,2455,0,41.3,12.99
臺南市,永康區,烏竹里,1085,403,682,15,1100,2791,0,39.41,14.44
臺南市,永康區,蔦松里,708,225,483,5,713,1847,0,38.6,12.18
臺南市,永康區,三民里,653,240,413,8,661,1503,0,43.98,15.97
臺南市,永康區,塩行里,2059,693,1366,18,2077,4855,0,42.78,14.27
臺南市,永康區,甲頂里,982,305,677,6,988,2226,0,44.38,13.7
臺南市,永康區,大灣里,1410,414,996,14,1424,3408,0,41.78,12.15
臺南市,永康區,東灣里,1425,407,1018,20,1445,3440,0,42.01,11.83
臺南市,永康區,西灣里,2997,1070,1927,28,3025,7237,0,41.8,14.79
臺南市,永康區,南灣里,1562,460,1102,9,1571,3833,0,40.99,12.0
臺南市,永康區,崑山里,2526,870,1656,18,2544,5820,0,43.71,14.95
臺南市,永康區,北灣里,1650,452,1198,16,1666,4081,0,40.82,11.08
臺南市,永康區,新樹里,822,269,553,10,832,2121,0,39.23,12.68
臺南市,永康區,復興里,705,467,238,13,718,1919,0,37.42,24.34
臺南市,永康區,復國里,3312,1768,1544,30,3342,8455,0,39.53,20.91
臺南市,永康區,建國里,772,469,303,11,783,1905,0,41.1,24.62
臺南市,永康區,神洲里,464,235,229,7,471,1264,0,37.26,18.59
臺南市,永康區,西勢里,2426,871,1555,24,2450,6123,0,40.01,14.23
臺南市,永康區,成功里,832,588,244,16,848,2032,0,41.73,28.94
臺南市,永康區,中興里,1385,687,698,12,1397,3317,0,42.12,20.71
臺南市,永康區,勝利里,2963,1445,1518,26,2989,7661,0,39.02,18.86
臺南市,永康區,龍潭里,2295,716,1579,24,2319,6139,0,37.77,11.66
臺南市,永康區,光復里,196,140,56,1,197,527,0,37.38,26.57
臺南市,永康區,塩洲里,2382,989,1393,15,2397,5686,0,42.16,17.39
臺南市,永康區,二王里,3153,1427,1726,24,3177,7749,0,41.0,18.42
臺南市,永康區,六合里,2255,1012,1243,9,2264,5449,0,41.55,18.57
臺南市,永康區,三合里,1396,588,808,12,1408,3456,0,40.74,17.01
臺南市,永康區,東橋里,2796,1079,1717,22,2818,7184,0,39.23,15.02
臺南市,永康區,安康里,1863,764,1099,17,1880,4806,0,39.12,15.9
臺南市,永康區,西橋里,1235,482,753,18,1253,3018,0,41.52,15.97
臺南市,永康區,尚頂里,1645,554,1091,10,1655,3737,0,44.29,14.82
臺南市,永康區,復華里,3641,1816,1825,28,3669,9242,0,39.7,19.65
臺南市,永康區,正強里,3024,1117,1907,25,3049,7578,0,40.23,14.74
臺南市,永康區,中華里,1332,680,652,9,1341,2787,0,48.12,24.4
臺南市,永康區,北興里,2039,767,1272,14,2053,4977,0,41.25,15.41
臺南市,永康區,龍埔里,1457,560,897,7,1464,3732,0,39.23,15.01
臺南市,永康區,永明里,1856,825,1031,19,1875,4598,0,40.78,17.94
臺南市,永康區,塩興里,1351,533,818,12,1363,3794,0,35.93,14.05
臺南市,永康區,合計,78858,32001,46857,697,79555,196894,235327,40.4,16.25
臺南市,東區,富裕里,963,376,587,8,971,2144,0,45.29,17.54
臺南市,東區,裕農里,1295,570,725,14,1309,2857,0,45.82,19.95
臺南市,東區,大智里,2797,1389,1408,25,2822,6524,0,43.26,21.29
臺南市,東區,崇學里,1283,545,738,15,1298,2838,0,45.74,19.2
臺南市,東區,泉南里,2065,851,1214,19,2084,4536,0,45.94,18.76
臺南市,東區,仁和里,1875,812,1063,15,1890,4489,0,42.1,18.09
臺南市,東區,後甲里,1189,489,700,10,1199,2816,0,42.58,17.37
臺南市,東區,東光里,2198,1038,1160,12,2210,4731,0,46.71,21.94
臺南市,東區,新東里,1154,564,590,5,1159,2370,0,48.9,23.8
臺南市,東區,中西里,1344,595,749,8,1352,2931,0,46.13,20.3
臺南市,東區,東安里,538,207,331,3,541,1309,0,41.33,15.81
臺南市,東區,崇明里,1828,895,933,5,1833,3981,0,46.04,22.48
臺南市,東區,自強里,2184,1000,1184,10,2194,5154,0,42.57,19.4
臺南市,東區,和平里,2112,889,1223,20,2132,5004,0,42.61,17.77
臺南市,東區,路東里,736,366,370,3,739,1574,0,46.95,23.25
臺南市,東區,大德里,657,278,379,1,658,1465,0,44.91,18.98
臺南市,東區,關聖里,2076,1034,1042,12,2088,4496,0,46.44,23.0
臺南市,東區,衛國里,651,295,356,8,659,1504,0,43.82,19.61
臺南市,東區,崇善里,2199,886,1313,14,2213,4969,0,44.54,17.83
臺南市,東區,富強里,1935,784,1151,16,1951,4395,0,44.39,17.84
臺南市,東區,圍下里,860,359,501,8,868,1797,0,48.3,19.98
臺南市,東區,小東里,1831,914,917,12,1843,4122,0,44.71,22.17
臺南市,東區,大學里,517,241,276,4,521,1038,0,50.19,23.22
臺南市,東區,龍山里,2153,944,1209,11,2164,4589,0,47.16,20.57
臺南市,東區,虎尾里,2275,968,1307,18,2293,5079,0,45.15,19.06
臺南市,東區,德高里,1417,560,857,9,1426,3195,0,44.63,17.53
臺南市,東區,莊敬里,1555,725,830,8,1563,3480,0,44.91,20.83
臺南市,東區,大福里,725,301,424,10,735,1609,0,45.68,18.71
臺南市,東區,忠孝里,1938,949,989,19,1957,4148,0,47.18,22.88
臺南市,東區,崇誨里,1108,577,531,6,1114,2346,0,47.49,24.6
臺南市,東區,東明里,1341,615,726,9,1350,2853,0,47.32,21.56
臺南市,東區,崇德里,2065,970,1095,22,2087,4400,0,47.43,22.05
臺南市,東區,東智里,1205,568,637,7,1212,2747,0,44.12,20.68
臺南市,東區,東聖里,933,390,543,6,939,2206,0,42.57,17.68
臺南市,東區,崇成里,1270,570,700,9,1279,2925,0,43.73,19.49
臺南市,東區,東門里,834,338,496,8,842,1800,0,46.78,18.78
臺南市,東區,成大里,834,399,435,6,840,1924,0,43.66,20.74
臺南市,東區,大同里,1250,549,701,4,1254,2848,0,44.03,19.28
臺南市,東區,德光里,1882,840,1042,9,1891,3861,0,48.98,21.76
臺南市,東區,崇信里,1563,621,942,5,1568,4399,0,35.64,14.12
臺南市,東區,崇文里,2594,1237,1357,12,2606,5808,0,44.87,21.3
臺南市,東區,復興里,1468,572,896,12,1480,3284,0,45.07,17.42
臺南市,東區,裕聖里,2106,1077,1029,18,2124,4654,0,45.64,23.14
臺南市,東區,南聖里,1133,543,590,7,1140,2522,0,45.2,21.53
臺南市,東區,文聖里,1956,907,1049,22,1978,4275,0,46.27,21.22
臺南市,東區,合計,67892,30597,37295,484,68376,151996,183689,44.99,20.13
臺南市,南區,竹溪里,823,388,435,7,830,1623,0,51.14,23.91
臺南市,南區,明德里,547,266,281,5,552,1383,0,39.91,19.23
臺南市,南區,大成里,797,352,445,4,801,1753,0,45.69,20.08
臺南市,南區,廣州里,1076,371,705,13,1089,2226,0,48.92,16.67
臺南市,南區,新昌里,952,371,581,10,962,2173,0,44.27,17.07
臺南市,南區,新興里,1248,479,769,9,1257,2697,0,46.61,17.76
臺南市,南區,田寮里,1377,563,814,7,1384,3096,0,44.7,18.18
臺南市,南區,國宅里,1237,430,807,8,1245,2875,0,43.3,14.96
臺南市,南區,光明里,1772,577,1195,17,1789,4140,0,43.21,13.94
臺南市,南區,明亮里,1582,536,1046,19,1601,3510,0,45.61,15.27
臺南市,南區,喜東里,903,241,662,4,907,2071,0,43.8,11.64
臺南市,南區,喜北里,954,235,719,8,962,2143,0,44.89,10.97
臺南市,南區,喜南里,543,111,432,3,546,1191,0,45.84,9.32
臺南市,南區,省躬里,1477,411,1066,10,1487,3849,0,38.63,10.68
臺南市,南區,興農里,1099,308,791,9,1108,2639,0,41.99,11.67
臺南市,南區,同安里,941,267,674,7,948,2169,0,43.71,12.31
臺南市,南區,佛壇里,1061,256,805,2,1063,2471,0,43.02,10.36
臺南市,南區,大林里,1039,529,510,8,1047,2187,0,47.87,24.19
臺南市,南區,大忠里,2016,878,1138,16,2032,4438,0,45.79,19.78
臺南市,南區,大恩里,1458,667,791,10,1468,3368,0,43.59,19.8
臺南市,南區,新生里,1502,1045,457,18,1520,3347,0,45.41,31.22
臺南市,南區,再興里,1053,519,534,6,1059,2222,0,47.66,23.36
臺南市,南區,明興里,1438,428,1010,8,1446,3277,0,44.13,13.06
臺南市,南區,文華里,1486,574,912,8,1494,3213,0,46.5,17.86
臺南市,南區,金華里,2119,796,1323,20,2139,4948,0,43.23,16.09
臺南市,南區,南都里,929,360,569,14,943,2683,0,35.15,13.42
臺南市,南區,開南里,2359,883,1476,19,2378,5627,0,42.26,15.69
臺南市,南區,彰南里,655,230,425,6,661,1531,0,43.17,15.02
臺南市,南區,建南里,2307,748,1559,19,2326,5014,0,46.39,14.92
臺南市,南區,郡南里,1558,568,990,18,1576,3483,0,45.25,16.31
臺南市,南區,府南里,1932,734,1198,14,1946,4744,0,41.02,15.47
臺南市,南區,文南里,2279,865,1414,12,2291,4978,0,46.02,17.38
臺南市,南區,鯤鯓里,688,249,439,5,693,1717,0,40.36,14.5
臺南市,南區,松安里,814,223,591,9,823,1752,0,46.97,12.73
臺南市,南區,永寧里,771,204,567,8,779,1700,0,45.82,12.0
臺南市,南區,南華里,978,349,629,7,985,2425,0,40.62,14.39
臺南市,南區,鹽埕里,1677,531,1146,10,1687,3641,0,46.33,14.58
臺南市,南區,合計,47447,17542,29905,377,47824,108304,123057,44.16,16.2
臺南市,北區,開元里,1449,632,817,9,1458,3350,0,43.52,18.87
臺南市,北區,東興里,931,507,424,10,941,1911,0,49.24,26.53
臺南市,北區,力行里,1090,530,560,11,1101,2358,0,46.69,22.48
臺南市,北區,振興里,876,350,526,7,883,1929,0,45.78,18.14
臺南市,北區,仁愛里,1089,497,592,9,1098,2173,0,50.53,22.87
臺南市,北區,大豐里,1686,566,1120,6,1692,4183,0,40.45,13.53
臺南市,北區,重興里,882,428,454,5,887,1829,0,48.5,23.4
臺南市,北區,和順里,2202,889,1313,12,2214,4751,0,46.6,18.71
臺南市,北區,正覺里,1380,456,924,15,1395,3128,0,44.6,14.58
臺南市,北區,成功里,1929,688,1241,15,1944,4481,0,43.38,15.35
臺南市,北區,文元里,1442,551,891,12,1454,3391,0,42.88,16.25
臺南市,北區,大港里,2371,928,1443,16,2387,5281,0,45.2,17.57
臺南市,北區,中樓里,655,275,380,6,661,1388,0,47.62,19.81
臺南市,北區,公園里,816,398,418,9,825,1809,0,45.61,22.0
臺南市,北區,元寶里,1596,711,885,11,1607,4041,0,39.77,17.59
臺南市,北區,永祥里,1355,595,760,15,1370,3012,0,45.48,19.75
臺南市,北區,成德里,1903,809,1094,14,1917,4329,0,44.28,18.69
臺南市,北區,文成里,1326,514,812,8,1334,2933,0,45.48,17.52
臺南市,北區,大和里,1548,476,1072,13,1561,3603,0,43.33,13.21
臺南市,北區,賢北里,1646,603,1043,13,1659,3566,0,46.52,16.91
臺南市,北區,長勝里,1708,1071,637,19,1727,3781,0,45.68,28.33
臺南市,北區,合興里,1541,651,890,8,1549,3378,0,45.86,19.27
臺南市,北區,北門里,2194,975,1219,16,2210,5163,0,42.8,18.88
臺南市,北區,小北里,1593,620,973,16,1609,3826,0,42.05,16.2
臺南市,北區,大光里,2032,1213,819,21,2053,4747,0,43.25,25.55
臺南市,北區,大興里,1266,532,734,8,1274,2929,0,43.5,18.16
臺南市,北區,長興里,1127,431,696,8,1135,2655,0,42.75,16.23
臺南市,北區,北華里,1464,555,909,8,1472,3987,0,36.92,13.92
臺南市,北區,華德里,1568,624,944,6,1574,3631,0,43.35,17.19
臺南市,北區,福德里,1951,822,1129,15,1966,4418,0,44.5,18.61
臺南市,北區,立人里,1111,380,731,9,1120,2467,0,45.4,15.4
臺南市,北區,雙安里,1018,436,582,6,1024,2258,0,45.35,19.31
臺南市,北區,元美里,1329,509,820,10,1339,2999,0,44.65,16.97
臺南市,北區,合計,48074,20222,27852,366,48440,109685,129057,44.16,18.44
臺南市,安南區,東和里,1137,407,730,7,1144,2798,0,40.89,14.55
臺南市,安南區,安順里,1905,691,1214,22,1927,4730,0,40.74,14.61
臺南市,安南區,󻕯南里,1795,619,1176,15,1810,4668,0,38.77,13.26
臺南市,安南區,州南里,1973,673,1300,18,1991,5017,0,39.69,13.41
臺南市,安南區,州北里,1819,615,1204,8,1827,4446,0,41.09,13.83
臺南市,安南區,安東里,1180,376,804,10,1190,2762,0,43.08,13.61
臺南市,安南區,安西里,1442,484,958,10,1452,3488,0,41.63,13.88
臺南市,安南區,頂安里,1864,581,1283,24,1888,4518,0,41.79,12.86
臺南市,安南區,安慶里,2499,834,1665,22,2521,6006,0,41.97,13.89
臺南市,安南區,新順里,2498,906,1592,15,2513,6119,0,41.07,14.81
臺南市,安南區,原佃里,866,313,553,6,872,2171,0,40.17,14.42
臺南市,安南區,總頭里,736,217,519,9,745,1811,0,41.14,11.98
臺南市,安南區,長安里,1838,586,1252,9,1847,4706,0,39.25,12.45
臺南市,安南區,公親里,460,140,320,2,462,1148,0,40.24,12.2
臺南市,安南區,海東里,2004,622,1382,7,2011,5528,0,36.38,11.25
臺南市,安南區,海西里,1091,384,707,6,1097,2803,0,39.14,13.7
臺南市,安南區,海南里,1006,333,673,4,1010,2365,0,42.71,14.08
臺南市,安南區,溪心里,2674,948,1726,24,2698,7823,0,34.49,12.12
臺南市,安南區,塩田里,647,285,362,12,659,1587,0,41.52,17.96
臺南市,安南區,淵東里,1714,547,1167,19,1733,4730,0,36.64,11.56
臺南市,安南區,淵西里,1149,367,782,9,1158,3591,0,32.25,10.22
臺南市,安南區,佃東里,1194,401,793,9,1203,3358,0,35.82,11.94
臺南市,安南區,佃西里,713,233,480,8,721,2107,0,34.22,11.06
臺南市,安南區,公󻕯里,444,141,303,6,450,1031,0,43.65,13.68
臺南市,安南區,南興里,645,161,484,8,653,1831,0,35.66,8.79
臺南市,安南區,學東里,794,240,554,9,803,2484,0,32.33,9.66
臺南市,安南區,城東里,526,179,347,3,529,1572,0,33.65,11.39
臺南市,安南區,城北里,587,154,433,9,596,1569,0,37.99,9.82
臺南市,安南區,城中里,400,152,248,5,405,1050,0,38.57,14.48
臺南市,安南區,城南里,1136,347,789,15,1151,3209,0,35.87,10.81
臺南市,安南區,城西里,505,134,371,6,511,1442,0,35.44,9.29
臺南市,安南區,青草里,452,135,317,4,456,1507,0,30.26,8.96
臺南市,安南區,砂崙里,505,146,359,7,512,1292,0,39.63,11.3
臺南市,安南區,鹿耳里,280,116,164,5,285,888,0,32.09,13.06
臺南市,安南區,四草里,741,264,477,2,743,1882,0,39.48,14.03
臺南市,安南區,安和里,893,263,630,5,898,2122,0,42.32,12.39
臺南市,安南區,溪北里,1208,413,795,16,1224,2749,0,44.53,15.02
臺南市,安南區,溪頂里,1883,678,1205,13,1896,4392,0,43.17,15.44
臺南市,安南區,溪墘里,1242,377,865,7,1249,3015,0,41.43,12.5
臺南市,安南區,海佃里,1798,531,1267,13,1811,4278,0,42.33,12.41
臺南市,安南區,幸福里,1560,442,1118,12,1572,3596,0,43.72,12.29
臺南市,安南區,鳳凰里,1663,609,1054,7,1670,4402,0,37.94,13.83
臺南市,安南區,梅花里,1616,565,1051,14,1630,4025,0,40.5,14.04
臺南市,安南區,理想里,1907,580,1327,14,1921,4467,0,43.0,12.98
臺南市,安南區,溪東里,1624,591,1033,9,1633,3943,0,41.42,14.99
臺南市,安南區,淵中里,1258,378,880,11,1269,3321,0,38.21,11.38
臺南市,安南區,布袋里,579,196,383,4,583,1480,0,39.39,13.24
臺南市,安南區,國安里,1143,377,766,13,1156,2718,0,42.53,13.87
臺南市,安南區,安富里,2063,655,1408,20,2083,5393,0,38.62,12.15
臺南市,安南區,大安里,1453,485,968,10,1463,3607,0,40.56,13.45
臺南市,安南區,媽祖宮里,480,186,294,6,486,1456,0,33.38,12.77
臺南市,安南區,合計,63589,21057,42532,528,64117,163001,196238,39.34,12.92
臺南市,安平區,金城里,820,374,446,9,829,2012,0,41.2,18.59
臺南市,安平區,漁光里,197,72,125,3,200,435,0,45.98,16.55
臺南市,安平區,建平里,2093,824,1269,16,2109,5116,0,41.22,16.11
臺南市,安平區,怡平里,1679,693,986,11,1690,4196,0,40.28,16.52
臺南市,安平區,華平里,2013,812,1201,14,2027,4827,0,41.99,16.82
臺南市,安平區,平通里,2720,1111,1609,11,2731,7232,0,37.76,15.36
臺南市,安平區,文平里,2252,967,1285,16,2268,5000,0,45.36,19.34
臺南市,安平區,國平里,3058,1254,1804,20,3078,7593,0,40.54,16.52
臺南市,安平區,育平里,2963,1329,1634,19,2982,7951,0,37.5,16.71
臺南市,安平區,億載里,1310,500,810,6,1316,3031,0,43.42,16.5
臺南市,安平區,平安里,1445,517,928,13,1458,3301,0,44.17,15.66
臺南市,安平區,天妃里,1385,468,917,10,1395,3261,0,42.78,14.35
臺南市,安平區,王城里,1076,363,713,13,1089,2761,0,39.44,13.15
臺南市,安平區,合計,23011,9284,13727,161,23172,56716,67297,40.86,16.37
臺南市,中西區,赤嵌里,1661,585,1076,8,1669,3653,0,45.69,16.01
臺南市,中西區,郡王里,1329,549,780,8,1337,3036,0,44.04,18.08
臺南市,中西區,法華里,1233,553,680,14,1247,2678,0,46.56,20.65
臺南市,中西區,開山里,1002,342,660,8,1010,2406,0,41.98,14.21
臺南市,中西區,永華里,1130,431,699,14,1144,2516,0,45.47,17.13
臺南市,中西區,藥王里,1470,503,967,12,1482,3287,0,45.09,15.3
臺南市,中西區,光賢里,1619,560,1059,14,1633,3479,0,46.94,16.1
臺南市,中西區,大涼里,1119,441,678,14,1133,2515,0,45.05,17.53
臺南市,中西區,西湖里,2632,1105,1527,22,2654,5665,0,46.85,19.51
臺南市,中西區,西賢里,2335,935,1400,10,2345,4932,0,47.55,18.96
臺南市,中西區,城隍里,1648,584,1064,13,1661,3667,0,45.3,15.93
臺南市,中西區,南美里,1374,488,886,3,1377,3143,0,43.81,15.53
臺南市,中西區,南門里,1180,535,645,7,1187,2478,0,47.9,21.59
臺南市,中西區,小西門里,1342,566,776,13,1355,3070,0,44.14,18.44
臺南市,中西區,五條港里,875,320,555,5,880,1972,0,44.62,16.23
臺南市,中西區,兌悅里,1568,491,1077,18,1586,3846,0,41.24,12.77
臺南市,中西區,淺草里,1070,379,691,3,1073,2485,0,43.18,15.25
臺南市,中西區,府前里,830,291,539,7,837,1878,0,44.57,15.5
臺南市,中西區,南廠里,1701,571,1130,10,1711,3913,0,43.73,14.59
臺南市,中西區,西和里,1777,690,1087,12,1789,3847,0,46.5,17.94
臺南市,中西區,合計,28895,10919,17976,215,29110,64466,78163,45.16,16.94
臺南市,合計,合計,648162,241018,407144,6028,654190,1592388,1868739,41.08,15.14
高雄市,鹽埕區,藍橋里,626,204,422,7,633,1261,0,50.2,16.18
高雄市,鹽埕區,慈愛里,156,58,98,0,156,321,0,48.6,18.07
高雄市,鹽埕區,博愛里,326,102,224,5,331,626,0,52.88,16.29
高雄市,鹽埕區,壽星里,538,246,292,8,546,1222,0,44.68,20.13
高雄市,鹽埕區,中山里,597,248,349,6,603,1240,0,48.63,20.0
高雄市,鹽埕區,教仁里,930,356,574,6,936,1941,0,48.22,18.34
高雄市,鹽埕區,新樂里,416,171,245,0,416,805,0,51.68,21.24
高雄市,鹽埕區,中原里,299,100,199,3,302,569,0,53.08,17.57
高雄市,鹽埕區,光明里,580,190,390,5,585,1394,0,41.97,13.63
高雄市,鹽埕區,育仁里,361,133,228,2,363,733,0,49.52,18.14
高雄市,鹽埕區,河濱里,788,304,484,3,791,1581,0,50.03,19.23
高雄市,鹽埕區,沙地里,331,104,227,3,334,721,0,46.32,14.42
高雄市,鹽埕區,南端里,423,157,266,3,426,935,0,45.56,16.79
高雄市,鹽埕區,港都里,501,170,331,3,504,1042,0,48.37,16.31
高雄市,鹽埕區,江西里,489,162,327,1,490,1023,0,47.9,15.84
高雄市,鹽埕區,新豐里,377,154,223,4,381,775,0,49.16,19.87
高雄市,鹽埕區,府北里,862,329,533,6,868,1989,0,43.64,16.54
高雄市,鹽埕區,陸橋里,513,191,322,2,515,1114,0,46.23,17.15
高雄市,鹽埕區,瀨南里,277,98,179,2,279,547,0,51.01,17.92
高雄市,鹽埕區,新化里,271,109,162,4,275,543,0,50.64,20.07
高雄市,鹽埕區,江南里,262,52,210,2,264,569,0,46.4,9.14
高雄市,鹽埕區,合計,9923,3638,6285,75,9998,20951,23272,47.72,17.36
高雄市,鼓山區,鼓峰里,847,478,369,5,852,1923,0,44.31,24.86
高雄市,鼓山區,雄峰里,823,542,281,8,831,1924,0,43.19,28.17
高雄市,鼓山區,前峰里,1950,976,974,12,1962,4040,0,48.56,24.16
高雄市,鼓山區,光榮里,1560,484,1076,8,1568,3318,0,47.26,14.59
高雄市,鼓山區,民族里,638,237,401,6,644,1257,0,51.23,18.85
高雄市,鼓山區,內惟里,486,150,336,2,488,1072,0,45.52,13.99
高雄市,鼓山區,建國里,1083,437,646,8,1091,2405,0,45.36,18.17
高雄市,鼓山區,忠正里,1550,625,925,12,1562,3652,0,42.77,17.11
高雄市,鼓山區,自強里,374,340,34,1,375,703,0,53.34,48.36
高雄市,鼓山區,龍井里,518,198,320,4,522,1210,0,43.14,16.36
高雄市,鼓山區,正德里,854,266,588,11,865,1928,0,44.87,13.8
高雄市,鼓山區,平和里,1603,546,1057,8,1611,3346,0,48.15,16.32
高雄市,鼓山區,民強里,1214,421,793,6,1220,2539,0,48.05,16.58
高雄市,鼓山區,厚生里,1353,469,884,10,1363,2970,0,45.89,15.79
高雄市,鼓山區,龍子里,6601,2987,3614,42,6643,15526,0,42.79,19.24
高雄市,鼓山區,龍水里,9781,4518,5263,47,9828,22850,0,43.01,19.77
高雄市,鼓山區,明誠里,6795,3374,3421,31,6826,16357,0,41.73,20.63
高雄市,鼓山區,華豐里,1643,841,802,13,1656,3836,0,43.17,21.92
高雄市,鼓山區,裕興里,1430,749,681,5,1435,3144,0,45.64,23.82
高雄市,鼓山區,裕豐里,1143,689,454,8,1151,2453,0,46.92,28.09
高雄市,鼓山區,鼓岩里,477,154,323,5,482,1125,0,42.84,13.69
高雄市,鼓山區,樹德里,563,175,388,6,569,1113,0,51.12,15.72
高雄市,鼓山區,寶樹里,515,183,332,7,522,1920,0,27.19,9.53
高雄市,鼓山區,興宗里,559,211,348,6,565,1241,0,45.53,17.0
高雄市,鼓山區,光化里,533,219,314,1,534,1207,0,44.24,18.14
高雄市,鼓山區,山下里,606,271,335,4,610,1306,0,46.71,20.75
高雄市,鼓山區,河邊里,560,221,339,2,562,1301,0,43.2,16.99
高雄市,鼓山區,綠川里,613,213,400,7,620,1361,0,45.55,15.65
高雄市,鼓山區,登山里,255,96,159,3,258,605,0,42.64,15.87
高雄市,鼓山區,峰南里,355,106,249,3,358,778,0,46.02,13.62
高雄市,鼓山區,麗興里,416,141,275,8,424,928,0,45.69,15.19
高雄市,鼓山區,新民里,419,110,309,4,423,955,0,44.29,11.52
高雄市,鼓山區,延平里,361,106,255,5,366,715,0,51.19,14.83
高雄市,鼓山區,維生里,578,199,379,3,581,1190,0,48.82,16.72
高雄市,鼓山區,惠安里,472,137,335,5,477,1102,0,43.28,12.43
高雄市,鼓山區,壽山里,527,144,383,5,532,1307,0,40.7,11.02
高雄市,鼓山區,哨船頭里,429,179,250,3,432,963,0,44.86,18.59
高雄市,鼓山區,桃源里,236,81,155,3,239,527,0,45.35,15.37
高雄市,鼓山區,合計,50720,22273,28447,327,51047,116097,141101,43.97,19.18
高雄市,左營區,進學里,648,307,341,5,653,2636,0,24.77,11.65
高雄市,左營區,尾西里,476,149,327,5,481,973,0,49.43,15.31
高雄市,左營區,頂北里,272,96,176,2,274,512,0,53.52,18.75
高雄市,左營區,中北里,302,69,233,2,304,603,0,50.41,11.44
高雄市,左營區,中南里,244,70,174,1,245,496,0,49.4,14.11
高雄市,左營區,廟東里,409,85,324,3,412,799,0,51.56,10.64
高雄市,左營區,廟北里,404,100,304,4,408,839,0,48.63,11.92
高雄市,左營區,尾南里,325,86,239,3,328,705,0,46.52,12.2
高雄市,左營區,尾北里,1400,531,869,14,1414,3265,0,43.31,16.26
高雄市,左營區,屏山里,639,445,194,13,652,1512,0,43.12,29.43
高雄市,左營區,祥和里,148,117,31,0,148,331,0,44.71,35.35
高雄市,左營區,永清里,189,135,54,2,191,600,0,31.83,22.5
高雄市,左營區,莒光里,732,445,287,3,735,1687,0,43.57,26.38
高雄市,左營區,光輝里,1028,536,492,10,1038,2403,0,43.2,22.31
高雄市,左營區,合群里,1240,1118,122,15,1255,2489,0,50.42,44.92
高雄市,左營區,明建里,289,199,90,2,291,611,0,47.63,32.57
高雄市,左營區,頂西里,444,106,338,6,450,907,0,49.61,11.69
高雄市,左營區,聖后里,367,107,260,2,369,711,0,51.9,15.05
高雄市,左營區,聖西里,156,50,106,0,156,329,0,47.42,15.2
高雄市,左營區,聖南里,251,72,179,4,255,522,0,48.85,13.79
高雄市,左營區,城南里,242,67,175,1,243,491,0,49.49,13.65
高雄市,左營區,路東里,367,112,255,2,369,690,0,53.48,16.23
高雄市,左營區,廍北里,194,34,160,3,197,391,0,50.38,8.7
高雄市,左營區,廍南里,296,100,196,0,296,575,0,51.48,17.39
高雄市,左營區,埤西里,404,170,234,2,406,842,0,48.22,20.19
高雄市,左營區,埤北里,559,336,223,9,568,1260,0,45.08,26.67
高雄市,左營區,埤東里,415,160,255,4,419,920,0,45.54,17.39
高雄市,左營區,海勝里,2708,2208,500,35,2743,5561,0,49.33,39.71
高雄市,左營區,崇實里,1345,790,555,12,1357,3147,0,43.12,25.1
高雄市,左營區,自助里,362,206,156,5,367,907,0,40.46,22.71
高雄市,左營區,果貿里,1268,997,271,6,1274,2680,0,47.54,37.2
高雄市,左營區,果惠里,695,535,160,6,701,1445,0,48.51,37.02
高雄市,左營區,果峰里,664,523,141,5,669,1540,0,43.44,33.96
高雄市,左營區,新下里,5898,2909,2989,50,5948,13601,0,43.73,21.39
高雄市,左營區,新上里,10913,4800,6113,67,10980,25163,0,43.64,19.08
高雄市,左營區,新中里,2175,658,1517,22,2197,4725,0,46.5,13.93
高雄市,左營區,新光里,5746,2659,3087,40,5786,13461,0,42.98,19.75
高雄市,左營區,菜公里,11548,5349,6199,82,11630,28382,0,40.98,18.85
高雄市,左營區,福山里,13778,6710,7068,73,13851,35376,0,39.15,18.97
高雄市,左營區,合計,69540,34146,35394,520,70060,164087,196916,42.7,20.81
高雄市,楠梓區,清豐里,8664,3447,5217,67,8731,21636,0,40.35,15.93
高雄市,楠梓區,東寧里,1754,682,1072,10,1764,4264,0,41.37,15.99
高雄市,楠梓區,五常里,2357,861,1496,20,2377,6356,0,37.4,13.55
高雄市,楠梓區,享平里,1268,440,828,7,1275,3150,0,40.48,13.97
高雄市,楠梓區,中陽里,1327,426,901,17,1344,3252,0,41.33,13.1
高雄市,楠梓區,惠楠里,1042,371,671,8,1050,3163,0,33.2,11.73
高雄市,楠梓區,惠民里,1731,679,1052,22,1753,3884,0,45.13,17.48
高雄市,楠梓區,惠豐里,2017,1022,995,16,2033,4669,0,43.54,21.89
高雄市,楠梓區,錦屏里,1357,362,995,10,1367,2830,0,48.3,12.79
高雄市,楠梓區,玉屏里,1019,227,792,13,1032,2059,0,50.12,11.02
高雄市,楠梓區,金田里,1670,460,1210,16,1686,3828,0,44.04,12.02
高雄市,楠梓區,稔田里,722,154,568,2,724,1375,0,52.65,11.2
高雄市,楠梓區,瑞屏里,1392,526,866,17,1409,3487,0,40.41,15.08
高雄市,楠梓區,翠屏里,6099,3153,2946,35,6134,16189,0,37.89,19.48
高雄市,楠梓區,宏南里,356,194,162,3,359,657,0,54.64,29.53
高雄市,楠梓區,宏毅里,1057,478,579,5,1062,2064,0,51.45,23.16
高雄市,楠梓區,宏榮里,1084,572,512,2,1086,2417,0,44.93,23.67
高雄市,楠梓區,廣昌里,1266,580,686,14,1280,2885,0,44.37,20.1
高雄市,楠梓區,久昌里,1065,501,564,8,1073,2765,0,38.81,18.12
高雄市,楠梓區,大昌里,770,355,415,11,781,2046,0,38.17,17.35
高雄市,楠梓區,福昌里,963,360,603,8,971,2023,0,48.0,17.8
高雄市,楠梓區,盛昌里,2316,1146,1170,14,2330,5347,0,43.58,21.43
高雄市,楠梓區,泰昌里,562,222,340,6,568,1397,0,40.66,15.89
高雄市,楠梓區,興昌里,1807,739,1068,15,1822,4314,0,42.23,17.13
高雄市,楠梓區,建昌里,1073,502,571,4,1077,2534,0,42.5,19.81
高雄市,楠梓區,宏昌里,1395,664,731,6,1401,3221,0,43.5,20.61
高雄市,楠梓區,和昌里,888,416,472,5,893,1997,0,44.72,20.83
高雄市,楠梓區,慶昌里,1538,748,790,6,1544,3122,0,49.46,23.96
高雄市,楠梓區,隆昌里,1391,656,735,12,1403,3235,0,43.37,20.28
高雄市,楠梓區,秀昌里,946,475,471,6,952,2104,0,45.25,22.58
高雄市,楠梓區,裕昌里,1849,781,1068,14,1863,4652,0,40.05,16.79
高雄市,楠梓區,國昌里,1429,624,805,9,1438,3394,0,42.37,18.39
高雄市,楠梓區,加昌里,3347,1710,1637,23,3370,8252,0,40.84,20.72
高雄市,楠梓區,仁昌里,1934,992,942,12,1946,4959,0,39.24,20.0
高雄市,楠梓區,藍田里,2976,1353,1623,22,2998,7507,0,39.94,18.02
高雄市,楠梓區,中興里,697,227,470,6,703,1558,0,45.12,14.57
高雄市,楠梓區,中和里,1434,522,912,10,1444,4154,0,34.76,12.57
高雄市,楠梓區,合計,64562,27627,36935,481,65043,156746,189931,41.5,17.63
高雄市,三民區,鼎金里,1543,543,1000,11,1554,3804,0,40.85,14.27
高雄市,三民區,鼎盛里,3009,1248,1761,20,3029,7370,0,41.1,16.93
高雄市,三民區,鼎強里,1626,599,1027,10,1636,3793,0,43.13,15.79
高雄市,三民區,鼎力里,1698,665,1033,9,1707,3884,0,43.95,17.12
高雄市,三民區,鼎西里,2837,1071,1766,17,2854,7030,0,40.6,15.23
高雄市,三民區,鼎中里,1588,521,1067,11,1599,3436,0,46.54,15.16
高雄市,三民區,鼎泰里,9185,4225,4960,65,9250,20899,0,44.26,20.22
高雄市,三民區,本館里,3542,1374,2168,12,3554,8380,0,42.41,16.4
高雄市,三民區,本和里,3039,1212,1827,18,3057,6992,0,43.72,17.33
高雄市,三民區,本文里,867,340,527,8,875,1915,0,45.69,17.75
高雄市,三民區,本武里,715,237,478,3,718,1561,0,46.0,15.18
高雄市,三民區,本元里,2191,889,1302,19,2210,4987,0,44.32,17.83
高雄市,三民區,本安里,1930,838,1092,7,1937,4277,0,45.29,19.59
高雄市,三民區,本上里,1973,877,1096,11,1984,4461,0,44.47,19.66
高雄市,三民區,本揚里,3227,1370,1857,19,3246,7143,0,45.44,19.18
高雄市,三民區,寶獅里,1625,645,980,4,1629,3486,0,46.73,18.5
高雄市,三民區,寶德里,2078,804,1274,13,2091,4824,0,43.35,16.67
高雄市,三民區,寶泰里,1524,562,962,13,1537,3831,0,40.12,14.67
高雄市,三民區,寶興里,2746,1071,1675,16,2762,6396,0,43.18,16.74
高雄市,三民區,寶中里,1225,443,782,8,1233,2807,0,43.93,15.78
高雄市,三民區,寶華里,1349,620,729,9,1358,3089,0,43.96,20.07
高雄市,三民區,寶國里,3204,1334,1870,19,3223,7514,0,42.89,17.75
高雄市,三民區,寶民里,1222,530,692,11,1233,3030,0,40.69,17.49
高雄市,三民區,寶慶里,1082,428,654,7,1089,2557,0,42.59,16.74
高雄市,三民區,寶業里,2429,1003,1426,12,2441,5630,0,43.36,17.82
高雄市,三民區,寶盛里,2261,963,1298,20,2281,4748,0,48.04,20.28
高雄市,三民區,寶安里,2798,1229,1569,24,2822,6808,0,41.45,18.05
高雄市,三民區,寶龍里,1890,757,1133,13,1903,3982,0,47.79,19.01
高雄市,三民區,寶珠里,2264,894,1370,10,2274,6719,0,33.84,13.31
高雄市,三民區,寶玉里,3290,1384,1906,18,3308,7920,0,41.77,17.47
高雄市,三民區,灣子里,1506,617,889,7,1513,3836,0,39.44,16.08
高雄市,三民區,灣愛里,1011,359,652,15,1026,2898,0,35.4,12.39
高雄市,三民區,灣中里,2023,717,1306,15,2038,5297,0,38.47,13.54
高雄市,三民區,灣華里,1049,410,639,7,1056,2586,0,40.84,15.85
高雄市,三民區,灣勝里,771,213,558,8,779,1821,0,42.78,11.7
高雄市,三民區,灣利里,1428,418,1010,5,1433,3021,0,47.43,13.84
高雄市,三民區,灣復里,1379,532,847,11,1390,3493,0,39.79,15.23
高雄市,三民區,正興里,4713,2006,2707,39,4752,11804,0,40.26,16.99
高雄市,三民區,正順里,1678,677,1001,7,1685,3743,0,45.02,18.09
高雄市,三民區,灣興里,798,273,525,9,807,1778,0,45.39,15.35
高雄市,三民區,灣成里,1015,405,610,7,1022,2499,0,40.9,16.21
高雄市,三民區,安康里,1026,358,668,8,1034,2682,0,38.55,13.35
高雄市,三民區,安寧里,773,271,502,11,784,1744,0,44.95,15.54
高雄市,三民區,安吉里,1851,781,1070,14,1865,4294,0,43.43,18.19
高雄市,三民區,安發里,1912,759,1153,11,1923,4233,0,45.43,17.93
高雄市,三民區,安東里,1416,489,927,7,1423,2893,0,49.19,16.9
高雄市,三民區,安和里,1162,377,785,11,1173,2309,0,50.8,16.33
高雄市,三民區,達德里,641,211,430,2,643,1208,0,53.23,17.47
高雄市,三民區,達明里,718,240,478,9,727,1482,0,49.06,16.19
高雄市,三民區,達仁里,660,227,433,6,666,1379,0,48.3,16.46
高雄市,三民區,達勇里,404,147,257,2,406,882,0,46.03,16.67
高雄市,三民區,同德里,1303,471,832,11,1314,2589,0,50.75,18.19
高雄市,三民區,德智里,989,380,609,7,996,2030,0,49.06,18.72
高雄市,三民區,德仁里,871,331,540,5,876,1812,0,48.34,18.27
高雄市,三民區,安生里,693,224,469,6,699,1339,0,52.2,16.73
高雄市,三民區,德東里,394,127,267,2,396,748,0,52.94,16.98
高雄市,三民區,德行里,571,195,376,4,575,1023,0,56.21,19.06
高雄市,三民區,精華里,698,250,448,3,701,1448,0,48.41,17.27
高雄市,三民區,民享里,1006,330,676,5,1011,1900,0,53.21,17.37
高雄市,三民區,安宜里,1465,492,973,10,1475,2953,0,49.95,16.66
高雄市,三民區,安泰里,1653,651,1002,23,1676,3633,0,46.13,17.92
高雄市,三民區,安邦里,1719,616,1103,14,1733,3606,0,48.06,17.08
高雄市,三民區,十全里,753,233,520,2,755,1671,0,45.18,13.94
高雄市,三民區,十美里,831,294,537,6,837,1690,0,49.53,17.4
高雄市,三民區,德北里,932,361,571,6,938,1992,0,47.09,18.12
高雄市,三民區,立誠里,336,105,231,3,339,659,0,51.44,15.93
高雄市,三民區,立業里,385,122,263,1,386,914,0,42.23,13.35
高雄市,三民區,港東里,590,197,393,4,594,1341,0,44.3,14.69
高雄市,三民區,港新里,628,262,366,3,631,1337,0,47.2,19.6
高雄市,三民區,港西里,333,125,208,3,336,760,0,44.21,16.45
高雄市,三民區,博愛里,537,214,323,6,543,1126,0,48.22,19.01
高雄市,三民區,博惠里,1835,713,1122,16,1851,3922,0,47.2,18.18
高雄市,三民區,長明里,420,182,238,6,426,1008,0,42.26,18.06
高雄市,三民區,建東里,449,198,251,1,450,1147,0,39.23,17.26
高雄市,三民區,興德里,862,360,502,8,870,1905,0,45.67,18.9
高雄市,三民區,鳳南里,457,139,318,6,463,886,0,52.26,15.69
高雄市,三民區,鳳北里,656,207,449,8,664,1307,0,50.8,15.84
高雄市,三民區,德西里,426,166,260,5,431,998,0,43.19,16.63
高雄市,三民區,豐裕里,974,339,635,7,981,2347,0,41.8,14.44
高雄市,三民區,川東里,526,190,336,3,529,1212,0,43.65,15.68
高雄市,三民區,裕民里,504,195,309,3,507,1226,0,41.35,15.91
高雄市,三民區,力行里,494,186,308,2,496,1046,0,47.42,17.78
高雄市,三民區,千歲里,576,225,351,8,584,1082,0,53.97,20.79
高雄市,三民區,立德里,559,218,341,1,560,1156,0,48.44,18.86
高雄市,三民區,千北里,460,154,306,3,463,1009,0,45.89,15.26
高雄市,三民區,千秋里,878,299,579,7,885,1967,0,44.99,15.2
高雄市,三民區,合計,124654,48914,75740,856,125510,285944,334725,43.89,17.11
高雄市,新興區,浩然里,838,405,433,2,840,1749,0,48.03,23.16
高雄市,新興區,振成里,484,211,273,2,486,1026,0,47.37,20.57
高雄市,新興區,德生里,1302,580,722,9,1311,2842,0,46.13,20.41
高雄市,新興區,振華里,493,224,269,3,496,1011,0,49.06,22.16
高雄市,新興區,正氣里,645,274,371,4,649,1282,0,50.62,21.37
高雄市,新興區,德政里,301,158,143,6,307,626,0,49.04,25.24
高雄市,新興區,仁聲里,417,164,253,4,421,979,0,43.0,16.75
高雄市,新興區,德望里,828,343,485,4,832,1808,0,46.02,18.97
高雄市,新興區,華聲里,407,148,259,3,410,902,0,45.45,16.41
高雄市,新興區,蕉園里,358,146,212,7,365,706,0,51.7,20.68
高雄市,新興區,永寧里,593,221,372,7,600,1289,0,46.55,17.15
高雄市,新興區,玉衡里,315,117,198,3,318,736,0,43.21,15.9
高雄市,新興區,順昌里,855,335,520,2,857,1998,0,42.89,16.77
高雄市,新興區,文昌里,1326,557,769,3,1329,2739,0,48.52,20.34
高雄市,新興區,光耀里,1053,467,586,7,1060,2197,0,48.25,21.26
高雄市,新興區,興昌里,782,346,436,9,791,1572,0,50.32,22.01
高雄市,新興區,開平里,1583,693,890,8,1591,3254,0,48.89,21.3
高雄市,新興區,成功里,588,298,290,2,590,1299,0,45.42,22.94
高雄市,新興區,新江里,454,160,294,6,460,1074,0,42.83,14.9
高雄市,新興區,黎明里,382,146,236,6,388,801,0,48.44,18.23
高雄市,新興區,愛平里,437,167,270,2,439,996,0,44.08,16.77
高雄市,新興區,南港里,988,328,660,8,996,1859,0,53.58,17.64
高雄市,新興區,中東里,1075,476,599,4,1079,2712,0,39.79,17.55
高雄市,新興區,明莊里,308,114,194,1,309,692,0,44.65,16.47
高雄市,新興區,大明里,473,180,293,6,479,1021,0,46.91,17.63
高雄市,新興區,秋山里,415,155,260,4,419,960,0,43.65,16.15
高雄市,新興區,長驛里,386,152,234,6,392,934,0,41.97,16.27
高雄市,新興區,建興里,386,142,244,1,387,919,0,42.11,15.45
高雄市,新興區,建華里,388,123,265,3,391,785,0,49.81,15.67
高雄市,新興區,漢民里,328,118,210,1,329,685,0,48.03,17.23
高雄市,新興區,榮治里,333,160,173,1,334,702,0,47.58,22.79
高雄市,新興區,東坡里,575,187,388,3,578,1152,0,50.17,16.23
高雄市,新興區,合計,20096,8295,11801,137,20233,43307,49925,46.72,19.15
高雄市,前金區,三川里,324,88,236,4,328,658,0,49.85,13.37
高雄市,前金區,草江里,487,223,264,4,491,983,0,49.95,22.69
高雄市,前金區,長城里,580,202,378,6,586,1310,0,44.73,15.42
高雄市,前金區,北金里,372,136,236,1,373,809,0,46.11,16.81
高雄市,前金區,東金里,473,171,302,1,474,957,0,49.53,17.87
高雄市,前金區,新生里,1629,743,886,6,1635,3581,0,45.66,20.75
高雄市,前金區,後金里,309,136,173,2,311,662,0,46.98,20.54
高雄市,前金區,長興里,531,230,301,4,535,1150,0,46.52,20.0
高雄市,前金區,青山里,810,320,490,11,821,1817,0,45.18,17.61
高雄市,前金區,民生里,350,160,190,1,351,778,0,45.12,20.57
高雄市,前金區,復元里,477,203,274,3,480,992,0,48.39,20.46
高雄市,前金區,林投里,403,143,260,3,406,1030,0,39.42,13.88
高雄市,前金區,國民里,412,165,247,2,414,901,0,45.95,18.31
高雄市,前金區,社東里,678,319,359,4,682,1424,0,47.89,22.4
高雄市,前金區,社西里,507,238,269,3,510,1017,0,50.15,23.4
高雄市,前金區,博孝里,465,191,274,2,467,986,0,47.36,19.37
高雄市,前金區,長生里,823,375,448,3,826,1640,0,50.37,22.87
高雄市,前金區,榮復里,487,198,289,4,491,1043,0,47.08,18.98
高雄市,前金區,文西里,448,170,278,5,453,941,0,48.14,18.07
高雄市,前金區,文東里,539,222,317,5,544,1108,0,49.1,20.04
高雄市,前金區,合計,11104,4633,6471,74,11178,23787,26498,46.99,19.48
高雄市,苓雅區,博仁里,337,158,179,4,341,681,0,50.07,23.2
高雄市,苓雅區,苓洲里,623,292,331,7,630,1496,0,42.11,19.52
高雄市,苓雅區,苓昇里,503,215,288,5,508,1147,0,44.29,18.74
高雄市,苓雅區,苓中里,704,272,432,10,714,1552,0,46.01,17.53
高雄市,苓雅區,苓雅里,607,277,330,4,611,1384,0,44.15,20.01
高雄市,苓雅區,苓東里,602,204,398,2,604,1405,0,42.99,14.52
高雄市,苓雅區,城北里,659,273,386,3,662,1540,0,42.99,17.73
高雄市,苓雅區,城西里,258,102,156,2,260,506,0,51.38,20.16
高雄市,苓雅區,城東里,797,334,463,9,806,1861,0,43.31,17.95
高雄市,苓雅區,意誠里,1385,657,728,9,1394,3663,0,38.06,17.94
高雄市,苓雅區,鼓中里,411,150,261,1,412,878,0,46.92,17.08
高雄市,苓雅區,田西里,605,258,347,8,613,1259,0,48.69,20.49
高雄市,苓雅區,人和里,719,286,433,8,727,1714,0,42.42,16.69
高雄市,苓雅區,仁政里,634,288,346,5,639,1191,0,53.65,24.18
高雄市,苓雅區,廣澤里,817,293,524,5,822,1686,0,48.75,17.38
高雄市,苓雅區,美田里,490,208,282,4,494,1085,0,45.53,19.17
高雄市,苓雅區,華堂里,1374,587,787,9,1383,2948,0,46.91,19.91
高雄市,苓雅區,日中里,1002,390,612,3,1005,2080,0,48.32,18.75
高雄市,苓雅區,普照里,1391,570,821,5,1396,2971,0,46.99,19.19
高雄市,苓雅區,和煦里,900,392,508,4,904,1962,0,46.08,19.98
高雄市,苓雅區,晴朗里,754,330,424,4,758,2551,0,29.71,12.94
高雄市,苓雅區,普天里,1567,689,878,10,1577,3394,0,46.46,20.3
高雄市,苓雅區,林富里,1030,444,586,6,1036,2101,0,49.31,21.13
高雄市,苓雅區,林圍里,1061,514,547,5,1066,2233,0,47.74,23.02
高雄市,苓雅區,林安里,650,312,338,2,652,1434,0,45.47,21.76
高雄市,苓雅區,光華里,318,106,212,5,323,666,0,48.5,15.92
高雄市,苓雅區,林興里,556,166,390,3,559,1226,0,45.6,13.54
高雄市,苓雅區,林華里,1215,456,759,6,1221,2632,0,46.39,17.33
高雄市,苓雅區,林西里,665,276,389,2,667,1516,0,44.0,18.21
高雄市,苓雅區,林中里,1250,504,746,9,1259,2734,0,46.05,18.43
高雄市,苓雅區,林泉里,876,423,453,5,881,1845,0,47.75,22.93
高雄市,苓雅區,林南里,1308,655,653,6,1314,2771,0,47.42,23.64
高雄市,苓雅區,中正里,1263,558,705,14,1277,2724,0,46.88,20.48
高雄市,苓雅區,尚義里,691,294,397,9,700,1480,0,47.3,19.86
高雄市,苓雅區,同慶里,987,472,515,8,995,2090,0,47.61,22.58
高雄市,苓雅區,凱旋里,940,496,444,2,942,2096,0,44.94,23.66
高雄市,苓雅區,安祥里,1103,482,621,11,1114,2380,0,46.81,20.25
高雄市,苓雅區,奏捷里,710,338,372,7,717,1489,0,48.15,22.7
高雄市,苓雅區,福壽里,680,212,468,6,686,1389,0,49.39,15.26
高雄市,苓雅區,福南里,787,301,486,10,797,1620,0,49.2,18.58
高雄市,苓雅區,五權里,1093,483,610,11,1104,2086,0,52.92,23.15
高雄市,苓雅區,民主里,1732,731,1001,16,1748,3752,0,46.59,19.48
高雄市,苓雅區,林德里,832,370,462,4,836,1742,0,47.99,21.24
高雄市,苓雅區,林貴里,775,338,437,6,781,1748,0,44.68,19.34
高雄市,苓雅區,林榮里,1663,762,901,12,1675,3776,0,44.36,20.18
高雄市,苓雅區,英明里,812,307,505,10,822,1791,0,45.9,17.14
高雄市,苓雅區,林靖里,731,419,312,12,743,1489,0,49.9,28.14
高雄市,苓雅區,朝陽里,618,245,373,4,622,1371,0,45.37,17.87
高雄市,苓雅區,福隆里,1129,398,731,11,1140,2410,0,47.3,16.51
高雄市,苓雅區,福祥里,527,240,287,3,530,1158,0,45.77,20.73
高雄市,苓雅區,福海里,456,232,224,1,457,1023,0,44.67,22.68
高雄市,苓雅區,福康里,853,285,568,8,861,1787,0,48.18,15.95
高雄市,苓雅區,福人里,822,346,476,7,829,1974,0,42.0,17.53
高雄市,苓雅區,福地里,1067,446,621,13,1080,2537,0,42.57,17.58
高雄市,苓雅區,福居里,1065,372,693,3,1068,2583,0,41.35,14.4
高雄市,苓雅區,福東里,1093,466,627,9,1102,2521,0,43.71,18.48
高雄市,苓雅區,福西里,781,288,493,7,788,1685,0,46.77,17.09
高雄市,苓雅區,永康里,983,440,543,6,989,2051,0,48.22,21.45
高雄市,苓雅區,正文里,991,412,579,6,997,2240,0,44.51,18.39
高雄市,苓雅區,正言里,1202,513,689,7,1209,2641,0,45.78,19.42
高雄市,苓雅區,正大里,1996,966,1030,16,2012,4822,0,41.73,20.03
高雄市,苓雅區,五福里,1630,700,930,18,1648,3581,0,46.02,19.55
高雄市,苓雅區,正心里,1596,709,887,9,1605,3399,0,47.22,20.86
高雄市,苓雅區,正道里,1721,733,988,11,1732,4055,0,42.71,18.08
高雄市,苓雅區,正義里,1159,429,730,5,1164,2329,0,49.98,18.42
高雄市,苓雅區,正仁里,1007,454,553,5,1012,2409,0,42.01,18.85
高雄市,苓雅區,文昌里,1544,557,987,14,1558,3573,0,43.6,15.59
高雄市,苓雅區,建軍里,801,307,494,5,806,1945,0,41.44,15.78
高雄市,苓雅區,衛武里,884,423,461,7,891,1894,0,47.04,22.33
高雄市,苓雅區,合計,64792,27605,37187,483,65275,143752,166008,45.41,19.2
高雄市,前鎮區,草衙里,3572,1141,2431,42,3614,9285,0,38.92,12.29
高雄市,前鎮區,明孝里,980,309,671,8,988,2288,0,43.18,13.51
高雄市,前鎮區,明正里,2216,728,1488,22,2238,4994,0,44.81,14.58
高雄市,前鎮區,明義里,982,344,638,7,989,2203,0,44.89,15.62
高雄市,前鎮區,仁愛里,569,159,410,4,573,1263,0,45.37,12.59
高雄市,前鎮區,德昌里,731,280,451,8,739,1891,0,39.08,14.81
高雄市,前鎮區,平等里,853,273,580,10,863,2883,0,29.93,9.47
高雄市,前鎮區,平昌里,243,59,184,4,247,606,0,40.76,9.74
高雄市,前鎮區,明禮里,622,160,462,10,632,1420,0,44.51,11.27
高雄市,前鎮區,信義里,632,178,454,8,640,1365,0,46.89,13.04
高雄市,前鎮區,信德里,915,309,606,8,923,2203,0,41.9,14.03
高雄市,前鎮區,明道里,444,114,330,5,449,1033,0,43.47,11.04
高雄市,前鎮區,興化里,313,100,213,4,317,656,0,48.32,15.24
高雄市,前鎮區,興仁里,311,74,237,0,311,673,0,46.21,11.0
高雄市,前鎮區,前鎮里,596,175,421,8,604,1293,0,46.71,13.53
高雄市,前鎮區,鎮東里,829,238,591,7,836,1636,0,51.1,14.55
高雄市,前鎮區,鎮榮里,911,265,646,10,921,2041,0,45.12,12.98
高雄市,前鎮區,鎮昌里,856,269,587,8,864,1918,0,45.05,14.03
高雄市,前鎮區,鎮海里,1753,646,1107,11,1764,3979,0,44.33,16.24
高雄市,前鎮區,鎮陽里,399,154,245,4,403,902,0,44.68,17.07
高雄市,前鎮區,興邦里,1249,572,677,9,1258,2779,0,45.27,20.58
高雄市,前鎮區,鎮中里,367,127,240,0,367,802,0,45.76,15.84
高雄市,前鎮區,鎮北里,498,183,315,7,505,1077,0,46.89,16.99
高雄市,前鎮區,忠純里,2522,1732,790,28,2550,5166,0,49.36,33.53
高雄市,前鎮區,忠誠里,983,814,169,15,998,1970,0,50.66,41.32
高雄市,前鎮區,西山里,1470,666,804,6,1476,3261,0,45.26,20.42
高雄市,前鎮區,民權里,1925,981,944,14,1939,3898,0,49.74,25.17
高雄市,前鎮區,建隆里,584,265,319,8,592,1249,0,47.4,21.22
高雄市,前鎮區,振興里,1005,470,535,5,1010,2251,0,44.87,20.88
高雄市,前鎮區,良和里,1358,716,642,4,1362,2750,0,49.53,26.04
高雄市,前鎮區,西甲里,902,334,568,10,912,2053,0,44.42,16.27
高雄市,前鎮區,盛興里,1112,541,571,2,1114,2633,0,42.31,20.55
高雄市,前鎮區,盛豐里,1303,530,773,7,1310,2968,0,44.14,17.86
高雄市,前鎮區,興中里,1304,548,756,6,1310,2985,0,43.89,18.36
高雄市,前鎮區,興東里,2493,1096,1397,12,2505,5492,0,45.61,19.96
高雄市,前鎮區,忠孝里,1376,662,714,9,1385,2994,0,46.26,22.11
高雄市,前鎮區,復國里,1177,446,731,9,1186,2585,0,45.88,17.25
高雄市,前鎮區,竹內里,1238,413,825,15,1253,2634,0,47.57,15.68
高雄市,前鎮區,竹東里,924,363,561,3,927,2104,0,44.06,17.25
高雄市,前鎮區,竹南里,2893,1245,1648,15,2908,6665,0,43.63,18.68
高雄市,前鎮區,竹北里,997,415,582,11,1008,2331,0,43.24,17.8
高雄市,前鎮區,竹西里,1830,796,1034,11,1841,3965,0,46.43,20.08
高雄市,前鎮區,竹中里,1533,636,897,9,1542,3340,0,46.17,19.04
高雄市,前鎮區,瑞竹里,644,229,415,6,650,1563,0,41.59,14.65
高雄市,前鎮區,瑞南里,1917,656,1261,12,1929,4567,0,42.24,14.36
高雄市,前鎮區,瑞豐里,1084,391,693,10,1094,2650,0,41.28,14.75
高雄市,前鎮區,瑞祥里,1889,741,1148,14,1903,4492,0,42.36,16.5
高雄市,前鎮區,瑞東里,936,297,639,9,945,2252,0,41.96,13.19
高雄市,前鎮區,瑞和里,788,249,539,6,794,1810,0,43.87,13.76
高雄市,前鎮區,瑞平里,1596,588,1008,14,1610,3473,0,46.36,16.93
高雄市,前鎮區,瑞隆里,1493,540,953,11,1504,3408,0,44.13,15.85
高雄市,前鎮區,瑞北里,1350,445,905,15,1365,3140,0,43.47,14.17
高雄市,前鎮區,瑞西里,1059,299,760,14,1073,2484,0,43.2,12.04
高雄市,前鎮區,瑞崗里,1139,395,744,7,1146,2474,0,46.32,15.97
高雄市,前鎮區,瑞興里,1077,336,741,10,1087,2446,0,44.44,13.74
高雄市,前鎮區,瑞誠里,1066,422,644,11,1077,2518,0,42.77,16.76
高雄市,前鎮區,瑞文里,988,311,677,6,994,2355,0,42.21,13.21
高雄市,前鎮區,瑞華里,1954,764,1190,15,1969,4394,0,44.81,17.39
高雄市,前鎮區,瑞昌里,1314,429,885,10,1324,3072,0,43.1,13.96
高雄市,前鎮區,合計,70064,27618,42446,573,70637,159582,184355,44.26,17.31
高雄市,旗津區,旗下里,510,138,372,5,515,1181,0,43.61,11.69
高雄市,旗津區,永安里,384,141,243,4,388,1056,0,36.74,13.35
高雄市,旗津區,振興里,619,180,439,9,628,1544,0,40.67,11.66
高雄市,旗津區,慈愛里,790,229,561,5,795,2240,0,35.49,10.22
高雄市,旗津區,復興里,985,411,574,16,1001,2922,0,34.26,14.07
高雄市,旗津區,中華里,639,172,467,2,641,1497,0,42.82,11.49
高雄市,旗津區,實踐里,505,308,197,9,514,1394,0,36.87,22.09
高雄市,旗津區,北汕里,866,280,586,12,878,2620,0,33.51,10.69
高雄市,旗津區,南汕里,777,129,648,11,788,2021,0,38.99,6.38
高雄市,旗津區,上竹里,1033,231,802,9,1042,2749,0,37.9,8.4
高雄市,旗津區,中洲里,740,198,542,4,744,1802,0,41.29,10.99
高雄市,旗津區,安順里,331,63,268,1,332,863,0,38.47,7.3
高雄市,旗津區,中興里,1014,256,758,5,1019,2457,0,41.47,10.42
高雄市,旗津區,合計,9193,2736,6457,92,9285,24346,27515,38.14,11.24
高雄市,小港區,小港里,979,366,613,8,987,2204,0,44.78,16.61
高雄市,小港區,港口里,1374,638,736,8,1382,3080,0,44.87,20.71
高雄市,小港區,港正里,1001,480,521,5,1006,2455,0,40.98,19.55
高雄市,小港區,港墘里,658,248,410,3,661,1658,0,39.87,14.96
高雄市,小港區,港明里,1120,400,720,10,1130,3006,0,37.59,13.31
高雄市,小港區,港后里,1090,394,696,5,1095,2482,0,44.12,15.87
高雄市,小港區,港南里,901,324,577,3,904,2715,0,33.3,11.93
高雄市,小港區,港興里,1012,378,634,8,1020,2209,0,46.17,17.11
高雄市,小港區,鳳宮里,990,338,652,9,999,2601,0,38.41,13.0
高雄市,小港區,店鎮里,2247,805,1442,19,2266,5620,0,40.32,14.32
高雄市,小港區,大苓里,1051,402,649,10,1061,2419,0,43.86,16.62
高雄市,小港區,二苓里,1411,455,956,12,1423,3563,0,39.94,12.77
高雄市,小港區,三苓里,1188,438,750,7,1195,2779,0,43.0,15.76
高雄市,小港區,正苓里,1471,633,838,12,1483,3906,0,37.97,16.21
高雄市,小港區,順苓里,1716,684,1032,15,1731,4344,0,39.85,15.75
高雄市,小港區,六苓里,1085,409,676,7,1092,2502,0,43.65,16.35
高雄市,小港區,宏亮里,1212,456,756,6,1218,3165,0,38.48,14.41
高雄市,小港區,山東里,1142,540,602,6,1148,2869,0,40.01,18.82
高雄市,小港區,青島里,1003,598,405,12,1015,2305,0,44.03,25.94
高雄市,小港區,濟南里,1661,785,876,15,1676,4066,0,41.22,19.31
高雄市,小港區,泰山里,1332,490,842,12,1344,3176,0,42.32,15.43
高雄市,小港區,山明里,4224,1472,2752,35,4259,11217,0,37.97,13.12
高雄市,小港區,高松里,1596,571,1025,10,1606,4154,0,38.66,13.75
高雄市,小港區,松金里,1006,362,644,6,1012,2549,0,39.7,14.2
高雄市,小港區,松山里,1324,520,804,18,1342,3066,0,43.77,16.96
高雄市,小港區,大坪里,1116,371,745,12,1128,2844,0,39.66,13.05
高雄市,小港區,坪頂里,2183,764,1419,15,2198,6006,0,36.6,12.72
高雄市,小港區,孔宅里,1930,724,1206,17,1947,4655,0,41.83,15.55
高雄市,小港區,廈莊里,1475,583,892,21,1496,3839,0,38.97,15.19
高雄市,小港區,合作里,1146,383,763,5,1151,2569,0,44.8,14.91
高雄市,小港區,桂林里,3069,1089,1980,25,3094,7687,0,40.25,14.17
高雄市,小港區,中厝里,1362,507,855,9,1371,3630,0,37.77,13.97
高雄市,小港區,鳳鳴里,1212,427,785,17,1229,3132,0,39.24,13.63
高雄市,小港區,龍鳳里,1190,396,794,7,1197,3059,0,39.13,12.95
高雄市,小港區,鳳森里,896,249,647,8,904,2196,0,41.17,11.34
高雄市,小港區,鳳林里,1208,342,866,6,1214,3013,0,40.29,11.35
高雄市,小港區,鳳興里,925,264,661,10,935,2483,0,37.66,10.63
高雄市,小港區,鳳源里,1340,327,1013,14,1354,3605,0,37.56,9.07
高雄市,小港區,合計,52846,19612,33234,427,53273,132828,156580,40.11,14.76
高雄市,鳳山區,縣口里,174,68,106,2,176,406,0,43.35,16.75
高雄市,鳳山區,成功里,275,99,176,6,281,599,0,46.91,16.53
高雄市,鳳山區,光明里,570,233,337,8,578,1288,0,44.88,18.09
高雄市,鳳山區,興中里,428,213,215,2,430,847,0,50.77,25.15
高雄市,鳳山區,南興里,414,161,253,1,415,864,0,48.03,18.63
高雄市,鳳山區,和德里,964,450,514,6,970,2199,0,44.11,20.46
高雄市,鳳山區,鳳崗里,491,236,255,3,494,1023,0,48.29,23.07
高雄市,鳳山區,中和里,1591,804,787,9,1600,3304,0,48.43,24.33
高雄市,鳳山區,鎮北里,3716,1486,2230,29,3745,10134,0,36.95,14.66
高雄市,鳳山區,縣衙里,360,177,183,1,361,800,0,45.13,22.13
高雄市,鳳山區,文英里,1508,610,898,15,1523,3583,0,42.51,17.02
高雄市,鳳山區,鎮西里,2155,904,1251,18,2173,4831,0,44.98,18.71
高雄市,鳳山區,鎮東里,957,399,558,2,959,2419,0,39.64,16.49
高雄市,鳳山區,埤頂里,2506,1233,1273,18,2524,5862,0,43.06,21.03
高雄市,鳳山區,中正里,1868,1518,350,24,1892,4101,0,46.14,37.02
高雄市,鳳山區,鎮南里,1965,741,1224,22,1987,4690,0,42.37,15.8
高雄市,鳳山區,老爺里,2792,933,1859,20,2812,6676,0,42.12,13.98
高雄市,鳳山區,瑞竹里,2121,990,1131,14,2135,5045,0,42.32,19.62
高雄市,鳳山區,忠義里,2046,959,1087,22,2068,4468,0,46.28,21.46
高雄市,鳳山區,誠義里,1683,890,793,14,1697,3708,0,45.77,24.0
高雄市,鳳山區,新興里,712,281,431,7,719,3408,0,21.1,8.25
高雄市,鳳山區,海光里,1256,715,541,8,1264,2855,0,44.27,25.04
高雄市,鳳山區,忠誠里,1492,578,914,12,1504,3386,0,44.42,17.07
高雄市,鳳山區,新甲里,1334,520,814,19,1353,2970,0,45.56,17.51
高雄市,鳳山區,武漢里,2005,772,1233,14,2019,4656,0,43.36,16.58
高雄市,鳳山區,正義里,2610,900,1710,21,2631,6047,0,43.51,14.88
高雄市,鳳山區,一甲里,1261,408,853,8,1269,3158,0,40.18,12.92
高雄市,鳳山區,福興里,2329,790,1539,23,2352,5638,0,41.72,14.01
高雄市,鳳山區,東門里,2216,1220,996,25,2241,5295,0,42.32,23.04
高雄市,鳳山區,瑞興里,2016,1031,985,16,2032,4791,0,42.41,21.52
高雄市,鳳山區,天興里,1506,533,973,7,1513,3443,0,43.94,15.48
高雄市,鳳山區,新強里,2309,954,1355,11,2320,5183,0,44.76,18.41
高雄市,鳳山區,國泰里,1588,718,870,15,1603,3682,0,43.54,19.5
高雄市,鳳山區,鳳東里,2671,1195,1476,26,2697,6156,0,43.81,19.41
高雄市,鳳山區,新富里,1646,609,1037,8,1654,3986,0,41.5,15.28
高雄市,鳳山區,國光里,1481,661,820,7,1488,3202,0,46.47,20.64
高雄市,鳳山區,國隆里,1065,363,702,8,1073,2412,0,44.49,15.05
高雄市,鳳山區,文德里,3793,1840,1953,22,3815,8807,0,43.32,20.89
高雄市,鳳山區,過埤里,5101,2126,2975,32,5133,13720,0,37.41,15.5
高雄市,鳳山區,曹公里,873,409,464,10,883,1878,0,47.02,21.78
高雄市,鳳山區,興仁里,1518,659,859,13,1531,3300,0,46.39,19.97
高雄市,鳳山區,五福里,1320,490,830,13,1333,2954,0,45.13,16.59
高雄市,鳳山區,忠孝里,2446,1149,1297,13,2459,5599,0,43.92,20.52
高雄市,鳳山區,生明里,890,496,394,9,899,1995,0,45.06,24.86
高雄市,鳳山區,和興里,2045,881,1164,11,2056,4606,0,44.64,19.13
高雄市,鳳山區,協和里,1464,775,689,17,1481,3154,0,46.96,24.57
高雄市,鳳山區,文山里,2711,1051,1660,22,2733,6154,0,44.41,17.08
高雄市,鳳山區,福誠里,1963,726,1237,18,1981,4554,0,43.5,15.94
高雄市,鳳山區,誠德里,1010,567,443,15,1025,2537,0,40.4,22.35
高雄市,鳳山區,三民里,505,216,289,7,512,1040,0,49.23,20.77
高雄市,鳳山區,北門里,1666,662,1004,16,1682,3969,0,42.38,16.68
高雄市,鳳山區,富甲里,729,282,447,9,738,1831,0,40.31,15.4
高雄市,鳳山區,南成里,3515,1217,2298,28,3543,8197,0,43.22,14.85
高雄市,鳳山區,文華里,3602,1916,1686,32,3634,8181,0,44.42,23.42
高雄市,鳳山區,大德里,1701,599,1102,17,1718,4349,0,39.5,13.77
高雄市,鳳山區,武松里,1049,414,635,4,1053,2612,0,40.31,15.85
高雄市,鳳山區,文衡里,1684,773,911,10,1694,4036,0,41.97,19.15
高雄市,鳳山區,文福里,4071,1952,2119,30,4101,9452,0,43.39,20.65
高雄市,鳳山區,誠信里,811,511,300,8,819,2046,0,40.03,24.98
高雄市,鳳山區,誠智里,1070,598,472,10,1080,2686,0,40.21,22.26
高雄市,鳳山區,國富里,1181,581,600,5,1186,2531,0,46.86,22.96
高雄市,鳳山區,武慶里,1010,401,609,6,1016,2292,0,44.33,17.5
高雄市,鳳山區,海洋里,1670,686,984,13,1683,3737,0,45.04,18.36
高雄市,鳳山區,新武里,1042,359,683,11,1053,2353,0,44.75,15.26
高雄市,鳳山區,新樂里,1819,764,1055,2,1821,4273,0,42.62,17.88
高雄市,鳳山區,新泰里,1638,731,907,10,1648,4006,0,41.14,18.25
高雄市,鳳山區,中崙里,1067,482,585,5,1072,2454,0,43.68,19.64
高雄市,鳳山區,中榮里,1744,745,999,9,1753,4441,0,39.47,16.78
高雄市,鳳山區,中民里,1829,682,1147,19,1848,4469,0,41.35,15.26
高雄市,鳳山區,二甲里,1918,708,1210,14,1932,4472,0,43.2,15.83
高雄市,鳳山區,龍成里,1133,374,759,5,1138,2740,0,41.53,13.65
高雄市,鳳山區,富榮里,985,388,597,7,992,2367,0,41.91,16.39
高雄市,鳳山區,善美里,2062,782,1280,16,2078,5524,0,37.62,14.16
高雄市,鳳山區,南和里,1101,396,705,10,1111,2597,0,42.78,15.25
高雄市,鳳山區,福祥里,1095,338,757,6,1101,2652,0,41.52,12.75
高雄市,鳳山區,保安里,2640,1001,1639,19,2659,6389,0,41.62,15.67
高雄市,鳳山區,合計,127552,55079,72473,994,128546,302069,358785,42.56,18.23
高雄市,林園區,東林里,1017,321,696,10,1027,2799,0,36.69,11.47
高雄市,林園區,林園里,1244,429,815,17,1261,3070,0,41.07,13.97
高雄市,林園區,溪州里,1532,476,1056,21,1553,4129,0,37.61,11.53
高雄市,林園區,潭頭里,1061,400,661,17,1078,2749,0,39.21,14.55
高雄市,林園區,中厝里,1235,479,756,19,1254,2981,0,42.07,16.07
高雄市,林園區,中門里,985,334,651,16,1001,2474,0,40.46,13.5
高雄市,林園區,頂厝里,1769,542,1227,22,1791,4546,0,39.4,11.92
高雄市,林園區,港埔里,751,205,546,11,762,1795,0,42.45,11.42
高雄市,林園區,西溪里,1299,341,958,19,1318,3401,0,38.75,10.03
高雄市,林園區,港嘴里,704,174,530,9,713,1671,0,42.67,10.41
高雄市,林園區,北汕里,527,190,337,3,530,1576,0,33.63,12.06
高雄市,林園區,林內里,717,314,403,6,723,1960,0,36.89,16.02
高雄市,林園區,王公里,1618,596,1022,12,1630,4087,0,39.88,14.58
高雄市,林園區,林家里,481,160,321,1,482,1274,0,37.83,12.56
高雄市,林園區,龔厝里,854,245,609,5,859,1939,0,44.3,12.64
高雄市,林園區,鳳芸里,713,182,531,8,721,1726,0,41.77,10.54
高雄市,林園區,中芸里,693,161,532,8,701,1767,0,39.67,9.11
高雄市,林園區,東汕里,320,94,226,1,321,883,0,36.35,10.65
高雄市,林園區,西汕里,263,64,199,1,264,729,0,36.21,8.78
高雄市,林園區,仁愛里,1199,353,846,13,1212,2918,0,41.54,12.1
高雄市,林園區,文賢里,1009,397,612,14,1023,2393,0,42.75,16.59
高雄市,林園區,廣應里,1333,435,898,17,1350,3366,0,40.11,12.92
高雄市,林園區,五福里,852,271,581,9,861,2660,0,32.37,10.19
高雄市,林園區,中汕里,766,161,605,11,777,2268,0,34.26,7.1
高雄市,林園區,合計,22942,7324,15618,270,23212,59161,69161,39.24,12.38
高雄市,大寮區,拷潭里,588,158,430,9,597,1391,0,42.92,11.36
高雄市,大寮區,內坑里,2102,816,1286,16,2118,5790,0,36.58,14.09
高雄市,大寮區,大寮里,2388,753,1635,38,2426,6676,0,36.34,11.28
高雄市,大寮區,上寮里,981,276,705,11,992,2414,0,41.09,11.43
高雄市,大寮區,三隆里,1877,627,1250,13,1890,4615,0,40.95,13.59
高雄市,大寮區,琉球里,1970,569,1401,18,1988,4639,0,42.85,12.27
高雄市,大寮區,翁園里,1752,461,1291,16,1768,3885,0,45.51,11.87
高雄市,大寮區,前庄里,1081,453,628,16,1097,2318,0,47.33,19.54
高雄市,大寮區,中庄里,4179,1488,2691,40,4219,10756,0,39.22,13.83
高雄市,大寮區,後庄里,3081,1247,1834,32,3113,7626,0,40.82,16.35
高雄市,大寮區,義仁里,752,223,529,8,760,1803,0,42.15,12.37
高雄市,大寮區,新厝里,592,183,409,7,599,1666,0,35.95,10.98
高雄市,大寮區,過溪里,995,328,667,8,1003,2472,0,40.57,13.27
高雄市,大寮區,潮寮里,1184,316,868,13,1197,2917,0,41.04,10.83
高雄市,大寮區,會結里,592,202,390,3,595,1538,0,38.69,13.13
高雄市,大寮區,會社里,2343,992,1351,19,2362,6229,0,37.92,15.93
高雄市,大寮區,山頂里,2962,1452,1510,32,2994,7455,0,40.16,19.48
高雄市,大寮區,忠義里,246,159,87,2,248,541,0,45.84,29.39
高雄市,大寮區,永芳里,2765,1043,1722,24,2789,6812,0,40.94,15.31
高雄市,大寮區,義和里,954,281,673,13,967,2201,0,43.93,12.77
高雄市,大寮區,溪寮里,677,227,450,5,682,1545,0,44.14,14.69
高雄市,大寮區,江山里,824,260,564,7,831,1851,0,44.89,14.05
高雄市,大寮區,昭明里,1402,417,985,11,1413,3723,0,37.95,11.2
高雄市,大寮區,光武里,41,28,13,5,46,111,0,41.44,25.23
高雄市,大寮區,中興里,2753,1659,1094,38,2791,6664,0,41.88,24.89
高雄市,大寮區,合計,39081,14618,24463,404,39485,97638,112129,40.44,14.97
高雄市,大樹區,竹寮里,1118,422,696,8,1126,2680,0,42.01,15.75
高雄市,大樹區,九曲里,1893,750,1143,33,1926,5186,0,37.14,14.46
高雄市,大樹區,久堂里,1731,687,1044,22,1753,4079,0,42.98,16.84
高雄市,大樹區,水安里,1018,316,702,18,1036,2313,0,44.79,13.66
高雄市,大樹區,水寮里,1016,288,728,6,1022,2219,0,46.06,12.98
高雄市,大樹區,檨腳里,1345,425,920,12,1357,3451,0,39.32,12.32
高雄市,大樹區,興山里,419,78,341,2,421,1026,0,41.03,7.6
高雄市,大樹區,和山里,402,105,297,4,406,994,0,40.85,10.56
高雄市,大樹區,姑山里,436,110,326,5,441,962,0,45.84,11.43
高雄市,大樹區,大坑里,567,178,389,4,571,1434,0,39.82,12.41
高雄市,大樹區,井腳里,652,146,506,5,657,1505,0,43.65,9.7
高雄市,大樹區,小坪里,560,178,382,14,574,1311,0,43.78,13.58
高雄市,大樹區,龍目里,759,127,632,16,775,1752,0,44.24,7.25
高雄市,大樹區,大樹里,997,263,734,13,1010,2492,0,40.53,10.55
高雄市,大樹區,三和里,378,140,238,2,380,994,0,38.23,14.08
高雄市,大樹區,溪埔里,629,165,464,4,633,1539,0,41.13,10.72
高雄市,大樹區,興田里,751,320,431,8,759,1855,0,40.92,17.25
高雄市,大樹區,統嶺里,264,86,178,2,266,670,0,39.7,12.84
高雄市,大樹區,合計,14935,4784,10151,178,15113,36462,41549,41.45,13.12
高雄市,大社區,嘉誠里,321,120,201,0,321,899,0,35.71,13.35
高雄市,大社區,保社里,1414,507,907,18,1432,3267,0,43.83,15.52
高雄市,大社區,大社里,2046,737,1309,16,2062,4936,0,41.77,14.93
高雄市,大社區,翠屏里,693,203,490,6,699,1648,0,42.42,12.32
高雄市,大社區,三奶里,1169,372,797,19,1188,2706,0,43.9,13.75
高雄市,大社區,觀音里,2411,751,1660,26,2437,5416,0,45.0,13.87
高雄市,大社區,神農里,1914,677,1237,15,1929,4948,0,38.99,13.68
高雄市,大社區,中里里,1329,459,870,19,1348,3171,0,42.51,14.47
高雄市,大社區,保安里,1310,401,909,19,1329,3118,0,42.62,12.86
高雄市,大社區,合計,12607,4227,8380,138,12745,30109,34208,42.33,14.04
高雄市,仁武區,大灣里,1836,662,1174,9,1845,4416,0,41.78,14.99
高雄市,仁武區,灣內里,3153,1147,2006,19,3172,7950,0,39.9,14.43
高雄市,仁武區,考潭里,1215,477,738,9,1224,2625,0,46.63,18.17
高雄市,仁武區,烏林里,1368,496,872,13,1381,3764,0,36.69,13.18
高雄市,仁武區,仁福里,323,107,216,9,332,849,0,39.1,12.6
高雄市,仁武區,仁武里,2038,669,1369,17,2055,5452,0,37.69,12.27
高雄市,仁武區,文武里,3773,1312,2461,20,3793,9055,0,41.89,14.49
高雄市,仁武區,竹後里,1016,236,780,9,1025,2172,0,47.19,10.87
高雄市,仁武區,八卦里,7036,2824,4212,56,7092,17709,0,40.05,15.95
高雄市,仁武區,高楠里,1088,402,686,13,1101,2610,0,42.18,15.4
高雄市,仁武區,後安里,1068,277,791,5,1073,2542,0,42.21,10.9
高雄市,仁武區,中華里,646,263,383,4,650,1606,0,40.47,16.38
高雄市,仁武區,五和里,1996,735,1261,14,2010,5171,0,38.87,14.21
高雄市,仁武區,仁和里,1698,650,1048,14,1712,3838,0,44.61,16.94
高雄市,仁武區,赤山里,2854,1131,1723,19,2873,6762,0,42.49,16.73
高雄市,仁武區,仁慈里,1063,422,641,10,1073,2202,0,48.73,19.16
高雄市,仁武區,合計,32171,11810,20361,240,32411,78723,92846,41.17,15.0
高雄市,鳥松區,鳥松里,4417,1776,2641,41,4458,10418,0,42.79,17.05
高雄市,鳥松區,夢裡里,2315,948,1367,8,2323,4917,0,47.24,19.28
高雄市,鳥松區,大華里,4818,2088,2730,21,4839,9866,0,49.05,21.16
高雄市,鳥松區,坔埔里,1635,561,1074,8,1643,3551,0,46.27,15.8
高雄市,鳥松區,仁美里,2748,846,1902,25,2773,6496,0,42.69,13.02
高雄市,鳥松區,大竹里,333,96,237,4,337,678,0,49.71,14.16
高雄市,鳥松區,華美里,1733,641,1092,10,1743,3874,0,44.99,16.55
高雄市,鳥松區,合計,17999,6956,11043,117,18116,39800,44727,45.52,17.48
高雄市,岡山區,平安里,469,196,273,7,476,1073,0,44.36,18.27
高雄市,岡山區,岡山里,1670,648,1022,12,1682,4363,0,38.55,14.85
高雄市,岡山區,壽天里,1435,658,777,13,1448,3149,0,45.98,20.9
高雄市,岡山區,維仁里,417,142,275,3,420,985,0,42.64,14.42
高雄市,岡山區,後紅里,1691,817,874,21,1712,4134,0,41.41,19.76
高雄市,岡山區,大遼里,631,169,462,13,644,1366,0,47.14,12.37
高雄市,岡山區,忠孝里,1318,1025,293,19,1337,2810,0,47.58,36.48
高雄市,岡山區,和平里,152,72,80,2,154,300,0,51.33,24.0
高雄市,岡山區,前峰里,1189,468,721,10,1199,2809,0,42.68,16.66
高雄市,岡山區,劉厝里,703,220,483,11,714,1401,0,50.96,15.7
高雄市,岡山區,協和里,1612,684,928,23,1635,3572,0,45.77,19.15
高雄市,岡山區,後協里,2229,1047,1182,17,2246,5458,0,41.15,19.18
高雄市,岡山區,信義里,658,370,288,3,661,1556,0,42.48,23.78
高雄市,岡山區,潭底里,335,87,248,5,340,761,0,44.68,11.43
高雄市,岡山區,三和里,364,86,278,5,369,867,0,42.56,9.92
高雄市,岡山區,仁壽里,1501,634,867,13,1514,3290,0,46.02,19.27
高雄市,岡山區,碧紅里,1541,631,910,12,1553,3822,0,40.63,16.51
高雄市,岡山區,程香里,1715,789,926,16,1731,4091,0,42.31,19.29
高雄市,岡山區,竹圍里,2659,1060,1599,13,2672,6810,0,39.24,15.57
高雄市,岡山區,台上里,2311,863,1448,14,2325,5811,0,40.01,14.85
高雄市,岡山區,灣裡里,768,276,492,5,773,1862,0,41.51,14.82
高雄市,岡山區,白米里,783,313,470,5,788,1933,0,40.77,16.19
高雄市,岡山區,石潭里,884,323,561,8,892,1850,0,48.22,17.46
高雄市,岡山區,福興里,468,173,295,7,475,1048,0,45.32,16.51
高雄市,岡山區,本洲里,678,219,459,4,682,1683,0,40.52,13.01
高雄市,岡山區,嘉興里,1397,378,1019,11,1408,3339,0,42.17,11.32
高雄市,岡山區,嘉峰里,774,279,495,11,785,1747,0,44.93,15.97
高雄市,岡山區,華崗里,749,138,611,7,756,1567,0,48.25,8.81
高雄市,岡山區,大莊里,364,133,231,2,366,984,0,37.2,13.52
高雄市,岡山區,協榮里,868,450,418,2,870,2090,0,41.63,21.53
高雄市,岡山區,為隨里,290,86,204,3,293,631,0,46.43,13.63
高雄市,岡山區,壽峰里,967,439,528,5,972,2230,0,43.59,19.69
高雄市,岡山區,仁義里,975,858,117,20,995,1809,0,55.0,47.43
高雄市,岡山區,合計,34565,14731,19834,322,34887,81201,96433,42.96,18.14
高雄市,橋頭區,橋頭里,945,356,589,6,951,2052,0,46.35,17.35
高雄市,橋頭區,橋南里,542,174,368,4,546,1060,0,51.51,16.42
高雄市,橋頭區,仕隆里,1128,362,766,10,1138,2289,0,49.72,15.81
高雄市,橋頭區,仕豐里,1253,468,785,9,1262,2597,0,48.59,18.02
高雄市,橋頭區,芋寮里,558,171,387,4,562,1196,0,46.99,14.3
高雄市,橋頭區,東林里,1077,289,788,9,1086,2294,0,47.34,12.6
高雄市,橋頭區,西林里,650,168,482,7,657,1371,0,47.92,12.25
高雄市,橋頭區,白樹里,1438,513,925,15,1453,3241,0,44.83,15.83
高雄市,橋頭區,筆秀里,728,212,516,6,734,1506,0,48.74,14.08
高雄市,橋頭區,新莊里,1860,727,1133,14,1874,4359,0,42.99,16.68
高雄市,橋頭區,甲北里,924,330,594,22,946,2139,0,44.23,15.43
高雄市,橋頭區,甲南里,1067,345,722,18,1085,2401,0,45.19,14.37
高雄市,橋頭區,頂鹽里,591,191,400,6,597,1340,0,44.55,14.25
高雄市,橋頭區,中崎里,283,58,225,2,285,662,0,43.05,8.76
高雄市,橋頭區,仕和里,1761,556,1205,18,1779,3625,0,49.08,15.34
高雄市,橋頭區,德松里,668,212,456,6,674,1442,0,46.74,14.7
高雄市,橋頭區,三德里,355,80,275,2,357,776,0,46.01,10.31
高雄市,橋頭區,合計,15828,5212,10616,158,15986,34350,39528,46.54,15.17
高雄市,燕巢區,尖山里,432,129,303,3,435,1096,0,39.69,11.77
高雄市,燕巢區,瓊林里,912,297,615,10,922,2055,0,44.87,14.45
高雄市,燕巢區,安招里,1390,465,925,22,1412,3308,0,42.68,14.06
高雄市,燕巢區,角宿里,1141,452,689,17,1158,2690,0,43.05,16.8
高雄市,燕巢區,鳳雄里,1047,367,680,12,1059,2471,0,42.86,14.85
高雄市,燕巢區,金山里,167,80,87,4,171,464,0,36.85,17.24
高雄市,燕巢區,東燕里,874,293,581,8,882,2315,0,38.1,12.66
高雄市,燕巢區,南燕里,1494,631,863,19,1513,3871,0,39.09,16.3
高雄市,燕巢區,西燕里,1279,458,821,11,1290,3315,0,38.91,13.82
高雄市,燕巢區,橫山里,697,242,455,11,708,1874,0,37.78,12.91
高雄市,燕巢區,深水里,888,302,586,12,900,2396,0,37.56,12.6
高雄市,燕巢區,合計,10321,3716,6605,129,10450,25855,29312,40.42,14.37
高雄市,田寮區,鹿埔里,142,49,93,0,142,347,0,40.92,14.12
高雄市,田寮區,南安里,364,113,251,10,374,1016,0,36.81,11.12
高雄市,田寮區,大同里,142,30,112,1,143,364,0,39.29,8.24
高雄市,田寮區,田寮里,128,34,94,1,129,364,0,35.44,9.34
高雄市,田寮區,七星里,224,56,168,3,227,594,0,38.22,9.43
高雄市,田寮區,崇德里,345,146,199,3,348,914,0,38.07,15.97
高雄市,田寮區,西德里,255,94,161,6,261,777,0,33.59,12.1
高雄市,田寮區,三和里,110,41,69,2,112,333,0,33.63,12.31
高雄市,田寮區,古亭里,157,41,116,5,162,484,0,33.47,8.47
高雄市,田寮區,新興里,452,119,333,7,459,1164,0,39.43,10.22
高雄市,田寮區,合計,2319,723,1596,38,2357,6357,6860,37.08,11.37
高雄市,阿蓮區,石安里,485,128,357,4,489,1283,0,38.11,9.98
高雄市,阿蓮區,中路里,823,174,649,12,835,1973,0,42.32,8.82
高雄市,阿蓮區,峯山里,461,126,335,5,466,1209,0,38.54,10.42
高雄市,阿蓮區,港後里,865,364,501,12,877,2122,0,41.33,17.15
高雄市,阿蓮區,崗山里,273,103,170,6,279,761,0,36.66,13.53
高雄市,阿蓮區,阿蓮里,1790,593,1197,18,1808,4888,0,36.99,12.13
高雄市,阿蓮區,清蓮里,953,304,649,11,964,2590,0,37.22,11.74
高雄市,阿蓮區,和蓮里,916,279,637,12,928,2291,0,40.51,12.18
高雄市,阿蓮區,青旗里,563,218,345,4,567,1541,0,36.79,14.15
高雄市,阿蓮區,復安里,630,217,413,10,640,1648,0,38.83,13.17
高雄市,阿蓮區,玉庫里,459,111,348,7,466,1043,0,44.68,10.64
高雄市,阿蓮區,南蓮里,1134,462,672,6,1140,2960,0,38.51,15.61
高雄市,阿蓮區,合計,9352,3079,6273,107,9459,24309,28170,38.91,12.67
高雄市,路竹區,竹滬里,1152,443,709,7,1159,3254,0,35.62,13.61
高雄市,路竹區,頂寮里,469,179,290,6,475,1144,0,41.52,15.65
高雄市,路竹區,新達里,442,167,275,7,449,1195,0,37.57,13.97
高雄市,路竹區,後鄉里,433,152,281,4,437,1098,0,39.8,13.84
高雄市,路竹區,北嶺里,567,191,376,7,574,1220,0,47.05,15.66
高雄市,路竹區,社西里,897,345,552,12,909,2211,0,41.11,15.6
高雄市,路竹區,甲北里,819,290,529,7,826,2084,0,39.64,13.92
高雄市,路竹區,甲南里,1196,531,665,15,1211,3276,0,36.97,16.21
高雄市,路竹區,下坑里,964,316,648,12,976,2623,0,37.21,12.05
高雄市,路竹區,竹園里,653,195,458,9,662,1825,0,36.27,10.68
高雄市,路竹區,竹東里,1383,563,820,11,1394,3439,0,40.54,16.37
高雄市,路竹區,竹西里,871,365,506,5,876,2163,0,40.5,16.87
高雄市,路竹區,文北里,1147,411,736,10,1157,2976,0,38.88,13.81
高雄市,路竹區,文南里,1016,416,600,7,1023,2337,0,43.77,17.8
高雄市,路竹區,三爺里,357,183,174,3,360,841,0,42.81,21.76
高雄市,路竹區,鴨寮里,772,283,489,7,779,1908,0,40.83,14.83
高雄市,路竹區,社東里,682,221,461,7,689,1711,0,40.27,12.92
高雄市,路竹區,社中里,329,111,218,4,333,846,0,39.36,13.12
高雄市,路竹區,竹南里,1170,475,695,6,1176,2643,0,44.49,17.97
高雄市,路竹區,社南里,1815,734,1081,18,1833,4526,0,40.5,16.22
高雄市,路竹區,合計,17134,6571,10563,164,17298,43320,51490,39.93,15.17
高雄市,湖內區,海山里,476,155,321,4,480,1070,0,44.86,14.49
高雄市,湖內區,劉家里,392,116,276,3,395,981,0,40.27,11.82
高雄市,湖內區,太爺里,356,94,262,4,360,768,0,46.88,12.24
高雄市,湖內區,公舘里,857,303,554,5,862,2214,0,38.93,13.69
高雄市,湖內區,葉厝里,1028,291,737,6,1034,2648,0,39.05,10.99
高雄市,湖內區,大湖里,1438,566,872,13,1451,3677,0,39.46,15.39
高雄市,湖內區,田尾里,402,155,247,1,403,997,0,40.42,15.55
高雄市,湖內區,湖內里,1470,570,900,17,1487,3781,0,39.33,15.08
高雄市,湖內區,海埔里,716,204,512,9,725,1752,0,41.38,11.64
高雄市,湖內區,文賢里,480,146,334,5,485,1198,0,40.48,12.19
高雄市,湖內區,中賢里,765,209,556,7,772,2155,0,35.82,9.7
高雄市,湖內區,逸賢里,426,118,308,4,430,1133,0,37.95,10.41
高雄市,湖內區,忠興里,275,90,185,2,277,700,0,39.57,12.86
高雄市,湖內區,湖東里,934,398,536,13,947,2739,0,34.57,14.53
高雄市,湖內區,合計,10015,3415,6600,93,10108,25813,29772,39.16,13.23
高雄市,茄萣區,福德里,420,113,307,4,424,955,0,44.4,11.83
高雄市,茄萣區,萬福里,333,105,228,4,337,854,0,39.46,12.3
高雄市,茄萣區,白雲里,684,272,412,5,689,1718,0,40.1,15.83
高雄市,茄萣區,嘉賜里,1452,471,981,9,1461,3784,0,38.61,12.45
高雄市,茄萣區,嘉安里,668,252,416,3,671,1771,0,37.89,14.23
高雄市,茄萣區,嘉定里,419,113,306,4,423,1100,0,38.45,10.27
高雄市,茄萣區,保定里,1113,328,785,8,1121,2955,0,37.94,11.1
高雄市,茄萣區,光定里,304,103,201,4,308,919,0,33.51,11.21
高雄市,茄萣區,大定里,342,125,217,2,344,1060,0,32.45,11.79
高雄市,茄萣區,吉定里,433,115,318,5,438,1114,0,39.32,10.32
高雄市,茄萣區,嘉樂里,761,267,494,8,769,2061,0,37.31,12.95
高雄市,茄萣區,嘉泰里,380,105,275,4,384,1067,0,35.99,9.84
高雄市,茄萣區,嘉福里,313,99,214,3,316,966,0,32.71,10.25
高雄市,茄萣區,和協里,457,143,314,4,461,1116,0,41.31,12.81
高雄市,茄萣區,崎漏里,1664,624,1040,20,1684,4679,0,35.99,13.34
高雄市,茄萣區,合計,9743,3235,6508,87,9830,26119,29883,37.64,12.39
高雄市,永安區,永安里,635,259,376,7,642,1558,0,41.21,16.62
高雄市,永安區,永華里,734,275,459,7,741,1799,0,41.19,15.29
高雄市,永安區,新港里,883,299,584,9,892,2291,0,38.93,13.05
高雄市,永安區,鹽田里,141,36,105,1,142,374,0,37.97,9.63
高雄市,永安區,保寧里,945,390,555,8,953,2564,0,37.17,15.21
高雄市,永安區,維新里,1255,435,820,11,1266,3396,0,37.28,12.81
高雄市,永安區,合計,4593,1694,2899,43,4636,11982,13609,38.69,14.14
高雄市,彌陀區,光和里,498,162,336,7,505,1250,0,40.4,12.96
高雄市,彌陀區,彌靖里,777,293,484,10,787,1846,0,42.63,15.87
高雄市,彌陀區,彌仁里,212,100,112,3,215,533,0,40.34,18.76
高雄市,彌陀區,彌壽里,342,161,181,3,345,738,0,46.75,21.82
高雄市,彌陀區,彌陀里,730,320,410,13,743,1710,0,43.45,18.71
高雄市,彌陀區,舊港里,619,230,389,10,629,1565,0,40.19,14.7
高雄市,彌陀區,文安里,672,246,426,9,681,1681,0,40.51,14.63
高雄市,彌陀區,鹽埕里,807,308,499,3,810,2007,0,40.36,15.35
高雄市,彌陀區,過港里,358,136,222,6,364,918,0,39.65,14.81
高雄市,彌陀區,海尾里,292,123,169,5,297,804,0,36.94,15.3
高雄市,彌陀區,漯底里,453,227,226,5,458,1134,0,40.39,20.02
高雄市,彌陀區,南寮里,799,316,483,11,810,2085,0,38.85,15.16
高雄市,彌陀區,合計,6559,2622,3937,85,6644,16271,18759,40.83,16.11
高雄市,梓官區,梓信里,914,256,658,2,916,2095,0,43.72,12.22
高雄市,梓官區,梓義里,825,261,564,5,830,2030,0,40.89,12.86
高雄市,梓官區,梓和里,1090,334,756,9,1099,2213,0,49.66,15.09
高雄市,梓官區,梓平里,660,184,476,10,670,1476,0,45.39,12.47
高雄市,梓官區,中崙里,560,184,376,3,563,1154,0,48.79,15.94
高雄市,梓官區,赤崁里,763,224,539,11,774,1791,0,43.22,12.51
高雄市,梓官區,禮蚵里,800,201,599,6,806,2055,0,39.22,9.78
高雄市,梓官區,智蚵里,1121,376,745,9,1130,2858,0,39.54,13.16
高雄市,梓官區,信蚵里,873,312,561,9,882,2313,0,38.13,13.49
高雄市,梓官區,同安里,384,133,251,5,389,970,0,40.1,13.71
高雄市,梓官區,大舍里,1524,472,1052,18,1542,3701,0,41.66,12.75
高雄市,梓官區,赤東里,910,265,645,7,917,2221,0,41.29,11.93
高雄市,梓官區,赤西里,339,127,212,8,347,801,0,43.32,15.86
高雄市,梓官區,茄苳里,907,309,598,8,915,2258,0,40.52,13.68
高雄市,梓官區,典寶里,1299,483,816,12,1311,2972,0,44.11,16.25
高雄市,梓官區,合計,12969,4121,8848,122,13091,30908,35292,42.35,13.33
高雄市,旗山區,太平里,833,349,484,8,841,2165,0,38.85,16.12
高雄市,旗山區,大德里,920,427,493,11,931,2273,0,40.96,18.79
高雄市,旗山區,湄洲里,580,212,368,5,585,1578,0,37.07,13.43
高雄市,旗山區,圓富里,584,231,353,11,595,1802,0,33.02,12.82
高雄市,旗山區,中正里,455,215,240,5,460,1418,0,32.44,15.16
高雄市,旗山區,大林里,413,190,223,8,421,1338,0,31.46,14.2
高雄市,旗山區,上洲里,382,91,291,5,387,1008,0,38.39,9.03
高雄市,旗山區,新光里,319,122,197,7,326,759,0,42.95,16.07
高雄市,旗山區,南勝里,839,256,583,15,854,2092,0,40.82,12.24
高雄市,旗山區,中寮里,66,19,47,2,68,179,0,37.99,10.61
高雄市,旗山區,東平里,804,321,483,13,817,1924,0,42.46,16.68
高雄市,旗山區,東昌里,389,183,206,3,392,983,0,39.88,18.62
高雄市,旗山區,竹峰里,572,250,322,5,577,1544,0,37.37,16.19
高雄市,旗山區,瑞吉里,754,284,470,7,761,1999,0,38.07,14.21
高雄市,旗山區,永和里,1105,397,708,15,1120,3245,0,34.51,12.23
高雄市,旗山區,三協里,832,329,503,7,839,2216,0,37.86,14.85
高雄市,旗山區,鯤洲里,322,63,259,6,328,705,0,46.52,8.94
高雄市,旗山區,大山里,481,148,333,6,487,1254,0,38.84,11.8
高雄市,旗山區,中洲里,324,87,237,6,330,797,0,41.41,10.92
高雄市,旗山區,南洲里,518,171,347,12,530,1262,0,42.0,13.55
高雄市,旗山區,廣福里,220,119,101,6,226,611,0,36.99,19.48
高雄市,旗山區,合計,11712,4464,7248,163,11875,31152,35449,38.12,14.33
高雄市,美濃區,福安里,982,456,526,12,994,2547,0,39.03,17.9
高雄市,美濃區,合和里,832,445,387,10,842,2321,0,36.28,19.17
高雄市,美濃區,祿興里,966,499,467,17,983,2552,0,38.52,19.55
高雄市,美濃區,中壇里,699,374,325,7,706,1978,0,35.69,18.91
高雄市,美濃區,德興里,539,323,216,7,546,1462,0,37.35,22.09
高雄市,美濃區,龍山里,686,342,344,13,699,2113,0,33.08,16.19
高雄市,美濃區,獅山里,959,427,532,10,969,2433,0,39.83,17.55
高雄市,美濃區,龍肚里,531,254,277,6,537,1382,0,38.86,18.38
高雄市,美濃區,廣德里,464,203,261,9,473,1299,0,36.41,15.63
高雄市,美濃區,興隆里,426,176,250,6,432,1158,0,37.31,15.2
高雄市,美濃區,中圳里,756,398,358,8,764,2066,0,36.98,19.26
高雄市,美濃區,東門里,428,186,242,3,431,1184,0,36.4,15.71
高雄市,美濃區,泰安里,610,321,289,5,615,1527,0,40.28,21.02
高雄市,美濃區,瀰濃里,791,372,419,5,796,2186,0,36.41,17.02
高雄市,美濃區,清水里,661,317,344,4,665,1720,0,38.66,18.43
高雄市,美濃區,吉洋里,686,308,378,5,691,1826,0,37.84,16.87
高雄市,美濃區,吉和里,497,253,244,5,502,1334,0,37.63,18.97
高雄市,美濃區,吉東里,589,217,372,9,598,1779,0,33.61,12.2
高雄市,美濃區,廣林里,511,226,285,11,522,1436,0,36.35,15.74
高雄市,美濃區,合計,12613,6097,6516,152,12765,34303,38209,37.21,17.77
高雄市,六龜區,新威里,227,80,147,5,232,714,0,32.49,11.2
高雄市,六龜區,新興里,193,63,130,2,195,649,0,30.05,9.71
高雄市,六龜區,新寮里,238,83,155,4,242,626,0,38.66,13.26
高雄市,六龜區,新發里,220,83,137,6,226,926,0,24.41,8.96
高雄市,六龜區,荖濃里,328,113,215,6,334,1359,0,24.58,8.31
高雄市,六龜區,六龜里,234,79,155,8,242,942,0,25.69,8.39
高雄市,六龜區,義寶里,351,151,200,4,355,1029,0,34.5,14.67
高雄市,六龜區,興龍里,223,64,159,4,227,785,0,28.92,8.15
高雄市,六龜區,中興里,460,247,213,10,470,1363,0,34.48,18.12
高雄市,六龜區,寶來里,244,100,144,2,246,858,0,28.67,11.66
高雄市,六龜區,文武里,369,149,220,8,377,1379,0,27.34,10.8
高雄市,六龜區,大津里,124,45,79,2,126,303,0,41.58,14.85
高雄市,六龜區,合計,3211,1257,1954,61,3272,10933,12236,29.93,11.5
高雄市,甲仙區,東安里,109,56,53,3,112,445,0,25.17,12.58
高雄市,甲仙區,西安里,353,230,123,3,356,835,0,42.63,27.54
高雄市,甲仙區,和安里,233,143,90,1,234,668,0,35.03,21.41
高雄市,甲仙區,大田里,439,205,234,9,448,1557,0,28.77,13.17
高雄市,甲仙區,寶隆里,221,69,152,4,225,651,0,34.56,10.6
高雄市,甲仙區,關山里,199,79,120,5,204,587,0,34.75,13.46
高雄市,甲仙區,小林里,130,59,71,2,132,514,0,25.68,11.48
高雄市,甲仙區,合計,1684,841,843,27,1711,5257,5798,32.55,16.0
高雄市,杉林區,杉林里,167,53,114,2,169,597,0,28.31,8.88
高雄市,杉林區,木梓里,156,50,106,2,158,655,0,24.12,7.63
高雄市,杉林區,集來里,327,102,225,2,329,1230,0,26.75,8.29
高雄市,杉林區,新庄里,476,221,255,13,489,1464,0,33.4,15.1
高雄市,杉林區,上平里,463,217,246,9,472,1537,0,30.71,14.12
高雄市,杉林區,月眉里,550,276,274,8,558,1603,0,34.81,17.22
高雄市,杉林區,月美里,382,153,229,10,392,1207,0,32.48,12.68
高雄市,杉林區,大愛里,516,213,303,7,523,1965,0,26.62,10.84
高雄市,杉林區,合計,3037,1285,1752,53,3090,10258,11365,30.12,12.53
高雄市,內門區,溝坪里,245,90,155,4,249,931,0,26.75,9.67
高雄市,內門區,金竹里,203,67,136,6,209,627,0,33.33,10.69
高雄市,內門區,永富里,284,117,167,8,292,955,0,30.58,12.25
高雄市,內門區,永吉里,119,55,64,1,120,413,0,29.06,13.32
高雄市,內門區,永興里,119,46,73,2,121,384,0,31.51,11.98
高雄市,內門區,石坑里,118,46,72,0,118,493,0,23.94,9.33
高雄市,內門區,內門里,363,166,197,5,368,963,0,38.21,17.24
高雄市,內門區,內豊里,365,138,227,4,369,1176,0,31.38,11.73
高雄市,內門區,觀亭里,560,252,308,7,567,1682,0,33.71,14.98
高雄市,內門區,中埔里,177,106,71,0,177,537,0,32.96,19.74
高雄市,內門區,內東里,280,103,177,5,285,765,0,37.25,13.46
高雄市,內門區,內南里,101,42,59,2,103,403,0,25.56,10.42
高雄市,內門區,東埔里,150,53,97,2,152,474,0,32.07,11.18
高雄市,內門區,三平里,196,69,127,5,201,638,0,31.5,10.82
高雄市,內門區,木柵里,184,52,132,4,188,589,0,31.92,8.83
高雄市,內門區,內興里,165,26,139,3,168,602,0,27.91,4.32
高雄市,內門區,瑞山里,118,60,58,4,122,318,0,38.36,18.87
高雄市,內門區,光興里,193,82,111,1,194,645,0,30.08,12.71
高雄市,內門區,合計,3940,1570,2370,63,4003,12595,13870,31.78,12.47
高雄市,茂林區,茂林里,225,178,47,1,226,712,0,31.74,25.0
高雄市,茂林區,萬山里,133,93,40,3,136,356,0,38.2,26.12
高雄市,茂林區,多納里,147,123,24,3,150,491,0,30.55,25.05
高雄市,茂林區,合計,505,394,111,7,512,1559,1879,32.84,25.27
高雄市,桃源區,桃源里,143,119,24,3,146,766,0,19.06,15.54
高雄市,桃源區,寶山里,100,81,19,5,105,458,0,22.93,17.69
高雄市,桃源區,建山里,98,67,31,2,100,587,0,17.04,11.41
高雄市,桃源區,高中里,133,105,28,0,133,620,0,21.45,16.94
高雄市,桃源區,勤和里,45,30,15,1,46,212,0,21.7,14.15
高雄市,桃源區,復興里,61,57,4,1,62,287,0,21.6,19.86
高雄市,桃源區,拉芙蘭里,71,40,31,1,72,230,0,31.3,17.39
高雄市,桃源區,梅山里,71,52,19,1,72,255,0,28.24,20.39
高雄市,桃源區,合計,722,551,171,14,736,3415,4205,21.55,16.13
高雄市,那瑪夏區,達卡努瓦里,335,271,64,4,339,1343,0,25.24,20.18
高雄市,那瑪夏區,瑪雅里,202,174,28,0,202,602,0,33.55,28.9
高雄市,那瑪夏區,南沙魯里,152,72,80,1,153,482,0,31.74,14.94
高雄市,那瑪夏區,合計,689,517,172,5,694,2427,3141,28.59,21.3
高雄市,合計,合計,986292,397990,588302,8279,994571,2353773,2755491,42.25,16.91
新竹縣,竹北市,斗崙里,3000,1734,1266,14,3014,6791,0,44.38,25.53
新竹縣,竹北市,鹿場里,4848,2750,2098,36,4884,10611,0,46.03,25.92
新竹縣,竹北市,東平里,5440,2833,2607,39,5479,11738,0,46.68,24.14
新竹縣,竹北市,中興里,3796,2091,1705,31,3827,8015,0,47.75,26.09
新竹縣,竹北市,隘口里,1312,740,572,9,1321,2974,0,44.42,24.88
新竹縣,竹北市,東海里,1099,762,337,12,1111,2997,0,37.07,25.43
新竹縣,竹北市,竹北里,2896,1772,1124,18,2914,7661,0,38.04,23.13
新竹縣,竹北市,竹仁里,3526,2219,1307,31,3557,8745,0,40.67,25.37
新竹縣,竹北市,竹義里,2073,1267,806,21,2094,5860,0,35.73,21.62
新竹縣,竹北市,泰和里,2231,1407,824,22,2253,5932,0,37.98,23.72
新竹縣,竹北市,新社里,2681,1631,1050,33,2714,7074,0,38.37,23.06
新竹縣,竹北市,聯興里,1772,1057,715,21,1793,4441,0,40.37,23.8
新竹縣,竹北市,麻園里,749,408,341,8,757,1986,0,38.12,20.54
新竹縣,竹北市,溪州里,1036,539,497,10,1046,2468,0,42.38,21.84
新竹縣,竹北市,白地里,795,408,387,18,813,2202,0,36.92,18.53
新竹縣,竹北市,新港里,496,195,301,7,503,1218,0,41.3,16.01
新竹縣,竹北市,大義里,640,265,375,4,644,1607,0,40.07,16.49
新竹縣,竹北市,崇義里,750,285,465,6,756,1914,0,39.5,14.89
新竹縣,竹北市,大眉里,693,398,295,8,701,1741,0,40.26,22.86
新竹縣,竹北市,尚義里,621,252,369,8,629,1683,0,37.37,14.97
新竹縣,竹北市,十興里,3045,1704,1341,27,3072,6632,0,46.32,25.69
新竹縣,竹北市,新國里,2320,1297,1023,13,2333,6000,0,38.88,21.62
新竹縣,竹北市,新庄里,398,227,171,6,404,1064,0,37.97,21.33
新竹縣,竹北市,北崙里,1650,1032,618,15,1665,3833,0,43.44,26.92
新竹縣,竹北市,新崙里,2521,1465,1056,26,2547,6255,0,40.72,23.42
新竹縣,竹北市,福德里,1345,838,507,13,1358,3262,0,41.63,25.69
新竹縣,竹北市,東興里,2850,1498,1352,22,2872,7126,0,40.3,21.02
新竹縣,竹北市,北興里,2189,1147,1042,12,2201,5571,0,39.51,20.59
新竹縣,竹北市,興安里,1476,907,569,10,1486,3538,0,42.0,25.64
新竹縣,竹北市,文化里,1499,917,582,15,1514,3337,0,45.37,27.48
新竹縣,竹北市,中崙里,2827,1692,1135,12,2839,6155,0,46.13,27.49
新竹縣,竹北市,合計,62574,35737,26837,527,63101,150431,203904,41.95,23.76
新竹縣,竹東鎮,上坪里,100,76,24,0,100,303,0,33.0,25.08
新竹縣,竹東鎮,瑞峰里,133,85,48,4,137,402,0,34.08,21.14
新竹縣,竹東鎮,軟橋里,132,86,46,2,134,369,0,36.31,23.31
新竹縣,竹東鎮,員崠里,837,612,225,2,839,2251,0,37.27,27.19
新竹縣,竹東鎮,東寧里,1253,892,361,11,1264,3227,0,39.17,27.64
新竹縣,竹東鎮,上舘里,3267,2323,944,35,3302,9255,0,35.68,25.1
新竹縣,竹東鎮,大鄉里,1599,1120,479,20,1619,4597,0,35.22,24.36
新竹縣,竹東鎮,東華里,311,213,98,0,311,643,0,48.37,33.13
新竹縣,竹東鎮,商華里,987,724,263,7,994,3051,0,32.58,23.73
新竹縣,竹東鎮,竹東里,581,356,225,7,588,1321,0,44.51,26.95
新竹縣,竹東鎮,榮樂里,595,414,181,3,598,1352,0,44.23,30.62
新竹縣,竹東鎮,鷄林里,1368,955,413,6,1374,3726,0,36.88,25.63
新竹縣,竹東鎮,仁愛里,1273,867,406,9,1282,3284,0,39.04,26.4
新竹縣,竹東鎮,五豐里,2417,1610,807,16,2433,7516,0,32.37,21.42
新竹縣,竹東鎮,三重里,2372,1578,794,21,2393,6371,0,37.56,24.77
新竹縣,竹東鎮,頭重里,1893,1225,668,18,1911,4492,0,42.54,27.27
新竹縣,竹東鎮,員山里,774,493,281,8,782,1905,0,41.05,25.88
新竹縣,竹東鎮,柯湖里,232,144,88,3,235,585,0,40.17,24.62
新竹縣,竹東鎮,二重里,4404,2804,1600,41,4445,11579,0,38.39,24.22
新竹縣,竹東鎮,中山里,638,461,177,13,651,1672,0,38.94,27.57
新竹縣,竹東鎮,中正里,832,543,289,15,847,2198,0,38.54,24.7
新竹縣,竹東鎮,南華里,435,296,139,1,436,1002,0,43.51,29.54
新竹縣,竹東鎮,榮華里,2712,1929,783,33,2745,6974,0,39.36,27.66
新竹縣,竹東鎮,忠孝里,558,387,171,8,566,1533,0,36.92,25.24
新竹縣,竹東鎮,陸豐里,244,168,76,4,248,579,0,42.83,29.02
新竹縣,竹東鎮,合計,29947,20361,9586,287,30234,80187,96850,37.7,25.39
新竹縣,新埔鎮,內立里,409,233,176,8,417,1106,0,37.7,21.07
新竹縣,新埔鎮,寶石里,368,232,136,5,373,857,0,43.52,27.07
新竹縣,新埔鎮,文山里,1815,1135,680,14,1829,4469,0,40.93,25.4
新竹縣,新埔鎮,五埔里,726,470,256,5,731,1976,0,36.99,23.79
新竹縣,新埔鎮,四座里,1385,791,594,8,1393,3266,0,42.65,24.22
新竹縣,新埔鎮,旱坑里,683,418,265,6,689,1753,0,39.3,23.84
新竹縣,新埔鎮,田新里,1256,818,438,11,1267,3147,0,40.26,25.99
新竹縣,新埔鎮,新埔里,400,253,147,7,407,964,0,42.22,26.24
新竹縣,新埔鎮,新生里,251,133,118,2,253,558,0,45.34,23.84
新竹縣,新埔鎮,新民里,454,306,148,3,457,1011,0,45.2,30.27
新竹縣,新埔鎮,上寮里,701,420,281,14,715,1823,0,39.22,23.04
新竹縣,新埔鎮,下寮里,1050,620,430,13,1063,2507,0,42.4,24.73
新竹縣,新埔鎮,南平里,427,245,182,9,436,977,0,44.63,25.08
新竹縣,新埔鎮,北平里,257,143,114,3,260,642,0,40.5,22.27
新竹縣,新埔鎮,巨埔里,491,234,257,6,497,1082,0,45.93,21.63
新竹縣,新埔鎮,照門里,475,265,210,11,486,1332,0,36.49,19.89
新竹縣,新埔鎮,清水里,190,96,94,0,190,403,0,47.15,23.82
新竹縣,新埔鎮,鹿鳴里,278,128,150,2,280,701,0,39.94,18.26
新竹縣,新埔鎮,新北里,238,129,109,6,244,570,0,42.81,22.63
新竹縣,新埔鎮,合計,11854,7069,4785,133,11987,29144,32991,41.13,24.26
新竹縣,關西鎮,東興里,221,165,56,3,224,472,0,47.46,34.96
新竹縣,關西鎮,西安里,766,546,220,5,771,1896,0,40.66,28.8
新竹縣,關西鎮,南雄里,291,197,94,3,294,677,0,43.43,29.1
新竹縣,關西鎮,北斗里,1444,958,486,20,1464,3579,0,40.91,26.77
新竹縣,關西鎮,仁安里,401,245,156,6,407,960,0,42.4,25.52
新竹縣,關西鎮,北山里,322,181,141,2,324,756,0,42.86,23.94
新竹縣,關西鎮,南山里,344,197,147,15,359,1025,0,35.02,19.22
新竹縣,關西鎮,東安里,1308,860,448,13,1321,3726,0,35.45,23.08
新竹縣,關西鎮,東光里,445,277,168,8,453,1248,0,36.3,22.2
新竹縣,關西鎮,新富里,169,96,73,4,173,529,0,32.7,18.15
新竹縣,關西鎮,金山里,207,138,69,2,209,549,0,38.07,25.14
新竹縣,關西鎮,錦山里,285,197,88,3,288,904,0,31.86,21.79
新竹縣,關西鎮,玉山里,129,63,66,3,132,431,0,30.63,14.62
新竹縣,關西鎮,大同里,348,171,177,2,350,787,0,44.47,21.73
新竹縣,關西鎮,石光里,654,407,247,8,662,1735,0,38.16,23.46
新竹縣,關西鎮,上林里,325,211,114,6,331,798,0,41.48,26.44
新竹縣,關西鎮,新力里,214,153,61,3,217,537,0,40.41,28.49
新竹縣,關西鎮,南和里,310,179,131,10,320,799,0,40.05,22.4
新竹縣,關西鎮,東山里,323,193,130,7,330,824,0,40.05,23.42
新竹縣,關西鎮,南新里,315,214,101,4,319,889,0,35.88,24.07
新竹縣,關西鎮,東平里,408,254,154,5,413,926,0,44.6,27.43
新竹縣,關西鎮,合計,9229,5902,3327,132,9361,24047,27521,38.93,24.54
新竹縣,湖口鄉,孝勢村,519,337,182,4,523,1181,0,44.28,28.54
新竹縣,湖口鄉,仁勢村,379,241,138,3,382,855,0,44.68,28.19
新竹縣,湖口鄉,愛勢村,1562,1009,553,19,1581,3959,0,39.93,25.49
新竹縣,湖口鄉,信勢村,1939,1242,697,23,1962,5246,0,37.4,23.68
新竹縣,湖口鄉,中勢村,1244,795,449,14,1258,3221,0,39.06,24.68
新竹縣,湖口鄉,德盛村,1671,1054,617,14,1685,4921,0,34.24,21.42
新竹縣,湖口鄉,和興村,1023,605,418,5,1028,2816,0,36.51,21.48
新竹縣,湖口鄉,長嶺村,1112,725,387,15,1127,3163,0,35.63,22.92
新竹縣,湖口鄉,長安村,370,226,144,2,372,1045,0,35.6,21.63
新竹縣,湖口鄉,湖口村,1063,677,386,10,1073,2753,0,38.98,24.59
新竹縣,湖口鄉,湖鏡村,999,732,267,18,1017,2452,0,41.48,29.85
新竹縣,湖口鄉,湖南村,605,419,186,7,612,1495,0,40.94,28.03
新竹縣,湖口鄉,波羅村,741,460,281,11,752,2217,0,33.92,20.75
新竹縣,湖口鄉,鳳凰村,1621,1042,579,19,1640,5086,0,32.25,20.49
新竹縣,湖口鄉,鳳山村,1172,841,331,10,1182,3248,0,36.39,25.89
新竹縣,湖口鄉,中興村,1885,1351,534,19,1904,6149,0,30.96,21.97
新竹縣,湖口鄉,信義村,1414,897,517,14,1428,3854,0,37.05,23.27
新竹縣,湖口鄉,中正村,1346,853,493,11,1357,3485,0,38.94,24.48
新竹縣,湖口鄉,東興村,1468,922,546,9,1477,4375,0,33.76,21.07
新竹縣,湖口鄉,勝利村,1359,956,403,19,1378,4199,0,32.82,22.77
新竹縣,湖口鄉,合計,23492,15384,8108,246,23738,65720,79420,36.12,23.41
新竹縣,新豐鄉,福興村,400,234,166,9,409,1086,0,37.66,21.55
新竹縣,新豐鄉,後湖村,625,348,277,11,636,1798,0,35.37,19.35
新竹縣,新豐鄉,青埔村,648,383,265,10,658,1867,0,35.24,20.51
新竹縣,新豐鄉,埔和村,1020,454,566,4,1024,2772,0,36.94,16.38
新竹縣,新豐鄉,瑞興村,573,345,228,6,579,1847,0,31.35,18.68
新竹縣,新豐鄉,坡頭村,310,128,182,3,313,833,0,37.58,15.37
新竹縣,新豐鄉,中崙村,1094,695,399,12,1106,3202,0,34.54,21.71
新竹縣,新豐鄉,重興村,1751,1130,621,26,1777,5247,0,33.87,21.54
新竹縣,新豐鄉,新豐村,729,333,396,4,733,2073,0,35.36,16.06
新竹縣,新豐鄉,員山村,988,675,313,4,992,2634,0,37.66,25.63
新竹縣,新豐鄉,松林村,1708,1122,586,15,1723,4372,0,39.41,25.66
新竹縣,新豐鄉,上坑村,572,368,204,11,583,1508,0,38.66,24.4
新竹縣,新豐鄉,鳳坑村,397,244,153,6,403,1044,0,38.6,23.37
新竹縣,新豐鄉,忠孝村,1342,875,467,14,1356,3558,0,38.11,24.59
新竹縣,新豐鄉,山崎村,1705,1125,580,18,1723,4427,0,38.92,25.41
新竹縣,新豐鄉,松柏村,2023,1297,726,15,2038,5803,0,35.12,22.35
新竹縣,新豐鄉,崎頂村,995,645,350,14,1009,2708,0,37.26,23.82
新竹縣,新豐鄉,合計,16880,10401,6479,182,17062,46779,57654,36.47,22.23
新竹縣,芎林鄉,五龍村,199,141,58,1,200,491,0,40.73,28.72
新竹縣,芎林鄉,華龍村,166,116,50,3,169,384,0,44.01,30.21
新竹縣,芎林鄉,秀湖村,363,274,89,5,368,934,0,39.4,29.34
新竹縣,芎林鄉,永興村,156,118,38,3,159,409,0,38.88,28.85
新竹縣,芎林鄉,石潭村,1017,692,325,10,1027,2655,0,38.68,26.06
新竹縣,芎林鄉,新鳳村,587,374,213,10,597,1577,0,37.86,23.72
新竹縣,芎林鄉,中坑村,240,172,68,3,243,626,0,38.82,27.48
新竹縣,芎林鄉,水坑村,307,191,116,7,314,779,0,40.31,24.52
新竹縣,芎林鄉,文林村,924,647,277,12,936,2349,0,39.85,27.54
新竹縣,芎林鄉,芎林村,654,401,253,11,665,1559,0,42.66,25.72
新竹縣,芎林鄉,上山村,1987,1272,715,19,2006,4643,0,43.2,27.4
新竹縣,芎林鄉,下山村,481,310,171,6,487,1098,0,44.35,28.23
新竹縣,芎林鄉,合計,7081,4708,2373,90,7171,17504,19888,40.97,26.9
新竹縣,橫山鄉,橫山村,1219,858,361,19,1238,3300,0,37.52,26.0
新竹縣,橫山鄉,田寮村,341,217,124,6,347,847,0,40.97,25.62
新竹縣,橫山鄉,南昌村,79,57,22,1,80,180,0,44.44,31.67
新竹縣,橫山鄉,豐鄉村,75,43,32,2,77,203,0,37.93,21.18
新竹縣,橫山鄉,豐田村,121,86,35,1,122,320,0,38.13,26.88
新竹縣,橫山鄉,內灣村,343,241,102,7,350,882,0,39.68,27.32
新竹縣,橫山鄉,福興村,164,106,58,2,166,419,0,39.62,25.3
新竹縣,橫山鄉,沙坑村,411,271,140,7,418,938,0,44.56,28.89
新竹縣,橫山鄉,新興村,623,466,157,11,634,1488,0,42.61,31.32
新竹縣,橫山鄉,大肚村,603,477,126,9,612,1628,0,37.59,29.3
新竹縣,橫山鄉,力行村,336,247,89,6,342,802,0,42.64,30.8
新竹縣,橫山鄉,合計,4315,3069,1246,71,4386,11007,12408,39.85,27.88
新竹縣,北埔鄉,北埔村,414,275,139,1,415,1117,0,37.15,24.62
新竹縣,北埔鄉,南興村,414,295,119,8,422,1142,0,36.95,25.83
新竹縣,北埔鄉,埔尾村,932,621,311,11,943,2547,0,37.02,24.38
新竹縣,北埔鄉,水磜村,280,179,101,2,282,818,0,34.47,21.88
新竹縣,北埔鄉,南埔村,181,129,52,0,181,363,0,49.86,35.54
新竹縣,北埔鄉,大林村,271,199,72,1,272,720,0,37.78,27.64
新竹縣,北埔鄉,大湖村,185,133,52,2,187,541,0,34.57,24.58
新竹縣,北埔鄉,南坑村,142,97,45,2,144,325,0,44.31,29.85
新竹縣,北埔鄉,外坪村,121,73,48,1,122,297,0,41.08,24.58
新竹縣,北埔鄉,合計,2940,2001,939,28,2968,7870,8864,37.71,25.43
新竹縣,寶山鄉,雙溪村,1014,619,395,8,1022,2659,0,38.44,23.28
新竹縣,寶山鄉,大崎村,873,550,323,7,880,2006,0,43.87,27.42
新竹縣,寶山鄉,三峰村,399,249,150,5,404,1015,0,39.8,24.53
新竹縣,寶山鄉,新城村,426,259,167,4,430,1168,0,36.82,22.17
新竹縣,寶山鄉,深井村,326,211,115,1,327,794,0,41.18,26.57
新竹縣,寶山鄉,寶斗村,229,155,74,4,233,731,0,31.87,21.2
新竹縣,寶山鄉,山湖村,249,154,95,0,249,541,0,46.03,28.47
新竹縣,寶山鄉,寶山村,344,228,116,3,347,847,0,40.97,26.92
新竹縣,寶山鄉,油田村,251,166,85,1,252,578,0,43.6,28.72
新竹縣,寶山鄉,雙新村,1032,650,382,9,1041,2676,0,38.9,24.29
新竹縣,寶山鄉,合計,5143,3241,1902,42,5185,13015,14570,39.84,24.9
新竹縣,峨眉鄉,峨眉村,368,261,107,7,375,815,0,46.01,32.02
新竹縣,峨眉鄉,中盛村,269,153,116,4,273,665,0,41.05,23.01
新竹縣,峨眉鄉,石井村,241,161,80,1,242,563,0,42.98,28.6
新竹縣,峨眉鄉,富興村,492,325,167,4,496,1340,0,37.01,24.25
新竹縣,峨眉鄉,七星村,246,157,89,3,249,605,0,41.16,25.95
新竹縣,峨眉鄉,湖光村,331,189,142,2,333,850,0,39.18,22.24
新竹縣,峨眉鄉,合計,1947,1246,701,21,1968,4838,5323,40.68,25.75
新竹縣,尖石鄉,義興村,166,123,43,3,169,587,0,28.79,20.95
新竹縣,尖石鄉,嘉樂村,268,214,54,3,271,818,0,33.13,26.16
新竹縣,尖石鄉,新樂村,313,270,43,5,318,1210,0,26.28,22.31
新竹縣,尖石鄉,梅花村,201,169,32,3,204,626,0,32.59,27.0
新竹縣,尖石鄉,錦屏村,257,212,45,1,258,1161,0,22.22,18.26
新竹縣,尖石鄉,玉峰村,241,163,78,3,244,1329,0,18.36,12.26
新竹縣,尖石鄉,秀巒村,260,198,62,5,265,1629,0,16.27,12.15
新竹縣,尖石鄉,合計,1706,1349,357,23,1729,7360,9561,23.49,18.33
新竹縣,五峰鄉,大隘村,343,300,43,7,350,1281,0,27.32,23.42
新竹縣,五峰鄉,花園村,204,154,50,2,206,711,0,28.97,21.66
新竹縣,五峰鄉,竹林村,99,79,20,1,100,377,0,26.53,20.95
新竹縣,五峰鄉,桃山村,358,252,106,6,364,1367,0,26.63,18.43
新竹縣,五峰鄉,合計,1004,785,219,16,1020,3736,4431,27.3,21.01
新竹縣,合計,合計,178112,111253,66859,1798,179910,461638,573385,38.97,24.1
苗栗縣,苗栗市,中苗里,478,337,141,1,479,1116,0,42.92,30.2
苗栗縣,苗栗市,建功里,1697,1228,469,9,1706,4048,0,42.14,30.34
苗栗縣,苗栗市,青苗里,360,240,120,5,365,1005,0,36.32,23.88
苗栗縣,苗栗市,玉清里,1032,764,268,7,1039,2166,0,47.97,35.27
苗栗縣,苗栗市,玉華里,1532,1130,402,14,1546,3579,0,43.2,31.57
苗栗縣,苗栗市,維新里,1495,1095,400,16,1511,3590,0,42.09,30.5
苗栗縣,苗栗市,維祥里,1229,905,324,7,1236,3260,0,37.91,27.76
苗栗縣,苗栗市,綠苗里,320,229,91,3,323,805,0,40.12,28.45
苗栗縣,苗栗市,高苗里,1210,842,368,3,1213,3216,0,37.72,26.18
苗栗縣,苗栗市,玉苗里,362,218,144,6,368,856,0,42.99,25.47
苗栗縣,苗栗市,大同里,230,151,79,4,234,497,0,47.08,30.38
苗栗縣,苗栗市,新苗里,355,217,138,2,357,841,0,42.45,25.8
苗栗縣,苗栗市,勝利里,1650,1137,513,10,1660,3843,0,43.2,29.59
苗栗縣,苗栗市,恭敬里,504,333,171,4,508,1333,0,38.11,24.98
苗栗縣,苗栗市,上苗里,668,434,234,11,679,1503,0,45.18,28.88
苗栗縣,苗栗市,北苗里,2062,1428,634,28,2090,5025,0,41.59,28.42
苗栗縣,苗栗市,清華里,1385,965,420,12,1397,3087,0,45.25,31.26
苗栗縣,苗栗市,嘉盛里,1380,979,401,13,1393,3365,0,41.4,29.09
苗栗縣,苗栗市,福星里,1574,1065,509,13,1587,4152,0,38.22,25.65
苗栗縣,苗栗市,新川里,440,301,139,8,448,1166,0,38.42,25.81
苗栗縣,苗栗市,文山里,1606,1110,496,7,1613,4041,0,39.92,27.47
苗栗縣,苗栗市,福麗里,2051,1477,574,14,2065,5344,0,38.64,27.64
苗栗縣,苗栗市,水源里,939,647,292,9,948,2448,0,38.73,26.43
苗栗縣,苗栗市,新英里,570,382,188,6,576,1664,0,34.62,22.96
苗栗縣,苗栗市,福安里,1260,881,379,8,1268,3443,0,36.83,25.59
苗栗縣,苗栗市,嘉新里,1242,899,343,12,1254,2769,0,45.29,32.47
苗栗縣,苗栗市,南勢里,644,455,189,6,650,1926,0,33.75,23.62
苗栗縣,苗栗市,文聖里,1264,867,397,11,1275,3556,0,35.85,24.38
苗栗縣,苗栗市,合計,29539,20716,8823,249,29788,73644,87384,40.45,28.13
苗栗縣,苑裡鎮,苑東里,817,385,432,10,827,2145,0,38.55,17.95
苗栗縣,苑裡鎮,苑南里,603,280,323,2,605,1435,0,42.16,19.51
苗栗縣,苑裡鎮,苑北里,366,160,206,1,367,878,0,41.8,18.22
苗栗縣,苑裡鎮,西平里,572,228,344,6,578,1612,0,35.86,14.14
苗栗縣,苑裡鎮,苑港里,417,129,288,6,423,1191,0,35.52,10.83
苗栗縣,苑裡鎮,西勢里,707,304,403,8,715,1961,0,36.46,15.5
苗栗縣,苑裡鎮,海岸里,342,139,203,4,346,1037,0,33.37,13.4
苗栗縣,苑裡鎮,房裡里,774,360,414,3,777,2186,0,35.54,16.47
苗栗縣,苑裡鎮,客庄里,1517,701,816,12,1529,3952,0,38.69,17.74
苗栗縣,苑裡鎮,中正里,712,321,391,5,717,2128,0,33.69,15.08
苗栗縣,苑裡鎮,苑坑里,285,101,184,0,285,912,0,31.25,11.07
苗栗縣,苑裡鎮,水坡里,221,77,144,3,224,628,0,35.67,12.26
苗栗縣,苑裡鎮,新復里,535,257,278,6,541,1353,0,39.99,18.99
苗栗縣,苑裡鎮,山脚里,483,227,256,3,486,1350,0,36.0,16.81
苗栗縣,苑裡鎮,舊社里,623,294,329,10,633,1788,0,35.4,16.44
苗栗縣,苑裡鎮,福田里,427,196,231,3,430,1235,0,34.82,15.87
苗栗縣,苑裡鎮,石鎮里,186,96,90,1,187,546,0,34.25,17.58
苗栗縣,苑裡鎮,蕉埔里,276,149,127,1,277,770,0,35.97,19.35
苗栗縣,苑裡鎮,社苓里,771,345,426,9,780,2413,0,32.32,14.3
苗栗縣,苑裡鎮,泰田里,567,211,356,7,574,1649,0,34.81,12.8
苗栗縣,苑裡鎮,上舘里,562,282,280,8,570,1604,0,35.54,17.58
苗栗縣,苑裡鎮,玉田里,557,254,303,5,562,1758,0,31.97,14.45
苗栗縣,苑裡鎮,南勢里,221,85,136,4,225,680,0,33.09,12.5
苗栗縣,苑裡鎮,山柑里,438,226,212,5,443,1419,0,31.22,15.93
苗栗縣,苑裡鎮,田心里,663,326,337,2,665,1872,0,35.52,17.41
苗栗縣,苑裡鎮,合計,13642,6133,7509,124,13766,38502,44437,35.75,15.93
苗栗縣,通霄鎮,通東里,405,188,217,6,411,1064,0,38.63,17.67
苗栗縣,通霄鎮,通西里,791,370,421,7,798,1916,0,41.65,19.31
苗栗縣,通霄鎮,平元里,719,318,401,9,728,1805,0,40.33,17.62
苗栗縣,通霄鎮,梅南里,518,222,296,5,523,1531,0,34.16,14.5
苗栗縣,通霄鎮,圳頭里,247,112,135,3,250,676,0,36.98,16.57
苗栗縣,通霄鎮,通南里,877,421,456,4,881,2637,0,33.41,15.97
苗栗縣,通霄鎮,城北里,223,103,120,4,227,658,0,34.5,15.65
苗栗縣,通霄鎮,城南里,311,137,174,11,322,903,0,35.66,15.17
苗栗縣,通霄鎮,南和里,291,120,171,3,294,769,0,38.23,15.6
苗栗縣,通霄鎮,福興里,224,118,106,5,229,622,0,36.82,18.97
苗栗縣,通霄鎮,坪頂里,395,221,174,5,400,1189,0,33.64,18.59
苗栗縣,通霄鎮,五南里,441,217,224,5,446,1325,0,33.66,16.38
苗栗縣,通霄鎮,五北里,458,198,260,4,462,1379,0,33.5,14.36
苗栗縣,通霄鎮,內湖里,528,255,273,4,532,1822,0,29.2,14.0
苗栗縣,通霄鎮,楓樹里,145,80,65,0,145,415,0,34.94,19.28
苗栗縣,通霄鎮,烏眉里,292,189,103,4,296,856,0,34.58,22.08
苗栗縣,通霄鎮,福龍里,123,78,45,1,124,385,0,32.21,20.26
苗栗縣,通霄鎮,福源里,226,122,104,4,230,770,0,29.87,15.84
苗栗縣,通霄鎮,通灣里,624,312,312,9,633,2187,0,28.94,14.27
苗栗縣,通霄鎮,新埔里,334,116,218,6,340,1078,0,31.54,10.76
苗栗縣,通霄鎮,內島里,221,94,127,2,223,709,0,31.45,13.26
苗栗縣,通霄鎮,白東里,425,225,200,5,430,1405,0,30.6,16.01
苗栗縣,通霄鎮,白西里,227,109,118,4,231,709,0,32.58,15.37
苗栗縣,通霄鎮,平安里,677,321,356,8,685,2009,0,34.1,15.98
苗栗縣,通霄鎮,合計,9722,4646,5076,118,9840,28819,32701,34.14,16.12
苗栗縣,竹南鎮,竹南里,813,463,350,2,815,1893,0,43.05,24.46
苗栗縣,竹南鎮,照南里,1437,786,651,17,1454,3293,0,44.15,23.87
苗栗縣,竹南鎮,正南里,972,517,455,3,975,2715,0,35.91,19.04
苗栗縣,竹南鎮,新南里,1998,1128,870,23,2021,4759,0,42.47,23.7
苗栗縣,竹南鎮,大厝里,2102,1294,808,21,2123,5205,0,40.79,24.86
苗栗縣,竹南鎮,營盤里,1328,692,636,12,1340,3484,0,38.46,19.86
苗栗縣,竹南鎮,聖福里,1366,793,573,9,1375,3366,0,40.85,23.56
苗栗縣,竹南鎮,竹興里,1047,587,460,9,1056,3259,0,32.4,18.01
苗栗縣,竹南鎮,龍鳳里,752,434,318,4,756,2041,0,37.04,21.26
苗栗縣,竹南鎮,山佳里,1654,1025,629,19,1673,4916,0,34.03,20.85
苗栗縣,竹南鎮,中港里,404,224,180,4,408,1080,0,37.78,20.74
苗栗縣,竹南鎮,中華里,1157,652,505,9,1166,2759,0,42.26,23.63
苗栗縣,竹南鎮,中英里,538,316,222,1,539,1520,0,35.46,20.79
苗栗縣,竹南鎮,中美里,723,426,297,2,725,1941,0,37.35,21.95
苗栗縣,竹南鎮,開元里,438,228,210,4,442,1207,0,36.62,18.89
苗栗縣,竹南鎮,海口里,1350,763,587,12,1362,4107,0,33.16,18.58
苗栗縣,竹南鎮,港墘里,824,458,366,10,834,2198,0,37.94,20.84
苗栗縣,竹南鎮,公舘里,375,248,127,6,381,1138,0,33.48,21.79
苗栗縣,竹南鎮,大埔里,1558,868,690,12,1570,4771,0,32.91,18.19
苗栗縣,竹南鎮,頂埔里,797,413,384,13,810,2066,0,39.21,19.99
苗栗縣,竹南鎮,崎頂里,1402,774,628,15,1417,3817,0,37.12,20.28
苗栗縣,竹南鎮,公義里,362,198,164,7,369,1009,0,36.57,19.62
苗栗縣,竹南鎮,佳興里,1193,652,541,21,1214,3241,0,37.46,20.12
苗栗縣,竹南鎮,天文里,838,519,319,9,847,2154,0,39.32,24.09
苗栗縣,竹南鎮,龍山里,912,501,411,6,918,2327,0,39.45,21.53
苗栗縣,竹南鎮,合計,26340,14959,11381,250,26590,70266,87307,37.84,21.29
苗栗縣,頭份市,流東里,708,482,226,9,717,2182,0,32.86,22.09
苗栗縣,頭份市,珊湖里,620,424,196,4,624,1710,0,36.49,24.8
苗栗縣,頭份市,斗煥里,1086,783,303,7,1093,2890,0,37.82,27.09
苗栗縣,頭份市,新華里,1404,1025,379,24,1428,3743,0,38.15,27.38
苗栗縣,頭份市,興隆里,1631,1105,526,12,1643,4464,0,36.81,24.75
苗栗縣,頭份市,上埔里,913,652,261,15,928,2565,0,36.18,25.42
苗栗縣,頭份市,土牛里,367,236,131,6,373,1018,0,36.64,23.18
苗栗縣,頭份市,頭份里,1177,806,371,14,1191,3264,0,36.49,24.69
苗栗縣,頭份市,忠孝里,1290,934,356,11,1301,3066,0,42.43,30.46
苗栗縣,頭份市,仁愛里,575,380,195,4,579,1574,0,36.79,24.14
苗栗縣,頭份市,信義里,334,214,120,7,341,977,0,34.9,21.9
苗栗縣,頭份市,和平里,489,305,184,4,493,1036,0,47.59,29.44
苗栗縣,頭份市,民族里,789,560,229,11,800,2007,0,39.86,27.9
苗栗縣,頭份市,東庄里,1539,1048,491,9,1548,4392,0,35.25,23.86
苗栗縣,頭份市,後庄里,1723,1084,639,9,1732,4339,0,39.92,24.98
苗栗縣,頭份市,山下里,1535,1032,503,17,1552,4022,0,38.59,25.66
苗栗縣,頭份市,蟠桃里,1179,792,387,8,1187,3306,0,35.9,23.96
苗栗縣,頭份市,田寮里,1411,943,468,6,1417,3987,0,35.54,23.65
苗栗縣,頭份市,蘆竹里,500,291,209,7,507,1289,0,39.33,22.58
苗栗縣,頭份市,上興里,643,412,231,11,654,2144,0,30.5,19.22
苗栗縣,頭份市,下興里,887,603,284,8,895,2511,0,35.64,24.01
苗栗縣,頭份市,尖山里,520,358,162,7,527,1295,0,40.69,27.64
苗栗縣,頭份市,尖下里,916,654,262,6,922,2511,0,36.72,26.05
苗栗縣,頭份市,廣興里,364,259,105,8,372,878,0,42.37,29.5
苗栗縣,頭份市,濫坑里,824,597,227,13,837,2216,0,37.77,26.94
苗栗縣,頭份市,民權里,864,549,315,3,867,2277,0,38.08,24.11
苗栗縣,頭份市,民生里,822,555,267,11,833,2362,0,35.27,23.5
苗栗縣,頭份市,建國里,1377,1025,352,14,1391,3387,0,41.07,30.26
苗栗縣,頭份市,成功里,1316,936,380,15,1331,3570,0,37.28,26.22
苗栗縣,頭份市,自強里,782,516,266,2,784,1951,0,40.18,26.45
苗栗縣,頭份市,合興里,917,625,292,9,926,2514,0,36.83,24.86
苗栗縣,頭份市,文化里,1341,854,487,13,1354,3515,0,38.52,24.3
苗栗縣,頭份市,中興里,1010,685,325,6,1016,2774,0,36.63,24.69
苗栗縣,頭份市,合計,31853,21724,10129,310,32163,85736,104902,37.51,25.34
苗栗縣,後龍鎮,南龍里,456,250,206,10,466,1399,0,33.31,17.87
苗栗縣,後龍鎮,中龍里,312,164,148,6,318,731,0,43.5,22.44
苗栗縣,後龍鎮,北龍里,498,247,251,6,504,1248,0,40.38,19.79
苗栗縣,後龍鎮,大庄里,1468,833,635,14,1482,4216,0,35.15,19.76
苗栗縣,後龍鎮,溪洲里,689,391,298,12,701,2258,0,31.05,17.32
苗栗縣,後龍鎮,豐富里,512,362,150,4,516,1219,0,42.33,29.7
苗栗縣,後龍鎮,校椅里,393,275,118,5,398,1026,0,38.79,26.8
苗栗縣,後龍鎮,埔頂里,847,484,363,14,861,2669,0,32.26,18.13
苗栗縣,後龍鎮,新民里,491,286,205,5,496,1304,0,38.04,21.93
苗栗縣,後龍鎮,復興里,241,117,124,2,243,679,0,35.79,17.23
苗栗縣,後龍鎮,東明里,444,221,223,5,449,1462,0,30.71,15.12
苗栗縣,後龍鎮,大山里,493,240,253,7,500,1503,0,33.27,15.97
苗栗縣,後龍鎮,灣寶里,378,178,200,10,388,1231,0,31.52,14.46
苗栗縣,後龍鎮,海寶里,307,146,161,4,311,957,0,32.5,15.26
苗栗縣,後龍鎮,外埔里,302,186,116,3,305,982,0,31.06,18.94
苗栗縣,後龍鎮,海埔里,270,124,146,4,274,897,0,30.55,13.82
苗栗縣,後龍鎮,秀水里,242,116,126,1,243,682,0,35.63,17.01
苗栗縣,後龍鎮,水尾里,336,168,168,7,343,1023,0,33.53,16.42
苗栗縣,後龍鎮,龍津里,209,112,97,4,213,591,0,36.04,18.95
苗栗縣,後龍鎮,龍坑里,406,183,223,7,413,1251,0,33.01,14.63
苗栗縣,後龍鎮,福寧里,214,107,107,2,216,718,0,30.08,14.9
苗栗縣,後龍鎮,中和里,305,168,137,5,310,1010,0,30.69,16.63
苗栗縣,後龍鎮,南港里,358,174,184,3,361,1188,0,30.39,14.65
苗栗縣,後龍鎮,合計,10171,5532,4639,140,10311,30244,34941,34.09,18.29
苗栗縣,卓蘭鎮,中街里,318,161,157,0,318,698,0,45.56,23.07
苗栗縣,卓蘭鎮,新厝里,597,325,272,10,607,1479,0,41.04,21.97
苗栗縣,卓蘭鎮,上新里,756,364,392,5,761,1991,0,38.22,18.28
苗栗縣,卓蘭鎮,豐田里,349,167,182,8,357,937,0,38.1,17.82
苗栗縣,卓蘭鎮,西坪里,239,133,106,0,239,674,0,35.46,19.73
苗栗縣,卓蘭鎮,景山里,273,161,112,2,275,923,0,29.79,17.44
苗栗縣,卓蘭鎮,老庄里,741,376,365,9,750,1876,0,39.98,20.04
苗栗縣,卓蘭鎮,新榮里,425,186,239,5,430,1056,0,40.72,17.61
苗栗縣,卓蘭鎮,內灣里,741,362,379,3,744,2071,0,35.92,17.48
苗栗縣,卓蘭鎮,苗豐里,268,129,139,2,270,702,0,38.46,18.38
苗栗縣,卓蘭鎮,坪林里,347,189,158,2,349,1067,0,32.71,17.71
苗栗縣,卓蘭鎮,西坪里、坪林里,254,165,89,3,257,715,0,35.94,23.08
苗栗縣,卓蘭鎮,合計,5308,2718,2590,49,5357,14189,16007,37.75,19.16
苗栗縣,大湖鄉,大湖村,632,466,166,6,638,1539,0,41.46,30.28
苗栗縣,大湖鄉,明湖村,256,204,52,1,257,557,0,46.14,36.62
苗栗縣,大湖鄉,靜湖村,594,443,151,9,603,1714,0,35.18,25.85
苗栗縣,大湖鄉,富興村,392,246,146,4,396,1323,0,29.93,18.59
苗栗縣,大湖鄉,大南村,170,128,42,5,175,529,0,33.08,24.2
苗栗縣,大湖鄉,大寮村,424,292,132,3,427,1155,0,36.97,25.28
苗栗縣,大湖鄉,南湖村,221,144,77,1,222,599,0,37.06,24.04
苗栗縣,大湖鄉,義和村,429,273,156,7,436,1448,0,30.11,18.85
苗栗縣,大湖鄉,東興村,234,158,76,3,237,739,0,32.07,21.38
苗栗縣,大湖鄉,武榮村,181,133,48,3,184,484,0,38.02,27.48
苗栗縣,大湖鄉,栗林村,279,183,96,3,282,988,0,28.54,18.52
苗栗縣,大湖鄉,新開村,301,181,120,2,303,993,0,30.51,18.23
苗栗縣,大湖鄉,合計,4113,2851,1262,47,4160,12068,13686,34.47,23.62
苗栗縣,公館鄉,館中村,640,409,231,9,649,1507,0,43.07,27.14
苗栗縣,公館鄉,館東村,931,657,274,8,939,2286,0,41.08,28.74
苗栗縣,公館鄉,館南村,1259,862,397,15,1274,3412,0,37.34,25.26
苗栗縣,公館鄉,大坑村,349,216,133,5,354,921,0,38.44,23.45
苗栗縣,公館鄉,中義村,767,514,253,8,775,2259,0,34.31,22.75
苗栗縣,公館鄉,玉泉村,923,602,321,4,927,2296,0,40.37,26.22
苗栗縣,公館鄉,石墻村,518,371,147,6,524,1448,0,36.19,25.62
苗栗縣,公館鄉,福基村,391,285,106,6,397,995,0,39.9,28.64
苗栗縣,公館鄉,福星村,787,533,254,10,797,2019,0,39.47,26.4
苗栗縣,公館鄉,開礦村,103,80,23,3,106,280,0,37.86,28.57
苗栗縣,公館鄉,福德村,161,88,73,1,162,339,0,47.79,25.96
苗栗縣,公館鄉,五谷村,859,534,325,15,874,2213,0,39.49,24.13
苗栗縣,公館鄉,玉谷村,529,366,163,11,540,1453,0,37.16,25.19
苗栗縣,公館鄉,鶴岡村,647,448,199,3,650,1579,0,41.17,28.37
苗栗縣,公館鄉,鶴山村,536,366,170,4,540,1427,0,37.84,25.65
苗栗縣,公館鄉,仁安村,479,326,153,3,482,1270,0,37.95,25.67
苗栗縣,公館鄉,尖山村,536,347,189,6,542,1415,0,38.3,24.52
苗栗縣,公館鄉,南河村,87,71,16,2,89,213,0,41.78,33.33
苗栗縣,公館鄉,北河村,104,68,36,0,104,329,0,31.61,20.67
苗栗縣,公館鄉,合計,10606,7143,3463,119,10725,27661,32119,38.77,25.82
苗栗縣,銅鑼鄉,福興村,409,344,65,3,412,940,0,43.83,36.6
苗栗縣,銅鑼鄉,銅鑼村,1722,1229,493,16,1738,4334,0,40.1,28.36
苗栗縣,銅鑼鄉,朝陽村,681,492,189,5,686,1617,0,42.42,30.43
苗栗縣,銅鑼鄉,樟樹村,404,266,138,9,413,1247,0,33.12,21.33
苗栗縣,銅鑼鄉,九湖村,416,297,119,6,422,1142,0,36.95,26.01
苗栗縣,銅鑼鄉,竹森村,331,243,88,0,331,1021,0,32.42,23.8
苗栗縣,銅鑼鄉,中平村,1100,739,361,15,1115,3115,0,35.79,23.72
苗栗縣,銅鑼鄉,興隆村,189,117,72,2,191,540,0,35.37,21.67
苗栗縣,銅鑼鄉,盛隆村,143,97,46,2,145,411,0,35.28,23.6
苗栗縣,銅鑼鄉,新隆村,227,151,76,3,230,525,0,43.81,28.76
苗栗縣,銅鑼鄉,合計,5622,3975,1647,61,5683,14892,17039,38.16,26.69
苗栗縣,南庄鄉,東村,417,309,108,4,421,1102,0,38.2,28.04
苗栗縣,南庄鄉,西村,223,159,64,2,225,609,0,36.95,26.11
苗栗縣,南庄鄉,南江村,371,286,85,3,374,1283,0,29.15,22.29
苗栗縣,南庄鄉,田美村,272,181,91,5,277,793,0,34.93,22.82
苗栗縣,南庄鄉,獅山村,265,186,79,3,268,793,0,33.8,23.46
苗栗縣,南庄鄉,南富村,466,338,128,6,472,1037,0,45.52,32.59
苗栗縣,南庄鄉,員林村,383,266,117,2,385,986,0,39.05,26.98
苗栗縣,南庄鄉,蓬萊村,231,185,46,3,234,838,0,27.92,22.08
苗栗縣,南庄鄉,東河村,227,188,39,5,232,912,0,25.44,20.61
苗栗縣,南庄鄉,合計,2855,2098,757,33,2888,8353,9430,34.57,25.12
苗栗縣,頭屋鄉,頭屋村,981,700,281,7,988,2420,0,40.83,28.93
苗栗縣,頭屋鄉,象山村,687,460,227,6,693,1786,0,38.8,25.76
苗栗縣,頭屋鄉,北坑村,244,183,61,2,246,687,0,35.81,26.64
苗栗縣,頭屋鄉,獅潭村,648,465,183,12,660,1635,0,40.37,28.44
苗栗縣,頭屋鄉,曲洞村,396,265,131,3,399,848,0,47.05,31.25
苗栗縣,頭屋鄉,飛鳳村,162,112,50,3,165,377,0,43.77,29.71
苗栗縣,頭屋鄉,明德村,427,296,131,3,430,968,0,44.42,30.58
苗栗縣,頭屋鄉,鳴鳳村,124,81,43,4,128,302,0,42.38,26.82
苗栗縣,頭屋鄉,合計,3669,2562,1107,40,3709,9023,10112,41.11,28.39
苗栗縣,三義鄉,廣盛村,1596,1108,488,10,1606,3909,0,41.08,28.34
苗栗縣,三義鄉,双湖村,691,483,208,4,695,1787,0,38.89,27.03
苗栗縣,三義鄉,双潭村,485,344,141,5,490,1321,0,37.09,26.04
苗栗縣,三義鄉,勝興村,1323,850,473,19,1342,3286,0,40.84,25.87
苗栗縣,三義鄉,西湖村,570,424,146,7,577,1427,0,40.43,29.71
苗栗縣,三義鄉,龍騰村,169,128,41,1,170,402,0,42.29,31.84
苗栗縣,三義鄉,鯉魚潭村,465,226,239,7,472,1241,0,38.03,18.21
苗栗縣,三義鄉,合計,5299,3563,1736,53,5352,13373,15480,40.02,26.64
苗栗縣,西湖鄉,高埔村,228,189,39,6,234,595,0,39.33,31.76
苗栗縣,西湖鄉,下埔村,194,155,39,4,198,564,0,35.11,27.48
苗栗縣,西湖鄉,五湖村,280,206,74,3,283,790,0,35.82,26.08
苗栗縣,西湖鄉,四湖村,207,155,52,0,207,627,0,33.01,24.72
苗栗縣,西湖鄉,金獅村,182,139,43,0,182,482,0,37.76,28.84
苗栗縣,西湖鄉,龍洞村,149,93,56,3,152,446,0,34.08,20.85
苗栗縣,西湖鄉,三湖村,316,215,101,2,318,871,0,36.51,24.68
苗栗縣,西湖鄉,湖東村,338,247,91,5,343,1112,0,30.85,22.21
苗栗縣,西湖鄉,二湖村,215,152,63,2,217,646,0,33.59,23.53
苗栗縣,西湖鄉,合計,2109,1551,558,25,2134,6133,6635,34.8,25.29
苗栗縣,造橋鄉,造橋村,756,539,217,6,762,2010,0,37.91,26.82
苗栗縣,造橋鄉,平興村,176,126,50,0,176,442,0,39.82,28.51
苗栗縣,造橋鄉,豐湖村,378,255,123,3,381,969,0,39.32,26.32
苗栗縣,造橋鄉,大西村,1198,812,386,14,1212,3315,0,36.56,24.49
苗栗縣,造橋鄉,錦水村,182,125,57,3,185,479,0,38.62,26.1
苗栗縣,造橋鄉,大龍村,190,132,58,2,192,485,0,39.59,27.22
苗栗縣,造橋鄉,朝陽村,431,254,177,9,440,1252,0,35.14,20.29
苗栗縣,造橋鄉,談文村,288,178,110,5,293,837,0,35.01,21.27
苗栗縣,造橋鄉,龍昇村,301,148,153,2,303,943,0,32.13,15.69
苗栗縣,造橋鄉,合計,3900,2569,1331,44,3944,10732,12084,36.75,23.94
苗栗縣,三灣鄉,三灣村,769,525,244,6,775,2118,0,36.59,24.79
苗栗縣,三灣鄉,內灣村,267,190,77,6,273,613,0,44.54,31.0
苗栗縣,三灣鄉,銅鏡村,320,236,84,5,325,822,0,39.54,28.71
苗栗縣,三灣鄉,頂寮村,73,46,27,1,74,227,0,32.6,20.26
苗栗縣,三灣鄉,北埔村,162,102,60,4,166,517,0,32.11,19.73
苗栗縣,三灣鄉,大河村,201,135,66,3,204,523,0,39.01,25.81
苗栗縣,三灣鄉,大坪村,181,120,61,3,184,391,0,47.06,30.69
苗栗縣,三灣鄉,永和村,159,116,43,5,164,368,0,44.57,31.52
苗栗縣,三灣鄉,合計,2132,1470,662,33,2165,5579,6259,38.81,26.35
苗栗縣,獅潭鄉,百壽村,94,81,13,1,95,322,0,29.5,25.16
苗栗縣,獅潭鄉,永興村,199,147,52,9,208,531,0,39.17,27.68
苗栗縣,獅潭鄉,新店村,317,227,90,7,324,869,0,37.28,26.12
苗栗縣,獅潭鄉,和興村,196,137,59,4,200,539,0,37.11,25.42
苗栗縣,獅潭鄉,豐林村,198,151,47,7,205,548,0,37.41,27.55
苗栗縣,獅潭鄉,新豐村,124,88,36,2,126,323,0,39.01,27.24
苗栗縣,獅潭鄉,竹木村,276,204,72,5,281,650,0,43.23,31.38
苗栗縣,獅潭鄉,合計,1404,1035,369,35,1439,3782,4094,38.05,27.37
苗栗縣,泰安鄉,八卦村,85,65,20,1,86,336,0,25.6,19.35
苗栗縣,泰安鄉,錦水村,314,259,55,2,316,1070,0,29.53,24.21
苗栗縣,泰安鄉,清安村,289,231,58,4,293,871,0,33.64,26.52
苗栗縣,泰安鄉,大興村,190,167,23,2,192,480,0,40.0,34.79
苗栗縣,泰安鄉,中興村,131,108,23,0,131,501,0,26.15,21.56
苗栗縣,泰安鄉,梅園村,135,111,24,2,137,481,0,28.48,23.08
苗栗縣,泰安鄉,象鼻村,177,147,30,6,183,666,0,27.48,22.07
苗栗縣,泰安鄉,士林村,198,179,19,5,203,590,0,34.41,30.34
苗栗縣,泰安鄉,合計,1519,1267,252,22,1541,4995,5695,30.85,25.37
苗栗縣,合計,合計,169803,106512,63291,1752,171555,457991,540312,37.46,23.26
彰化縣,彰化市,文化里,530,262,268,6,536,1253,0,42.78,20.91
彰化縣,彰化市,下廍里,2127,1076,1051,11,2138,4972,0,43.0,21.64
彰化縣,彰化市,興北里,678,324,354,4,682,1603,0,42.55,20.21
彰化縣,彰化市,信義里,376,178,198,4,380,760,0,50.0,23.42
彰化縣,彰化市,民生里,573,300,273,6,579,1331,0,43.5,22.54
彰化縣,彰化市,陽明里,742,355,387,11,753,1723,0,43.7,20.6
彰化縣,彰化市,萬安里,1719,817,902,14,1733,3835,0,45.19,21.3
彰化縣,彰化市,新興里,2263,1076,1187,18,2281,5212,0,43.76,20.64
彰化縣,彰化市,新華里,765,400,365,9,774,1718,0,45.05,23.28
彰化縣,彰化市,龍山里,833,401,432,2,835,1895,0,44.06,21.16
彰化縣,彰化市,中山里,343,206,137,4,347,762,0,45.54,27.03
彰化縣,彰化市,中正里,645,337,308,4,649,1377,0,47.13,24.47
彰化縣,彰化市,永福里,395,168,227,3,398,862,0,46.17,19.49
彰化縣,彰化市,光復里,260,93,167,6,266,642,0,41.43,14.49
彰化縣,彰化市,光華里,362,172,190,0,362,706,0,51.27,24.36
彰化縣,彰化市,萬壽里,380,131,249,4,384,864,0,44.44,15.16
彰化縣,彰化市,中央里,372,153,219,5,377,748,0,50.4,20.45
彰化縣,彰化市,富貴里,392,164,228,2,394,863,0,45.65,19.0
彰化縣,彰化市,民權里,466,214,252,4,470,1067,0,44.05,20.06
彰化縣,彰化市,西興里,1474,747,727,5,1479,3304,0,44.76,22.61
彰化縣,彰化市,西勢里,1550,842,708,18,1568,3585,0,43.74,23.49
彰化縣,彰化市,忠孝里,525,266,259,7,532,1129,0,47.12,23.56
彰化縣,彰化市,忠權里,1328,686,642,17,1345,3158,0,42.59,21.72
彰化縣,彰化市,五權里,1524,784,740,16,1540,4175,0,36.89,18.78
彰化縣,彰化市,長樂里,457,191,266,3,460,930,0,49.46,20.54
彰化縣,彰化市,東芳里,1389,665,724,14,1403,3505,0,40.03,18.97
彰化縣,彰化市,南安里,885,444,441,8,893,2137,0,41.79,20.78
彰化縣,彰化市,南美里,733,358,375,6,739,1884,0,39.23,19.0
彰化縣,彰化市,莿桐里,1320,638,682,15,1335,3079,0,43.36,20.72
彰化縣,彰化市,磚磘里,1262,641,621,14,1276,3285,0,38.84,19.51
彰化縣,彰化市,平和里,1672,836,836,24,1696,4235,0,40.05,19.74
彰化縣,彰化市,桃源里,961,475,486,7,968,2424,0,39.93,19.6
彰化縣,彰化市,卦山里,1093,590,503,9,1102,2437,0,45.22,24.21
彰化縣,彰化市,東興里,676,323,353,7,683,1511,0,45.2,21.38
彰化縣,彰化市,大同里,455,209,246,3,458,974,0,47.02,21.46
彰化縣,彰化市,永生里,543,261,282,4,547,1169,0,46.79,22.33
彰化縣,彰化市,華陽里,746,426,320,7,753,1770,0,42.54,24.07
彰化縣,彰化市,華北里,631,334,297,9,640,1426,0,44.88,23.42
彰化縣,彰化市,南瑶里,3233,1603,1630,22,3255,7458,0,43.64,21.49
彰化縣,彰化市,成功里,651,323,328,9,660,1470,0,44.9,21.97
彰化縣,彰化市,延和里,2089,1041,1048,14,2103,4938,0,42.59,21.08
彰化縣,彰化市,南興里,3128,1546,1582,26,3154,7515,0,41.97,20.57
彰化縣,彰化市,西安里,1221,605,616,10,1231,2775,0,44.36,21.8
彰化縣,彰化市,彰安里,1255,605,650,12,1267,2845,0,44.53,21.27
彰化縣,彰化市,光南里,638,321,317,3,641,1419,0,45.17,22.62
彰化縣,彰化市,介壽里,958,589,369,5,963,2598,0,37.07,22.67
彰化縣,彰化市,延平里,3769,1966,1803,28,3797,8962,0,42.37,21.94
彰化縣,彰化市,建寶里,1018,577,441,10,1028,2240,0,45.89,25.76
彰化縣,彰化市,福安里,449,216,233,10,459,981,0,46.79,22.02
彰化縣,彰化市,大竹里,1314,651,663,10,1324,3193,0,41.47,20.39
彰化縣,彰化市,竹中里,634,336,298,10,644,1653,0,38.96,20.33
彰化縣,彰化市,安溪里,787,400,387,8,795,1899,0,41.86,21.06
彰化縣,彰化市,香山里,1300,624,676,22,1322,3295,0,40.12,18.94
彰化縣,彰化市,牛埔里,1242,561,681,13,1255,2951,0,42.53,19.01
彰化縣,彰化市,福山里,2712,1257,1455,32,2744,6731,0,40.77,18.67
彰化縣,彰化市,中庄里,962,451,511,10,972,2426,0,40.07,18.59
彰化縣,彰化市,三村里,437,214,223,2,439,1183,0,37.11,18.09
彰化縣,彰化市,國聖里,1013,471,542,16,1029,2414,0,42.63,19.51
彰化縣,彰化市,寶廍里,478,221,257,10,488,1222,0,39.93,18.09
彰化縣,彰化市,茄苳里,386,195,191,2,388,936,0,41.45,20.83
彰化縣,彰化市,茄南里,1240,631,609,15,1255,2915,0,43.05,21.65
彰化縣,彰化市,阿夷里,3344,1791,1553,26,3370,8423,0,40.01,21.26
彰化縣,彰化市,古夷里,927,432,495,7,934,2377,0,39.29,18.17
彰化縣,彰化市,復興里,1777,927,850,17,1794,4046,0,44.34,22.91
彰化縣,彰化市,和調里,1125,584,541,7,1132,2634,0,42.98,22.17
彰化縣,彰化市,石牌里,417,207,210,6,423,1132,0,37.37,18.29
彰化縣,彰化市,福田里,469,237,232,4,473,1249,0,37.87,18.98
彰化縣,彰化市,竹巷里,321,142,179,3,324,840,0,38.57,16.9
彰化縣,彰化市,田中里,357,171,186,3,360,885,0,40.68,19.32
彰化縣,彰化市,快官里,459,211,248,2,461,1114,0,41.38,18.94
彰化縣,彰化市,台鳳里,1666,933,733,10,1676,4349,0,38.54,21.45
彰化縣,彰化市,崙平里,2253,1146,1107,17,2270,5297,0,42.85,21.63
彰化縣,彰化市,向陽里,2182,1193,989,14,2196,5234,0,41.96,22.79
彰化縣,彰化市,合計,79656,39921,39735,725,80381,189909,229765,42.33,21.02
彰化縣,鹿港鎮,大有里,466,183,283,3,469,1109,0,42.29,16.5
彰化縣,鹿港鎮,中興里,220,71,149,1,221,506,0,43.68,14.03
彰化縣,鹿港鎮,洛津里,314,123,191,1,315,847,0,37.19,14.52
彰化縣,鹿港鎮,順興里,379,164,215,0,379,906,0,41.83,18.1
彰化縣,鹿港鎮,頂厝里,2875,1229,1646,29,2904,7832,0,37.08,15.69
彰化縣,鹿港鎮,東崎里,1816,804,1012,14,1830,5195,0,35.23,15.48
彰化縣,鹿港鎮,埔崙里,1926,752,1174,21,1947,5046,0,38.59,14.9
彰化縣,鹿港鎮,東石里,1602,547,1055,10,1612,4391,0,36.71,12.46
彰化縣,鹿港鎮,郭厝里,218,77,141,0,218,521,0,41.84,14.78
彰化縣,鹿港鎮,新宮里,399,133,266,1,400,837,0,47.79,15.89
彰化縣,鹿港鎮,玉順里,448,171,277,4,452,1126,0,40.14,15.19
彰化縣,鹿港鎮,景福里,472,235,237,3,475,1084,0,43.82,21.68
彰化縣,鹿港鎮,泰興里,496,220,276,3,499,1130,0,44.16,19.47
彰化縣,鹿港鎮,長興里,124,61,63,0,124,267,0,46.44,22.85
彰化縣,鹿港鎮,龍山里,278,115,163,6,284,618,0,45.95,18.61
彰化縣,鹿港鎮,興化里,250,107,143,1,251,574,0,43.73,18.64
彰化縣,鹿港鎮,菜園里,403,120,283,10,413,877,0,47.09,13.68
彰化縣,鹿港鎮,街尾里,999,400,599,9,1008,2170,0,46.45,18.43
彰化縣,鹿港鎮,頂番里,1327,683,644,13,1340,3879,0,34.54,17.61
彰化縣,鹿港鎮,頭崙里,904,443,461,12,916,2598,0,35.26,17.05
彰化縣,鹿港鎮,廖厝里,1323,693,630,16,1339,4105,0,32.62,16.88
彰化縣,鹿港鎮,溝墘里,1456,771,685,15,1471,4124,0,35.67,18.7
彰化縣,鹿港鎮,草中里,1166,625,541,10,1176,3189,0,36.88,19.6
彰化縣,鹿港鎮,頭南里,716,399,317,12,728,2191,0,33.23,18.21
彰化縣,鹿港鎮,山崙里,1058,474,584,10,1068,3032,0,35.22,15.63
彰化縣,鹿港鎮,海埔里,1182,498,684,12,1194,3575,0,33.4,13.93
彰化縣,鹿港鎮,詔安里,665,294,371,8,673,2076,0,32.42,14.16
彰化縣,鹿港鎮,洋厝里,899,382,517,17,916,2425,0,37.77,15.75
彰化縣,鹿港鎮,永安里,1568,665,903,17,1585,4383,0,36.16,15.17
彰化縣,鹿港鎮,合計,25949,11439,14510,258,26207,70613,86115,37.11,16.2
彰化縣,和美鎮,竹營里,2144,1095,1049,17,2161,6113,0,35.35,17.91
彰化縣,和美鎮,和東里,1646,797,849,12,1658,4323,0,38.35,18.44
彰化縣,和美鎮,和南里,181,105,76,0,181,398,0,45.48,26.38
彰化縣,和美鎮,和北里,623,299,324,7,630,1796,0,35.08,16.65
彰化縣,和美鎮,和西里,1215,599,616,14,1229,3164,0,38.84,18.93
彰化縣,和美鎮,四張里,1016,488,528,10,1026,2785,0,36.84,17.52
彰化縣,和美鎮,頭前里,544,283,261,6,550,1672,0,32.89,16.93
彰化縣,和美鎮,還社里,338,180,158,5,343,847,0,40.5,21.25
彰化縣,和美鎮,面前里,804,399,405,6,810,2119,0,38.23,18.83
彰化縣,和美鎮,鎮平里,1054,513,541,16,1070,2869,0,37.3,17.88
彰化縣,和美鎮,大霞里,466,234,232,2,468,1464,0,31.97,15.98
彰化縣,和美鎮,源埤里,617,308,309,8,625,1857,0,33.66,16.59
彰化縣,和美鎮,南佃里,812,392,420,6,818,2204,0,37.11,17.79
彰化縣,和美鎮,雅溝里,458,207,251,5,463,1318,0,35.13,15.71
彰化縣,和美鎮,山犁里,2004,1050,954,11,2015,5228,0,38.54,20.08
彰化縣,和美鎮,嘉犁里,725,376,349,7,732,1959,0,37.37,19.19
彰化縣,和美鎮,鐵山里,1061,496,565,12,1073,2669,0,40.2,18.58
彰化縣,和美鎮,詔安里,764,375,389,8,772,2034,0,37.95,18.44
彰化縣,和美鎮,柑井里,1179,531,648,22,1201,3450,0,34.81,15.39
彰化縣,和美鎮,竹園里,357,151,206,7,364,868,0,41.94,17.4
彰化縣,和美鎮,新庄里,962,501,461,21,983,2388,0,41.16,20.98
彰化縣,和美鎮,犁盛里,911,404,507,17,928,2277,0,40.76,17.74
彰化縣,和美鎮,中寮里,361,170,191,7,368,1109,0,33.18,15.33
彰化縣,和美鎮,中圍里,1055,492,563,10,1065,2845,0,37.43,17.29
彰化縣,和美鎮,糖友里,1556,832,724,14,1570,4308,0,36.44,19.31
彰化縣,和美鎮,塗厝里,590,309,281,5,595,1748,0,34.04,17.68
彰化縣,和美鎮,地潭里,246,138,108,1,247,842,0,29.33,16.39
彰化縣,和美鎮,湖內里,449,191,258,3,452,1196,0,37.79,15.97
彰化縣,和美鎮,嘉寶里,627,301,326,5,632,2038,0,31.01,14.77
彰化縣,和美鎮,月眉里,1122,501,621,15,1137,3033,0,37.49,16.52
彰化縣,和美鎮,好修里,563,257,306,7,570,1548,0,36.82,16.6
彰化縣,和美鎮,仁愛里,892,443,449,7,899,2716,0,33.1,16.31
彰化縣,和美鎮,合計,27342,13417,13925,293,27635,75185,89825,36.76,17.85
彰化縣,線西鄉,線西村,433,279,154,3,436,1187,0,36.73,23.5
彰化縣,線西鄉,頂庄村,828,498,330,11,839,2276,0,36.86,21.88
彰化縣,線西鄉,寓埔村,778,417,361,10,788,2324,0,33.91,17.94
彰化縣,線西鄉,塭仔村,441,227,214,2,443,1240,0,35.73,18.31
彰化縣,線西鄉,溝內村,382,212,170,4,386,1223,0,31.56,17.33
彰化縣,線西鄉,下犁村,681,327,354,8,689,1914,0,36.0,17.08
彰化縣,線西鄉,頂犁村,794,436,358,9,803,2519,0,31.88,17.31
彰化縣,線西鄉,德興村,506,276,230,5,511,1348,0,37.91,20.47
彰化縣,線西鄉,合計,4843,2672,2171,52,4895,14031,16573,34.89,19.04
彰化縣,伸港鄉,曾家村,529,249,280,7,536,1748,0,30.66,14.24
彰化縣,伸港鄉,蚵寮村,417,127,290,4,421,1157,0,36.39,10.98
彰化縣,伸港鄉,埤墘村,480,236,244,6,486,1484,0,32.75,15.9
彰化縣,伸港鄉,溪底村,693,315,378,4,697,2048,0,34.03,15.38
彰化縣,伸港鄉,泉州村,675,393,282,6,681,1990,0,34.22,19.75
彰化縣,伸港鄉,泉厝村,454,232,222,7,461,1273,0,36.21,18.22
彰化縣,伸港鄉,海尾村,663,337,326,8,671,1826,0,36.75,18.46
彰化縣,伸港鄉,全興村,502,344,158,4,506,1714,0,29.52,20.07
彰化縣,伸港鄉,定興村,840,436,404,17,857,2652,0,32.32,16.44
彰化縣,伸港鄉,新港村,1714,872,842,12,1726,5173,0,33.37,16.86
彰化縣,伸港鄉,什股村,619,375,244,6,625,2344,0,26.66,16.0
彰化縣,伸港鄉,大同村,954,449,505,8,962,2622,0,36.69,17.12
彰化縣,伸港鄉,七嘉村,983,523,460,6,989,3002,0,32.94,17.42
彰化縣,伸港鄉,汴頭村,723,383,340,13,736,2240,0,32.86,17.1
彰化縣,伸港鄉,合計,10246,5271,4975,108,10354,31273,37802,33.11,16.85
彰化縣,福興鄉,番社村,530,166,364,2,532,1480,0,35.95,11.22
彰化縣,福興鄉,社尾村,490,199,291,5,495,1453,0,34.07,13.7
彰化縣,福興鄉,大崙村,448,199,249,7,455,1237,0,36.78,16.09
彰化縣,福興鄉,外埔村,507,205,302,6,513,1505,0,34.09,13.62
彰化縣,福興鄉,外中村,423,155,268,2,425,1168,0,36.39,13.27
彰化縣,福興鄉,元中村,449,196,253,6,455,1273,0,35.74,15.4
彰化縣,福興鄉,三汴村,533,217,316,10,543,1360,0,39.93,15.96
彰化縣,福興鄉,萬豐村,367,145,222,2,369,832,0,44.35,17.43
彰化縣,福興鄉,番婆村,728,363,365,4,732,2397,0,30.54,15.14
彰化縣,福興鄉,橋頭村,934,433,501,9,943,2653,0,35.54,16.32
彰化縣,福興鄉,秀厝村,815,347,468,8,823,2550,0,32.27,13.61
彰化縣,福興鄉,鎮平村,367,196,171,6,373,1172,0,31.83,16.72
彰化縣,福興鄉,三和村,376,114,262,11,387,1047,0,36.96,10.89
彰化縣,福興鄉,麥厝村,631,248,383,13,644,2180,0,29.54,11.38
彰化縣,福興鄉,廈粘村,584,291,293,9,593,1856,0,31.95,15.68
彰化縣,福興鄉,頂粘村,645,347,298,10,655,2276,0,28.78,15.25
彰化縣,福興鄉,福寶村,331,185,146,5,336,1276,0,26.33,14.5
彰化縣,福興鄉,二港村,454,196,258,7,461,1275,0,36.16,15.37
彰化縣,福興鄉,福興村,1293,542,751,10,1303,3643,0,35.77,14.88
彰化縣,福興鄉,福南村,818,324,494,11,829,2581,0,32.12,12.55
彰化縣,福興鄉,同安村,750,335,415,3,753,2364,0,31.85,14.17
彰化縣,福興鄉,西勢村,690,311,379,10,700,1917,0,36.52,16.22
彰化縣,福興鄉,合計,13163,5714,7449,156,13319,39495,46114,33.72,14.47
彰化縣,秀水鄉,秀水村,684,293,391,7,691,1676,0,41.23,17.48
彰化縣,秀水鄉,安溪村,850,361,489,10,860,2038,0,42.2,17.71
彰化縣,秀水鄉,莊雅村,1039,585,454,8,1047,2642,0,39.63,22.14
彰化縣,秀水鄉,金興村,636,329,307,8,644,1828,0,35.23,18.0
彰化縣,秀水鄉,陝西村,505,275,230,3,508,1438,0,35.33,19.12
彰化縣,秀水鄉,安東村,1487,736,751,13,1500,3871,0,38.75,19.01
彰化縣,秀水鄉,鶴鳴村,1268,597,671,11,1279,3154,0,40.55,18.93
彰化縣,秀水鄉,馬興村,888,405,483,16,904,2279,0,39.67,17.77
彰化縣,秀水鄉,義興村,509,267,242,5,514,1479,0,34.75,18.05
彰化縣,秀水鄉,福安村,1682,815,867,15,1697,4523,0,37.52,18.02
彰化縣,秀水鄉,埔崙村,843,397,446,9,852,1939,0,43.94,20.47
彰化縣,秀水鄉,曾厝村,633,325,308,7,640,1677,0,38.16,19.38
彰化縣,秀水鄉,金陵村,669,273,396,4,673,1737,0,38.74,15.72
彰化縣,秀水鄉,下崙村,774,321,453,5,779,2170,0,35.9,14.79
彰化縣,秀水鄉,合計,12467,5979,6488,121,12588,32451,38830,38.79,18.42
彰化縣,花壇鄉,花壇村,1324,684,640,13,1337,3179,0,42.06,21.52
彰化縣,花壇鄉,金墩村,674,328,346,15,689,1758,0,39.19,18.66
彰化縣,花壇鄉,中庄村,922,479,443,5,927,2329,0,39.8,20.57
彰化縣,花壇鄉,劉厝村,454,197,257,10,464,1069,0,43.41,18.43
彰化縣,花壇鄉,崙雅村,559,251,308,5,564,1419,0,39.75,17.69
彰化縣,花壇鄉,南口村,752,385,367,11,763,1892,0,40.33,20.35
彰化縣,花壇鄉,中口村,296,134,162,1,297,721,0,41.19,18.59
彰化縣,花壇鄉,北口村,731,380,351,6,737,1803,0,40.88,21.08
彰化縣,花壇鄉,長沙村,1888,1038,850,20,1908,4928,0,38.72,21.06
彰化縣,花壇鄉,文德村,1134,568,566,14,1148,3092,0,37.13,18.37
彰化縣,花壇鄉,白沙村,1711,916,795,16,1727,4602,0,37.53,19.9
彰化縣,花壇鄉,岩竹村,516,220,296,7,523,1340,0,39.03,16.42
彰化縣,花壇鄉,橋頭村,1154,627,527,13,1167,3298,0,35.39,19.01
彰化縣,花壇鄉,灣雅村,308,182,126,4,312,890,0,35.06,20.45
彰化縣,花壇鄉,灣東村,336,160,176,6,342,932,0,36.7,17.17
彰化縣,花壇鄉,三春村,661,361,300,9,670,1906,0,35.15,18.94
彰化縣,花壇鄉,永春村,578,319,259,5,583,1888,0,30.88,16.9
彰化縣,花壇鄉,長春村,492,281,211,8,500,1605,0,31.15,17.51
彰化縣,花壇鄉,合計,14490,7510,6980,168,14658,38651,45018,37.92,19.43
彰化縣,芬園鄉,舊社村,586,286,300,10,596,1743,0,34.19,16.41
彰化縣,芬園鄉,大埔村,473,233,240,3,476,1387,0,34.32,16.8
彰化縣,芬園鄉,竹林村,677,338,339,7,684,1754,0,39.0,19.27
彰化縣,芬園鄉,社口村,859,411,448,12,871,2452,0,35.52,16.76
彰化縣,芬園鄉,茄荖村,890,379,511,12,902,2344,0,38.48,16.17
彰化縣,芬園鄉,嘉興村,651,356,295,16,667,1622,0,41.12,21.95
彰化縣,芬園鄉,芬園村,302,135,167,2,304,877,0,34.66,15.39
彰化縣,芬園鄉,縣庄村,413,166,247,4,417,1142,0,36.51,14.54
彰化縣,芬園鄉,圳墘村,217,94,123,6,223,647,0,34.47,14.53
彰化縣,芬園鄉,溪頭村,627,273,354,9,636,1646,0,38.64,16.59
彰化縣,芬園鄉,進芬村,348,184,164,1,349,965,0,36.17,19.07
彰化縣,芬園鄉,同安村,383,150,233,6,389,1139,0,34.15,13.17
彰化縣,芬園鄉,中崙村,258,91,167,5,263,854,0,30.8,10.66
彰化縣,芬園鄉,大竹村,327,124,203,2,329,966,0,34.06,12.84
彰化縣,芬園鄉,楓坑村,202,110,92,4,206,576,0,35.76,19.1
彰化縣,芬園鄉,合計,7213,3330,3883,99,7312,20114,22927,36.35,16.56
彰化縣,員林市,東和里,408,229,179,6,414,1051,0,39.39,21.79
彰化縣,員林市,民生里,1080,559,521,9,1089,2683,0,40.59,20.83
彰化縣,員林市,中正里,1306,694,612,10,1316,3068,0,42.89,22.62
彰化縣,員林市,仁美里,1098,558,540,9,1107,2540,0,43.58,21.97
彰化縣,員林市,新興里,334,150,184,5,339,695,0,48.78,21.58
彰化縣,員林市,和平里,1099,570,529,14,1113,2785,0,39.96,20.47
彰化縣,員林市,光明里,349,171,178,2,351,754,0,46.55,22.68
彰化縣,員林市,中山里,287,150,137,1,288,571,0,50.44,26.27
彰化縣,員林市,黎明里,681,341,340,8,689,1808,0,38.11,18.86
彰化縣,員林市,惠來里,2269,1094,1175,22,2291,5571,0,41.12,19.64
彰化縣,員林市,三義里,953,442,511,9,962,2460,0,39.11,17.97
彰化縣,員林市,新生里,1744,856,888,16,1760,4122,0,42.7,20.77
彰化縣,員林市,南平里,2122,1066,1056,14,2136,5313,0,40.2,20.06
彰化縣,員林市,南興里,1825,967,858,17,1842,4646,0,39.65,20.81
彰化縣,員林市,源潭里,574,307,267,4,578,1675,0,34.51,18.33
彰化縣,員林市,大埔里,740,381,359,11,751,2088,0,35.97,18.25
彰化縣,員林市,三條里,1060,524,536,9,1069,2693,0,39.7,19.46
彰化縣,員林市,三和里,2373,1256,1117,15,2388,6107,0,39.1,20.57
彰化縣,員林市,三橋里,1186,621,565,13,1199,2880,0,41.63,21.56
彰化縣,員林市,中央里,688,324,364,12,700,1929,0,36.29,16.8
彰化縣,員林市,溝皂里,1054,508,546,13,1067,2485,0,42.94,20.44
彰化縣,員林市,大饒里,1377,694,683,10,1387,3290,0,42.16,21.09
彰化縣,員林市,大明里,891,386,505,11,902,2363,0,38.17,16.34
彰化縣,員林市,萬年里,1522,827,695,17,1539,3631,0,42.39,22.78
彰化縣,員林市,崙雅里,874,485,389,10,884,2304,0,38.37,21.05
彰化縣,員林市,振興里,1021,570,451,6,1027,2698,0,38.07,21.13
彰化縣,員林市,林厝里,963,458,505,21,984,2788,0,35.29,16.43
彰化縣,員林市,出水里,582,226,356,7,589,1640,0,35.91,13.78
彰化縣,員林市,湖水里,431,158,273,4,435,1187,0,36.65,13.31
彰化縣,員林市,大峯里,277,166,111,4,281,713,0,39.41,23.28
彰化縣,員林市,鎮興里,711,352,359,9,720,1974,0,36.47,17.83
彰化縣,員林市,浮圳里,770,380,390,10,780,2175,0,35.86,17.47
彰化縣,員林市,西東里,712,296,416,11,723,1938,0,37.31,15.27
彰化縣,員林市,南東里,609,282,327,5,614,1738,0,35.33,16.23
彰化縣,員林市,中東里,607,317,290,6,613,1748,0,35.07,18.14
彰化縣,員林市,東北里,834,403,431,9,843,2262,0,37.27,17.82
彰化縣,員林市,三愛里,1239,652,587,13,1252,2953,0,42.4,22.08
彰化縣,員林市,三信里,991,549,442,3,994,2262,0,43.94,24.27
彰化縣,員林市,三多里,1106,553,553,9,1115,2449,0,45.53,22.58
彰化縣,員林市,仁愛里,563,288,275,3,566,1328,0,42.62,21.69
彰化縣,員林市,忠孝里,818,440,378,8,826,2178,0,37.92,20.2
彰化縣,員林市,合計,40128,20250,19878,395,40523,101543,123460,39.91,19.94
彰化縣,溪湖鎮,光平里,491,229,262,2,493,1156,0,42.65,19.81
彰化縣,溪湖鎮,平和里,294,153,141,2,296,623,0,47.51,24.56
彰化縣,溪湖鎮,太平里,641,354,287,5,646,1780,0,36.29,19.89
彰化縣,溪湖鎮,光華里,177,110,67,1,178,420,0,42.38,26.19
彰化縣,溪湖鎮,東寮里,1192,643,549,7,1199,3356,0,35.73,19.16
彰化縣,溪湖鎮,西寮里,845,471,374,8,853,2176,0,39.2,21.65
彰化縣,溪湖鎮,大突里,1180,668,512,6,1186,3446,0,34.42,19.38
彰化縣,溪湖鎮,北勢里,449,206,243,5,454,1421,0,31.95,14.5
彰化縣,溪湖鎮,汴頭里,994,475,519,12,1006,3018,0,33.33,15.74
彰化縣,溪湖鎮,大竹里,903,489,414,12,915,2433,0,37.61,20.1
彰化縣,溪湖鎮,湖西里,828,440,388,5,833,2297,0,36.26,19.16
彰化縣,溪湖鎮,田中里,286,115,171,4,290,814,0,35.63,14.13
彰化縣,溪湖鎮,河東里,606,307,299,6,612,1829,0,33.46,16.79
彰化縣,溪湖鎮,中山里,757,407,350,7,764,2278,0,33.54,17.87
彰化縣,溪湖鎮,中竹里,299,133,166,1,300,817,0,36.72,16.28
彰化縣,溪湖鎮,東溪里,454,181,273,6,460,1353,0,34.0,13.38
彰化縣,溪湖鎮,西溪里,702,347,355,6,708,1836,0,38.56,18.9
彰化縣,溪湖鎮,湖東里,1596,801,795,21,1617,4595,0,35.19,17.43
彰化縣,溪湖鎮,頂庄里,207,113,94,0,207,641,0,32.29,17.63
彰化縣,溪湖鎮,忠覺里,475,257,218,3,478,1250,0,38.24,20.56
彰化縣,溪湖鎮,湳底里,235,109,126,5,240,694,0,34.58,15.71
彰化縣,溪湖鎮,大庭里,445,247,198,4,449,1362,0,32.97,18.14
彰化縣,溪湖鎮,媽厝里,385,151,234,5,390,1250,0,31.2,12.08
彰化縣,溪湖鎮,西勢里,708,316,392,6,714,2168,0,32.93,14.58
彰化縣,溪湖鎮,番婆里,565,269,296,5,570,1713,0,33.27,15.7
彰化縣,溪湖鎮,合計,15714,7991,7723,144,15858,44726,54577,35.46,17.87
彰化縣,田中鎮,香山里,268,125,143,2,270,816,0,33.09,15.32
彰化縣,田中鎮,碧峰里,368,213,155,3,371,1037,0,35.78,20.54
彰化縣,田中鎮,東源里,280,148,132,2,282,748,0,37.7,19.79
彰化縣,田中鎮,復興里,531,295,236,10,541,1496,0,36.16,19.72
彰化縣,田中鎮,平和里,516,301,215,14,530,1448,0,36.6,20.79
彰化縣,田中鎮,頂潭里,459,216,243,11,470,1226,0,38.34,17.62
彰化縣,田中鎮,中潭里,644,290,354,4,648,1756,0,36.9,16.51
彰化縣,田中鎮,龍潭里,254,102,152,2,256,580,0,44.14,17.59
彰化縣,田中鎮,北路里,1303,695,608,14,1317,3269,0,40.29,21.26
彰化縣,田中鎮,西路里,931,441,490,5,936,2363,0,39.61,18.66
彰化縣,田中鎮,東路里,402,188,214,4,406,1041,0,39.0,18.06
彰化縣,田中鎮,南路里,449,210,239,5,454,1106,0,41.05,18.99
彰化縣,田中鎮,中路里,806,418,388,7,813,1942,0,41.86,21.52
彰化縣,田中鎮,新庄里,939,502,437,4,943,2399,0,39.31,20.93
彰化縣,田中鎮,三安里,570,216,354,6,576,1560,0,36.92,13.85
彰化縣,田中鎮,大崙里,443,211,232,5,448,1292,0,34.67,16.33
彰化縣,田中鎮,沙崙里,631,297,334,12,643,1814,0,35.45,16.37
彰化縣,田中鎮,新民里,1524,788,736,20,1544,4178,0,36.96,18.86
彰化縣,田中鎮,梅州里,436,194,242,7,443,1271,0,34.85,15.26
彰化縣,田中鎮,三民里,514,271,243,4,518,1561,0,33.18,17.36
彰化縣,田中鎮,三光里,326,149,177,3,329,913,0,36.04,16.32
彰化縣,田中鎮,大社里,325,135,190,6,331,866,0,38.22,15.59
彰化縣,田中鎮,合計,12919,6405,6514,150,13069,34682,40379,37.68,18.47
彰化縣,大村鄉,大村村,1256,646,610,14,1270,3428,0,37.05,18.84
彰化縣,大村鄉,茄苳村,582,267,315,2,584,1546,0,37.77,17.27
彰化縣,大村鄉,南勢村,521,244,277,7,528,1493,0,35.37,16.34
彰化縣,大村鄉,田洋村,437,228,209,3,440,1209,0,36.39,18.86
彰化縣,大村鄉,新興村,382,165,217,6,388,1172,0,33.11,14.08
彰化縣,大村鄉,過溝村,1586,830,756,16,1602,4186,0,38.27,19.83
彰化縣,大村鄉,美港村,756,390,366,7,763,2092,0,36.47,18.64
彰化縣,大村鄉,平和村,862,419,443,11,873,2569,0,33.98,16.31
彰化縣,大村鄉,貢旗村,577,287,290,7,584,1569,0,37.22,18.29
彰化縣,大村鄉,加錫村,536,261,275,5,541,1528,0,35.41,17.08
彰化縣,大村鄉,村上村,543,282,261,3,546,1420,0,38.45,19.86
彰化縣,大村鄉,大橋村,699,382,317,8,707,2033,0,34.78,18.79
彰化縣,大村鄉,大崙村,551,252,299,13,564,1624,0,34.73,15.52
彰化縣,大村鄉,擺塘村,972,467,505,12,984,2635,0,37.34,17.72
彰化縣,大村鄉,黃厝村,786,362,424,9,795,2428,0,32.74,14.91
彰化縣,大村鄉,福興村,758,317,441,6,764,2179,0,35.06,14.55
彰化縣,大村鄉,合計,11804,5799,6005,129,11933,33111,39085,36.04,17.51
彰化縣,埔鹽鄉,埔鹽村,670,375,295,8,678,1664,0,40.75,22.54
彰化縣,埔鹽鄉,埔南村,545,279,266,8,553,1536,0,36.0,18.16
彰化縣,埔鹽鄉,廍子村,454,257,197,5,459,1251,0,36.69,20.54
彰化縣,埔鹽鄉,出水村,336,196,140,5,341,889,0,38.36,22.05
彰化縣,埔鹽鄉,南港村,607,329,278,5,612,1750,0,34.97,18.8
彰化縣,埔鹽鄉,打廉村,330,162,168,4,334,939,0,35.57,17.25
彰化縣,埔鹽鄉,豐澤村,446,222,224,11,457,1306,0,34.99,17.0
彰化縣,埔鹽鄉,崑崙村,383,198,185,4,387,1086,0,35.64,18.23
彰化縣,埔鹽鄉,角樹村,272,173,99,4,276,656,0,42.07,26.37
彰化縣,埔鹽鄉,瓦磘村,419,218,201,7,426,1199,0,35.53,18.18
彰化縣,埔鹽鄉,好修村,556,315,241,1,557,1781,0,31.27,17.69
彰化縣,埔鹽鄉,西湖村,641,364,277,5,646,2059,0,31.37,17.68
彰化縣,埔鹽鄉,大有村,395,202,193,5,400,1194,0,33.5,16.92
彰化縣,埔鹽鄉,新興村,183,119,64,5,188,456,0,41.23,26.1
彰化縣,埔鹽鄉,永平村,377,201,176,2,379,1101,0,34.42,18.26
彰化縣,埔鹽鄉,永樂村,309,168,141,7,316,848,0,37.26,19.81
彰化縣,埔鹽鄉,石埤村,394,193,201,5,399,1437,0,27.77,13.43
彰化縣,埔鹽鄉,天盛村,257,160,97,3,260,838,0,31.03,19.09
彰化縣,埔鹽鄉,太平村,471,275,196,11,482,1538,0,31.34,17.88
彰化縣,埔鹽鄉,新水村,507,346,161,7,514,1523,0,33.75,22.72
彰化縣,埔鹽鄉,三省村,447,238,209,9,456,1368,0,33.33,17.4
彰化縣,埔鹽鄉,南新村,448,287,161,3,451,1314,0,34.32,21.84
彰化縣,埔鹽鄉,合計,9447,5277,4170,124,9571,27733,31833,34.51,19.03
彰化縣,埔心鄉,東門村,1357,649,708,14,1371,3555,0,38.57,18.26
彰化縣,埔心鄉,埔心村,462,197,265,5,467,1250,0,37.36,15.76
彰化縣,埔心鄉,義民村,612,317,295,6,618,1556,0,39.72,20.37
彰化縣,埔心鄉,油車村,451,234,217,4,455,1258,0,36.17,18.6
彰化縣,埔心鄉,瓦北村,659,276,383,3,662,1740,0,38.05,15.86
彰化縣,埔心鄉,瓦中村,763,345,418,9,772,1976,0,39.07,17.46
彰化縣,埔心鄉,瓦南村,561,226,335,4,565,1422,0,39.73,15.89
彰化縣,埔心鄉,太平村,656,309,347,5,661,1976,0,33.45,15.64
彰化縣,埔心鄉,經口村,885,375,510,14,899,2348,0,38.29,15.97
彰化縣,埔心鄉,大華村,228,100,128,1,229,658,0,34.8,15.2
彰化縣,埔心鄉,仁里村,434,208,226,9,443,1265,0,35.02,16.44
彰化縣,埔心鄉,舊舘村,572,257,315,5,577,1491,0,38.7,17.24
彰化縣,埔心鄉,南舘村,362,158,204,8,370,1065,0,34.74,14.84
彰化縣,埔心鄉,新舘村,336,154,182,5,341,963,0,35.41,15.99
彰化縣,埔心鄉,羅厝村,430,155,275,4,434,1305,0,33.26,11.88
彰化縣,埔心鄉,芎蕉村,665,278,387,6,671,1842,0,36.43,15.09
彰化縣,埔心鄉,二重村,520,230,290,11,531,1436,0,36.98,16.02
彰化縣,埔心鄉,梧鳳村,314,148,166,8,322,893,0,36.06,16.57
彰化縣,埔心鄉,埤霞村,251,122,129,1,252,736,0,34.24,16.58
彰化縣,埔心鄉,埤脚村,320,181,139,9,329,916,0,35.92,19.76
彰化縣,埔心鄉,合計,10838,4919,5919,131,10969,29651,34223,36.99,16.59
彰化縣,永靖鄉,永東村,326,179,147,3,329,761,0,43.23,23.52
彰化縣,永靖鄉,永西村,607,279,328,0,607,1503,0,40.39,18.56
彰化縣,永靖鄉,永南村,730,372,358,8,738,1800,0,41.0,20.67
彰化縣,永靖鄉,永北村,775,381,394,14,789,2147,0,36.75,17.75
彰化縣,永靖鄉,港西村,659,300,359,9,668,1704,0,39.2,17.61
彰化縣,永靖鄉,五福村,533,272,261,7,540,1438,0,37.55,18.92
彰化縣,永靖鄉,湳港村,382,129,253,6,388,1059,0,36.64,12.18
彰化縣,永靖鄉,新莊村,355,207,148,6,361,1065,0,33.9,19.44
彰化縣,永靖鄉,瑚璉村,973,487,486,16,989,2670,0,37.04,18.24
彰化縣,永靖鄉,五汴村,560,204,356,11,571,1368,0,41.74,14.91
彰化縣,永靖鄉,浮圳村,363,175,188,2,365,1220,0,29.92,14.34
彰化縣,永靖鄉,光雲村,554,229,325,7,561,1624,0,34.54,14.1
彰化縣,永靖鄉,東寧村,665,309,356,10,675,1908,0,35.38,16.19
彰化縣,永靖鄉,永興村,609,313,296,7,616,1558,0,39.54,20.09
彰化縣,永靖鄉,崙子村,515,230,285,6,521,1400,0,37.21,16.43
彰化縣,永靖鄉,獨鰲村,259,130,129,3,262,825,0,31.76,15.76
彰化縣,永靖鄉,敦厚村,244,119,125,2,246,710,0,34.65,16.76
彰化縣,永靖鄉,崙美村,305,123,182,4,309,736,0,41.98,16.71
彰化縣,永靖鄉,同安村,253,117,136,3,256,654,0,39.14,17.89
彰化縣,永靖鄉,同仁村,311,150,161,4,315,847,0,37.19,17.71
彰化縣,永靖鄉,湳墘村,293,140,153,6,299,809,0,36.96,17.31
彰化縣,永靖鄉,四芳村,242,129,113,4,246,637,0,38.62,20.25
彰化縣,永靖鄉,福興村,357,195,162,2,359,1075,0,33.4,18.14
彰化縣,永靖鄉,竹子村,503,176,327,7,510,1290,0,39.53,13.64
彰化縣,永靖鄉,合計,11373,5345,6028,147,11520,30808,36061,37.39,17.35
彰化縣,社頭鄉,社頭村,1039,425,614,5,1044,2749,0,37.98,15.46
彰化縣,社頭鄉,東興村,502,244,258,9,511,1460,0,35.0,16.71
彰化縣,社頭鄉,山湖村,429,155,274,0,429,1121,0,38.27,13.83
彰化縣,社頭鄉,廣興村,1576,680,896,15,1591,4439,0,35.84,15.32
彰化縣,社頭鄉,廣福村,345,143,202,2,347,914,0,37.96,15.65
彰化縣,社頭鄉,朝興村,425,181,244,4,429,1096,0,39.14,16.51
彰化縣,社頭鄉,仁雅村,1048,519,529,4,1052,2717,0,38.72,19.1
彰化縣,社頭鄉,橋頭村,759,350,409,11,770,2068,0,37.23,16.92
彰化縣,社頭鄉,仁和村,234,127,107,4,238,754,0,31.56,16.84
彰化縣,社頭鄉,崙雅村,336,169,167,3,339,905,0,37.46,18.67
彰化縣,社頭鄉,湳底村,567,237,330,7,574,1712,0,33.53,13.84
彰化縣,社頭鄉,泰安村,296,155,141,8,304,968,0,31.4,16.01
彰化縣,社頭鄉,美雅村,459,218,241,5,464,1252,0,37.06,17.41
彰化縣,社頭鄉,新厝村,545,246,299,6,551,1401,0,39.33,17.56
彰化縣,社頭鄉,平和村,359,176,183,3,362,961,0,37.67,18.31
彰化縣,社頭鄉,里仁村,375,205,170,4,379,980,0,38.67,20.92
彰化縣,社頭鄉,張厝村,463,219,244,8,471,1204,0,39.12,18.19
彰化縣,社頭鄉,龍井村,271,103,168,1,272,806,0,33.75,12.78
彰化縣,社頭鄉,舊社村,624,276,348,10,634,1581,0,40.1,17.46
彰化縣,社頭鄉,埤斗村,341,139,202,2,343,977,0,35.11,14.23
彰化縣,社頭鄉,湳雅村,511,210,301,5,516,1487,0,34.7,14.12
彰化縣,社頭鄉,松竹村,381,160,221,3,384,1028,0,37.35,15.56
彰化縣,社頭鄉,清水村,420,227,193,5,425,1260,0,33.73,18.02
彰化縣,社頭鄉,協和村,743,310,433,5,748,2148,0,34.82,14.43
彰化縣,社頭鄉,合計,13048,5874,7174,129,13177,35988,42279,36.61,16.32
彰化縣,二水鄉,合和村,309,142,167,2,311,821,0,37.88,17.3
彰化縣,二水鄉,上豊村,368,151,217,10,378,916,0,41.27,16.48
彰化縣,二水鄉,過圳村,239,116,123,2,241,610,0,39.51,19.02
彰化縣,二水鄉,五伯村,254,117,137,1,255,609,0,41.87,19.21
彰化縣,二水鄉,光化村,376,175,201,5,381,883,0,43.15,19.82
彰化縣,二水鄉,文化村,363,194,169,3,366,933,0,39.23,20.79
彰化縣,二水鄉,二水村,317,146,171,6,323,776,0,41.62,18.81
彰化縣,二水鄉,聖化村,195,125,70,5,200,438,0,45.66,28.54
彰化縣,二水鄉,裕民村,370,177,193,2,372,996,0,37.35,17.77
彰化縣,二水鄉,惠民村,336,142,194,4,340,801,0,42.45,17.73
彰化縣,二水鄉,大園村,266,100,166,1,267,776,0,34.41,12.89
彰化縣,二水鄉,修仁村,289,152,137,2,291,779,0,37.36,19.51
彰化縣,二水鄉,合興村,262,107,155,6,268,665,0,40.3,16.09
彰化縣,二水鄉,源泉村,233,113,120,6,239,597,0,40.03,18.93
彰化縣,二水鄉,倡和村,218,103,115,1,219,562,0,38.97,18.33
彰化縣,二水鄉,復興村,374,151,223,13,387,1000,0,38.7,15.1
彰化縣,二水鄉,十五村,267,115,152,4,271,665,0,40.75,17.29
彰化縣,二水鄉,合計,5036,2326,2710,73,5109,12827,14488,39.83,18.13
彰化縣,北斗鎮,光復里,681,333,348,5,686,1771,0,38.74,18.8
彰化縣,北斗鎮,新政里,302,156,146,2,304,770,0,39.48,20.26
彰化縣,北斗鎮,重慶里,224,86,138,3,227,535,0,42.43,16.07
彰化縣,北斗鎮,五權里,280,138,142,2,282,656,0,42.99,21.04
彰化縣,北斗鎮,七星里,522,218,304,2,524,1406,0,37.27,15.5
彰化縣,北斗鎮,居仁里,537,328,209,3,540,1257,0,42.96,26.09
彰化縣,北斗鎮,東光里,828,388,440,7,835,2278,0,36.65,17.03
彰化縣,北斗鎮,文昌里,1118,572,546,14,1132,3114,0,36.35,18.37
彰化縣,北斗鎮,中和里,410,202,208,5,415,1307,0,31.75,15.46
彰化縣,北斗鎮,西德里,1742,847,895,16,1758,4588,0,38.32,18.46
彰化縣,北斗鎮,西安里,552,293,259,4,556,1694,0,32.82,17.3
彰化縣,北斗鎮,中寮里,950,407,543,8,958,2702,0,35.46,15.06
彰化縣,北斗鎮,大道里,704,294,410,4,708,1904,0,37.18,15.44
彰化縣,北斗鎮,新生里,591,303,288,7,598,2028,0,29.49,14.94
彰化縣,北斗鎮,大新里,591,330,261,6,597,1791,0,33.33,18.43
彰化縣,北斗鎮,合計,10032,4895,5137,88,10120,27801,33351,36.4,17.61
彰化縣,二林鎮,東和里,676,331,345,7,683,2094,0,32.62,15.81
彰化縣,二林鎮,南光里,1113,650,463,14,1127,3227,0,34.92,20.14
彰化縣,二林鎮,西平里,488,254,234,2,490,1498,0,32.71,16.96
彰化縣,二林鎮,北平里,947,457,490,21,968,2966,0,32.64,15.41
彰化縣,二林鎮,中西里,438,269,169,14,452,1610,0,28.07,16.71
彰化縣,二林鎮,廣興里,387,212,175,6,393,1341,0,29.31,15.81
彰化縣,二林鎮,香田里,297,132,165,5,302,1010,0,29.9,13.07
彰化縣,二林鎮,外竹里,271,145,126,4,275,976,0,28.18,14.86
彰化縣,二林鎮,興華里,389,232,157,8,397,1145,0,34.67,20.26
彰化縣,二林鎮,東興里,517,285,232,10,527,1598,0,32.98,17.83
彰化縣,二林鎮,後厝里,1119,647,472,17,1136,3312,0,34.3,19.54
彰化縣,二林鎮,豐田里,741,396,345,7,748,2497,0,29.96,15.86
彰化縣,二林鎮,頂厝里,357,203,154,15,372,1309,0,28.42,15.51
彰化縣,二林鎮,趙甲里,463,262,201,18,481,1557,0,30.89,16.83
彰化縣,二林鎮,振興里,330,175,155,9,339,1180,0,28.73,14.83
彰化縣,二林鎮,萬興里,260,150,110,5,265,770,0,34.42,19.48
彰化縣,二林鎮,永興里,505,260,245,4,509,1485,0,34.28,17.51
彰化縣,二林鎮,西庄里,353,159,194,4,357,1259,0,28.36,12.63
彰化縣,二林鎮,梅芳里,333,177,156,7,340,1071,0,31.75,16.53
彰化縣,二林鎮,華崙里,1124,665,459,14,1138,3551,0,32.05,18.73
彰化縣,二林鎮,東勢里,295,153,142,8,303,958,0,31.63,15.97
彰化縣,二林鎮,萬合里,286,169,117,13,299,1107,0,27.01,15.27
彰化縣,二林鎮,大永里,246,118,128,4,250,886,0,28.22,13.32
彰化縣,二林鎮,原斗里,487,246,241,3,490,1220,0,40.16,20.16
彰化縣,二林鎮,西斗里,336,173,163,4,340,1041,0,32.66,16.62
彰化縣,二林鎮,東華里,361,147,214,6,367,967,0,37.95,15.2
彰化縣,二林鎮,復豐里,201,97,104,5,206,704,0,29.26,13.78
彰化縣,二林鎮,合計,13320,7164,6156,234,13554,42339,49337,32.01,16.92
彰化縣,田尾鄉,田尾村,493,237,256,7,500,1279,0,39.09,18.53
彰化縣,田尾鄉,豐田村,270,148,122,3,273,793,0,34.43,18.66
彰化縣,田尾鄉,饒平村,955,507,448,12,967,2570,0,37.63,19.73
彰化縣,田尾鄉,睦宜村,361,171,190,3,364,1054,0,34.54,16.22
彰化縣,田尾鄉,福田村,282,122,160,6,288,751,0,38.35,16.25
彰化縣,田尾鄉,新興村,420,192,228,2,422,1022,0,41.29,18.79
彰化縣,田尾鄉,北鎮村,370,185,185,5,375,1202,0,31.2,15.39
彰化縣,田尾鄉,南鎮村,227,95,132,0,227,613,0,37.03,15.5
彰化縣,田尾鄉,新生村,480,216,264,7,487,1329,0,36.64,16.25
彰化縣,田尾鄉,南曾村,453,194,259,11,464,1280,0,36.25,15.16
彰化縣,田尾鄉,北曾村,579,234,345,11,590,1535,0,38.44,15.24
彰化縣,田尾鄉,溪畔村,442,197,245,2,444,1216,0,36.51,16.2
彰化縣,田尾鄉,打簾村,673,295,378,5,678,1724,0,39.33,17.11
彰化縣,田尾鄉,柳鳳村,417,219,198,4,421,941,0,44.74,23.27
彰化縣,田尾鄉,陸豐村,298,137,161,5,303,870,0,34.83,15.75
彰化縣,田尾鄉,海豐村,456,209,247,2,458,1365,0,33.55,15.31
彰化縣,田尾鄉,仁里村,547,260,287,10,557,1594,0,34.94,16.31
彰化縣,田尾鄉,新厝村,93,49,44,1,94,258,0,36.43,18.99
彰化縣,田尾鄉,溪頂村,224,93,131,2,226,613,0,36.87,15.17
彰化縣,田尾鄉,正義村,338,165,173,8,346,875,0,39.54,18.86
彰化縣,田尾鄉,合計,8378,3925,4453,106,8484,22884,26569,37.07,17.15
彰化縣,埤頭鄉,和豊村,771,376,395,11,782,2433,0,32.14,15.45
彰化縣,埤頭鄉,興農村,577,273,304,7,584,1785,0,32.72,15.29
彰化縣,埤頭鄉,埤頭村,575,227,348,9,584,1565,0,37.32,14.5
彰化縣,埤頭鄉,豊崙村,639,389,250,17,656,2256,0,29.08,17.24
彰化縣,埤頭鄉,崙子村,409,203,206,2,411,1230,0,33.41,16.5
彰化縣,埤頭鄉,永豊村,517,242,275,14,531,1561,0,34.02,15.5
彰化縣,埤頭鄉,合興村,1180,662,518,5,1185,3254,0,36.42,20.34
彰化縣,埤頭鄉,平原村,675,363,312,11,686,2210,0,31.04,16.43
彰化縣,埤頭鄉,崙腳村,236,101,135,4,240,710,0,33.8,14.23
彰化縣,埤頭鄉,元埔村,205,90,115,1,206,558,0,36.92,16.13
彰化縣,埤頭鄉,芙朝村,488,262,226,9,497,1486,0,33.45,17.63
彰化縣,埤頭鄉,新庄村,339,110,229,2,341,1021,0,33.4,10.77
彰化縣,埤頭鄉,陸嘉村,247,100,147,3,250,807,0,30.98,12.39
彰化縣,埤頭鄉,竹圍村,355,125,230,5,360,1052,0,34.22,11.88
彰化縣,埤頭鄉,中和村,508,224,284,5,513,1457,0,35.21,15.37
彰化縣,埤頭鄉,庄內村,333,126,207,10,343,1056,0,32.48,11.93
彰化縣,埤頭鄉,大湖村,343,117,226,6,349,913,0,38.23,12.81
彰化縣,埤頭鄉,合計,8397,3990,4407,121,8518,25354,29860,33.6,15.74
彰化縣,芳苑鄉,芳苑村,248,90,158,9,257,928,0,27.69,9.7
彰化縣,芳苑鄉,芳中村,146,62,84,3,149,395,0,37.72,15.7
彰化縣,芳苑鄉,仁愛村,223,121,102,3,226,735,0,30.75,16.46
彰化縣,芳苑鄉,信義村,131,64,67,3,134,522,0,25.67,12.26
彰化縣,芳苑鄉,後寮村,229,122,107,5,234,949,0,24.66,12.86
彰化縣,芳苑鄉,三合村,671,309,362,10,681,2090,0,32.58,14.78
彰化縣,芳苑鄉,永興村,406,204,202,4,410,1329,0,30.85,15.35
彰化縣,芳苑鄉,五俊村,102,51,51,2,104,475,0,21.89,10.74
彰化縣,芳苑鄉,路上村,176,95,81,5,181,630,0,28.73,15.08
彰化縣,芳苑鄉,路平村,218,133,85,3,221,785,0,28.15,16.94
彰化縣,芳苑鄉,三成村,227,111,116,6,233,973,0,23.95,11.41
彰化縣,芳苑鄉,福榮村,182,88,94,2,184,575,0,32.0,15.3
彰化縣,芳苑鄉,頂廍村,168,74,94,6,174,557,0,31.24,13.29
彰化縣,芳苑鄉,新街村,197,78,119,5,202,769,0,26.27,10.14
彰化縣,芳苑鄉,王功村,635,179,456,15,650,2116,0,30.72,8.46
彰化縣,芳苑鄉,博愛村,244,72,172,4,248,673,0,36.85,10.7
彰化縣,芳苑鄉,和平村,209,82,127,6,215,727,0,29.57,11.28
彰化縣,芳苑鄉,民生村,213,71,142,3,216,665,0,32.48,10.68
彰化縣,芳苑鄉,興仁村,371,117,254,8,379,1278,0,29.66,9.15
彰化縣,芳苑鄉,新寶村,489,189,300,6,495,1656,0,29.89,11.41
彰化縣,芳苑鄉,草湖村,447,225,222,3,450,1420,0,31.69,15.85
彰化縣,芳苑鄉,文津村,234,112,122,3,237,1062,0,22.32,10.55
彰化縣,芳苑鄉,建平村,590,265,325,2,592,2059,0,28.75,12.87
彰化縣,芳苑鄉,崙腳村,215,120,95,7,222,762,0,29.13,15.75
彰化縣,芳苑鄉,新生村,332,146,186,7,339,1304,0,26.0,11.2
彰化縣,芳苑鄉,漢寶村,955,452,503,10,965,3159,0,30.55,14.31
彰化縣,芳苑鄉,合計,8258,3632,4626,140,8398,28593,32372,29.37,12.7
彰化縣,大城鄉,潭墘村,317,131,186,1,318,1065,0,29.86,12.3
彰化縣,大城鄉,上山村,313,190,123,8,321,1069,0,30.03,17.77
彰化縣,大城鄉,東城村,375,209,166,8,383,1296,0,29.55,16.13
彰化縣,大城鄉,西城村,224,127,97,2,226,798,0,28.32,15.91
彰化縣,大城鄉,大城村,334,196,138,7,341,929,0,36.71,21.1
彰化縣,大城鄉,菜寮村,225,143,82,6,231,1048,0,22.04,13.65
彰化縣,大城鄉,山腳村,314,170,144,4,318,1256,0,25.32,13.54
彰化縣,大城鄉,永和村,164,95,69,5,169,662,0,25.53,14.35
彰化縣,大城鄉,頂庄村,181,96,85,2,183,663,0,27.6,14.48
彰化縣,大城鄉,公館村,301,151,150,9,310,1045,0,29.67,14.45
彰化縣,大城鄉,臺西村,222,119,103,8,230,861,0,26.71,13.82
彰化縣,大城鄉,東港村,274,170,104,4,278,1164,0,23.88,14.6
彰化縣,大城鄉,西港村,236,151,85,8,244,867,0,28.14,17.42
彰化縣,大城鄉,豐美村,214,92,122,6,220,845,0,26.04,10.89
彰化縣,大城鄉,三豐村,109,63,46,6,115,626,0,18.37,10.06
彰化縣,大城鄉,合計,3803,2103,1700,84,3887,14194,15893,27.38,14.82
彰化縣,竹塘鄉,竹元村,382,205,177,8,390,1148,0,33.97,17.86
彰化縣,竹塘鄉,竹塘村,640,350,290,8,648,1936,0,33.47,18.08
彰化縣,竹塘鄉,小西村,230,114,116,7,237,699,0,33.91,16.31
彰化縣,竹塘鄉,民靖村,220,117,103,1,221,753,0,29.35,15.54
彰化縣,竹塘鄉,五庄村,464,170,294,7,471,1527,0,30.84,11.13
彰化縣,竹塘鄉,樹腳村,210,86,124,1,211,641,0,32.92,13.42
彰化縣,竹塘鄉,田頭村,326,150,176,2,328,1052,0,31.18,14.26
彰化縣,竹塘鄉,新廣村,350,134,216,2,352,1083,0,32.5,12.37
彰化縣,竹塘鄉,溪墘村,173,62,111,1,174,471,0,36.94,13.16
彰化縣,竹塘鄉,竹林村,237,107,130,1,238,785,0,30.32,13.63
彰化縣,竹塘鄉,土庫村,219,96,123,1,220,626,0,35.14,15.34
彰化縣,竹塘鄉,內新村,187,56,131,2,189,536,0,35.26,10.45
彰化縣,竹塘鄉,長安村,247,83,164,4,251,750,0,33.47,11.07
彰化縣,竹塘鄉,永安村,145,53,92,3,148,536,0,27.61,9.89
彰化縣,竹塘鄉,合計,4030,1783,2247,48,4078,12543,14669,32.51,14.22
彰化縣,溪州鄉,溪厝村,597,250,347,7,604,1828,0,33.04,13.68
彰化縣,溪州鄉,舊眉村,493,201,292,11,504,1430,0,35.24,14.06
彰化縣,溪州鄉,柑園村,299,153,146,3,302,1131,0,26.7,13.53
彰化縣,溪州鄉,水尾村,485,130,355,9,494,1499,0,32.96,8.67
彰化縣,溪州鄉,坑厝村,249,94,155,4,253,699,0,36.19,13.45
彰化縣,溪州鄉,圳寮村,462,191,271,7,469,1461,0,32.1,13.07
彰化縣,溪州鄉,潮洋村,251,111,140,3,254,813,0,31.24,13.65
彰化縣,溪州鄉,瓦厝村,361,125,236,3,364,839,0,43.38,14.9
彰化縣,溪州鄉,西畔村,572,223,349,13,585,1977,0,29.59,11.28
彰化縣,溪州鄉,張厝村,198,76,122,3,201,693,0,29.0,10.97
彰化縣,溪州鄉,溪州村,585,276,309,6,591,1516,0,38.98,18.21
彰化縣,溪州鄉,成功村,508,207,301,6,514,1799,0,28.57,11.51
彰化縣,溪州鄉,菜公村,252,98,154,5,257,831,0,30.93,11.79
彰化縣,溪州鄉,尾厝村,661,312,349,8,669,1827,0,36.62,17.08
彰化縣,溪州鄉,大庄村,550,187,363,9,559,1863,0,30.01,10.04
彰化縣,溪州鄉,三圳村,436,180,256,10,446,1255,0,35.54,14.34
彰化縣,溪州鄉,東州村,720,308,412,5,725,1915,0,37.86,16.08
彰化縣,溪州鄉,榮光村,282,158,124,5,287,850,0,33.76,18.59
彰化縣,溪州鄉,三條村,329,68,261,2,331,846,0,39.13,8.04
彰化縣,溪州鄉,合計,8290,3348,4942,119,8409,25072,28983,33.54,13.35
彰化縣,合計,合計,390184,190279,199905,4342,394526,1061571,1260388,37.16,17.92
南投縣,南投市,龍泉里,379,190,189,2,381,910,0,41.87,20.88
南投縣,南投市,康壽里,636,334,302,4,640,1370,0,46.72,24.38
南投縣,南投市,三民里,333,175,158,0,333,772,0,43.13,22.67
南投縣,南投市,仁和里,258,105,153,2,260,486,0,53.5,21.6
南投縣,南投市,南投里,260,123,137,3,263,574,0,45.82,21.43
南投縣,南投市,彰仁里,193,88,105,3,196,366,0,53.55,24.04
南投縣,南投市,崇文里,424,212,212,4,428,933,0,45.87,22.72
南投縣,南投市,漳興里,1091,546,545,6,1097,2566,0,42.75,21.28
南投縣,南投市,漳和里,2820,1566,1254,30,2850,7006,0,40.68,22.35
南投縣,南投市,軍功里,1703,934,769,22,1725,4577,0,37.69,20.41
南投縣,南投市,東山里,146,65,81,4,150,376,0,39.89,17.29
南投縣,南投市,平和里,2436,1350,1086,20,2456,6024,0,40.77,22.41
南投縣,南投市,振興里,851,374,477,10,861,2053,0,41.94,18.22
南投縣,南投市,千秋里,400,201,199,10,410,1008,0,40.67,19.94
南投縣,南投市,三興里,2210,1288,922,24,2234,5330,0,41.91,24.17
南投縣,南投市,三和里,1250,689,561,9,1259,2691,0,46.79,25.6
南投縣,南投市,嘉興里,796,335,461,3,799,2109,0,37.89,15.88
南投縣,南投市,嘉和里,1664,889,775,22,1686,4405,0,38.27,20.18
南投縣,南投市,福山里,675,366,309,9,684,1866,0,36.66,19.61
南投縣,南投市,永興里,253,124,129,8,261,779,0,33.5,15.92
南投縣,南投市,鳳鳴里,199,62,137,3,202,606,0,33.33,10.23
南投縣,南投市,鳳山里,340,109,231,5,345,1073,0,32.15,10.16
南投縣,南投市,平山里,2036,1097,939,16,2052,5387,0,38.09,20.36
南投縣,南投市,新興里,1780,974,806,15,1795,4997,0,35.92,19.49
南投縣,南投市,永豐里,1096,562,534,8,1104,2815,0,39.22,19.96
南投縣,南投市,福興里,1132,546,586,10,1142,3015,0,37.88,18.11
南投縣,南投市,營北里,3079,2134,945,24,3103,5877,0,52.8,36.31
南投縣,南投市,營南里,1072,617,455,12,1084,2381,0,45.53,25.91
南投縣,南投市,內興里,2958,1893,1065,25,2983,6642,0,44.91,28.5
南投縣,南投市,內新里,566,281,285,8,574,1402,0,40.94,20.04
南投縣,南投市,光華里,359,293,66,4,363,738,0,49.19,39.7
南投縣,南投市,光榮里,504,421,83,5,509,993,0,51.26,42.4
南投縣,南投市,光明里,468,399,69,2,470,908,0,51.76,43.94
南投縣,南投市,光輝里,287,189,98,3,290,514,0,56.42,36.77
南投縣,南投市,合計,34654,19531,15123,335,34989,83549,98736,41.88,23.38
南投縣,埔里鎮,東門里,1096,611,485,9,1105,2573,0,42.95,23.75
南投縣,埔里鎮,南門里,406,205,201,2,408,785,0,51.97,26.11
南投縣,埔里鎮,西門里,1102,604,498,6,1108,2927,0,37.85,20.64
南投縣,埔里鎮,北門里,832,515,317,6,838,2457,0,34.11,20.96
南投縣,埔里鎮,同聲里,808,477,331,9,817,2163,0,37.77,22.05
南投縣,埔里鎮,薰化里,474,272,202,1,475,997,0,47.64,27.28
南投縣,埔里鎮,清新里,1268,740,528,18,1286,3608,0,35.64,20.51
南投縣,埔里鎮,大城里,2128,1250,878,20,2148,5729,0,37.49,21.82
南投縣,埔里鎮,籃城里,402,178,224,2,404,931,0,43.39,19.12
南投縣,埔里鎮,枇杷里,2610,1587,1023,27,2637,7501,0,35.16,21.16
南投縣,埔里鎮,水頭里,1122,610,512,9,1131,3785,0,29.88,16.12
南投縣,埔里鎮,麒麟里,327,178,149,2,329,1019,0,32.29,17.47
南投縣,埔里鎮,珠格里,373,204,169,8,381,1106,0,34.45,18.44
南投縣,埔里鎮,溪南里,394,237,157,5,399,1116,0,35.75,21.24
南投縣,埔里鎮,桃米里,351,240,111,5,356,1007,0,35.35,23.83
南投縣,埔里鎮,成功里,111,62,49,0,111,298,0,37.25,20.81
南投縣,埔里鎮,南村里,411,237,174,4,415,1324,0,31.34,17.9
南投縣,埔里鎮,愛蘭里,491,297,194,5,496,1412,0,35.13,21.03
南投縣,埔里鎮,鐵山里,604,338,266,7,611,1701,0,35.92,19.87
南投縣,埔里鎮,房里里,454,265,189,5,459,1348,0,34.05,19.66
南投縣,埔里鎮,向善里,261,135,126,4,265,661,0,40.09,20.42
南投縣,埔里鎮,一新里,393,264,129,5,398,988,0,40.28,26.72
南投縣,埔里鎮,廣成里,362,212,150,4,366,1132,0,32.33,18.73
南投縣,埔里鎮,史港里,220,136,84,2,222,580,0,38.28,23.45
南投縣,埔里鎮,福興里,336,133,203,3,339,962,0,35.24,13.83
南投縣,埔里鎮,牛眠里,1012,507,505,7,1019,2818,0,36.16,17.99
南投縣,埔里鎮,大湳里,615,340,275,8,623,1661,0,37.51,20.47
南投縣,埔里鎮,蜈蚣里,866,473,393,9,875,2570,0,34.05,18.4
南投縣,埔里鎮,合成里,569,264,305,10,579,1597,0,36.26,16.53
南投縣,埔里鎮,北安里,1301,759,542,13,1314,3098,0,42.41,24.5
南投縣,埔里鎮,杷城里,986,541,445,28,1014,2585,0,39.23,20.93
南投縣,埔里鎮,北梅里,1119,675,444,12,1131,3170,0,35.68,21.29
南投縣,埔里鎮,泰安里,856,521,335,8,864,2070,0,41.74,25.17
南投縣,埔里鎮,合計,24660,14067,10593,263,24923,67679,78732,36.83,20.78
南投縣,草屯鎮,玉峰里,903,532,371,9,912,2084,0,43.76,25.53
南投縣,草屯鎮,炎峰里,923,490,433,5,928,2059,0,45.07,23.8
南投縣,草屯鎮,和平里,506,248,258,6,512,1084,0,47.23,22.88
南投縣,草屯鎮,敦和里,2489,1372,1117,25,2514,6414,0,39.2,21.39
南投縣,草屯鎮,山腳里,3341,2027,1314,26,3367,7515,0,44.8,26.97
南投縣,草屯鎮,富寮里,2532,1294,1238,21,2553,6652,0,38.38,19.45
南投縣,草屯鎮,御史里,2387,1223,1164,28,2415,6108,0,39.54,20.02
南投縣,草屯鎮,新豐里,1591,802,789,28,1619,4032,0,40.15,19.89
南投縣,草屯鎮,碧峰里,1676,844,832,17,1693,4524,0,37.42,18.66
南投縣,草屯鎮,碧洲里,1045,616,429,4,1049,2446,0,42.89,25.18
南投縣,草屯鎮,復興里,1212,641,571,10,1222,2862,0,42.7,22.4
南投縣,草屯鎮,上林里,1425,832,593,10,1435,3175,0,45.2,26.2
南投縣,草屯鎮,新庄里,1448,771,677,11,1459,3702,0,39.41,20.83
南投縣,草屯鎮,北投里,1184,519,665,15,1199,2951,0,40.63,17.59
南投縣,草屯鎮,石川里,582,291,291,4,586,1502,0,39.01,19.37
南投縣,草屯鎮,加老里,937,422,515,7,944,2217,0,42.58,19.03
南投縣,草屯鎮,北勢里,723,334,389,12,735,1858,0,39.56,17.98
南投縣,草屯鎮,中原里,898,357,541,6,904,2029,0,44.55,17.59
南投縣,草屯鎮,南埔里,1553,719,834,7,1560,4072,0,38.31,17.66
南投縣,草屯鎮,土城里,598,355,243,6,604,1658,0,36.43,21.41
南投縣,草屯鎮,坪頂里,397,207,190,2,399,1017,0,39.23,20.35
南投縣,草屯鎮,雙冬里,694,348,346,12,706,2247,0,31.42,15.49
南投縣,草屯鎮,平林里,407,227,180,4,411,1070,0,38.41,21.21
南投縣,草屯鎮,中正里,306,160,146,6,312,664,0,46.99,24.1
南投縣,草屯鎮,中山里,1098,527,571,6,1104,2330,0,47.38,22.62
南投縣,草屯鎮,明正里,1555,844,711,16,1571,3714,0,42.3,22.72
南投縣,草屯鎮,新厝里,1431,829,602,8,1439,3215,0,44.76,25.79
南投縣,草屯鎮,合計,33841,17831,16010,311,34152,83201,97262,41.05,21.43
南投縣,竹山鎮,竹山里,850,445,405,6,856,1957,0,43.74,22.74
南投縣,竹山鎮,中正里,232,118,114,1,233,614,0,37.95,19.22
南投縣,竹山鎮,中山里,1683,869,814,16,1699,4553,0,37.32,19.09
南投縣,竹山鎮,雲林里,1329,719,610,11,1340,3463,0,38.69,20.76
南投縣,竹山鎮,硘磘里,642,328,314,10,652,1752,0,37.21,18.72
南投縣,竹山鎮,下坪里,460,251,209,12,472,1189,0,39.7,21.11
南投縣,竹山鎮,桂林里,1268,642,626,18,1286,3652,0,35.21,17.58
南投縣,竹山鎮,中和里,325,107,218,4,329,894,0,36.8,11.97
南投縣,竹山鎮,中崎里,449,234,215,7,456,1401,0,32.55,16.7
南投縣,竹山鎮,德興里,335,192,143,4,339,878,0,38.61,21.87
南投縣,竹山鎮,延平里,951,429,522,18,969,2802,0,34.58,15.31
南投縣,竹山鎮,延正里,532,261,271,11,543,1678,0,32.36,15.55
南投縣,竹山鎮,延山里,316,153,163,4,320,839,0,38.14,18.24
南投縣,竹山鎮,延和里,1720,864,856,12,1732,4860,0,35.64,17.78
南投縣,竹山鎮,山崇里,593,276,317,8,601,1818,0,33.06,15.18
南投縣,竹山鎮,社寮里,467,226,241,11,478,1312,0,36.43,17.23
南投縣,竹山鎮,中央里,380,174,206,4,384,1132,0,33.92,15.37
南投縣,竹山鎮,富州里,232,124,108,3,235,595,0,39.5,20.84
南投縣,竹山鎮,大鞍里,132,78,54,0,132,422,0,31.28,18.48
南投縣,竹山鎮,田子里,180,95,85,3,183,577,0,31.72,16.46
南投縣,竹山鎮,福興里,216,130,86,7,223,591,0,37.73,22.0
南投縣,竹山鎮,鯉魚里,215,107,108,1,216,733,0,29.47,14.6
南投縣,竹山鎮,瑞竹里,179,86,93,1,180,562,0,32.03,15.3
南投縣,竹山鎮,坪頂里,162,83,79,0,162,446,0,36.32,18.61
南投縣,竹山鎮,桶頭里,223,101,122,10,233,865,0,26.94,11.68
南投縣,竹山鎮,秀林里,262,120,142,4,266,674,0,39.47,17.8
南投縣,竹山鎮,延祥里,1324,655,669,8,1332,3551,0,37.51,18.45
南投縣,竹山鎮,竹圍里,831,445,386,7,838,2248,0,37.28,19.8
南投縣,竹山鎮,合計,16488,8312,8176,201,16689,46058,53033,36.23,18.05
南投縣,集集鎮,集集里,448,270,178,5,453,1076,0,42.1,25.09
南投縣,集集鎮,和平里,328,181,147,8,336,872,0,38.53,20.76
南投縣,集集鎮,林尾里,197,98,99,2,199,549,0,36.25,17.85
南投縣,集集鎮,田寮里,384,191,193,8,392,1141,0,34.36,16.74
南投縣,集集鎮,隘寮里,163,73,90,1,164,463,0,35.42,15.77
南投縣,集集鎮,玉映里,174,99,75,0,174,472,0,36.86,20.97
南投縣,集集鎮,吳厝里,341,204,137,5,346,877,0,39.45,23.26
南投縣,集集鎮,八張里,519,281,238,6,525,1415,0,37.1,19.86
南投縣,集集鎮,永昌里,353,178,175,4,357,943,0,37.86,18.88
南投縣,集集鎮,富山里,191,105,86,3,194,544,0,35.66,19.3
南投縣,集集鎮,廣明里,292,178,114,5,297,889,0,33.41,20.02
南投縣,集集鎮,合計,3390,1858,1532,47,3437,9241,10350,37.19,20.11
南投縣,名間鄉,南雅村,421,211,210,2,423,1008,0,41.96,20.93
南投縣,名間鄉,中正村,1322,638,684,12,1334,3391,0,39.34,18.81
南投縣,名間鄉,中山村,770,390,380,5,775,2202,0,35.2,17.71
南投縣,名間鄉,濁水村,609,280,329,5,614,1540,0,39.87,18.18
南投縣,名間鄉,炭寮村,319,140,179,3,322,978,0,32.92,14.31
南投縣,名間鄉,新民村,369,154,215,9,378,957,0,39.5,16.09
南投縣,名間鄉,新街村,1587,715,872,22,1609,4169,0,38.59,17.15
南投縣,名間鄉,東湖村,590,271,319,12,602,1625,0,37.05,16.68
南投縣,名間鄉,萬丹村,368,147,221,4,372,922,0,40.35,15.94
南投縣,名間鄉,田仔村,437,175,262,2,439,1233,0,35.6,14.19
南投縣,名間鄉,大庄村,710,242,468,14,724,1828,0,39.61,13.24
南投縣,名間鄉,廍下村,309,110,199,1,310,900,0,34.44,12.22
南投縣,名間鄉,大坑村,249,94,155,2,251,729,0,34.43,12.89
南投縣,名間鄉,竹圍村,339,129,210,9,348,911,0,38.2,14.16
南投縣,名間鄉,赤水村,452,180,272,8,460,1160,0,39.66,15.52
南投縣,名間鄉,三崙村,535,230,305,4,539,1538,0,35.05,14.95
南投縣,名間鄉,松山村,567,239,328,9,576,1468,0,39.24,16.28
南投縣,名間鄉,松柏村,418,172,246,8,426,1137,0,37.47,15.13
南投縣,名間鄉,埔中村,324,150,174,4,328,845,0,38.82,17.75
南投縣,名間鄉,崁腳村,315,197,118,6,321,874,0,36.73,22.54
南投縣,名間鄉,新厝村,297,158,139,6,303,739,0,41.0,21.38
南投縣,名間鄉,新光村,610,280,330,8,618,1737,0,35.58,16.12
南投縣,名間鄉,仁和村,331,197,134,5,336,867,0,38.75,22.72
南投縣,名間鄉,合計,12248,5499,6749,160,12408,32758,37230,37.88,16.79
南投縣,鹿谷鄉,鹿谷村,657,350,307,6,663,1813,0,36.57,19.31
南投縣,鹿谷鄉,初鄉村,491,274,217,7,498,1402,0,35.52,19.54
南投縣,鹿谷鄉,彰雅村,464,287,177,6,470,1294,0,36.32,22.18
南投縣,鹿谷鄉,廣興村,687,395,292,7,694,1909,0,36.35,20.69
南投縣,鹿谷鄉,內湖村,329,184,145,7,336,997,0,33.7,18.46
南投縣,鹿谷鄉,竹林村,463,252,211,7,470,1463,0,32.13,17.22
南投縣,鹿谷鄉,竹豐村,328,201,127,5,333,902,0,36.92,22.28
南投縣,鹿谷鄉,和雅村,221,151,70,4,225,620,0,36.29,24.35
南投縣,鹿谷鄉,鳳凰村,463,216,247,3,466,1309,0,35.6,16.5
南投縣,鹿谷鄉,永隆村,544,304,240,8,552,1562,0,35.34,19.46
南投縣,鹿谷鄉,秀峰村,213,87,126,7,220,747,0,29.45,11.65
南投縣,鹿谷鄉,清水村,255,125,130,2,257,689,0,37.3,18.14
南投縣,鹿谷鄉,瑞田村,198,82,116,3,201,710,0,28.31,11.55
南投縣,鹿谷鄉,合計,5313,2908,2405,72,5385,15417,16983,34.93,18.86
南投縣,中寮鄉,廣興村,256,96,160,6,262,773,0,33.89,12.42
南投縣,中寮鄉,崁頂村,171,96,75,3,174,470,0,37.02,20.43
南投縣,中寮鄉,八仙村,267,136,131,3,270,773,0,34.93,17.59
南投縣,中寮鄉,和興村,196,101,95,3,199,639,0,31.14,15.81
南投縣,中寮鄉,福盛村,220,114,106,3,223,683,0,32.65,16.69
南投縣,中寮鄉,永平村,546,284,262,7,553,1678,0,32.96,16.92
南投縣,中寮鄉,復興村,103,55,48,1,104,287,0,36.24,19.16
南投縣,中寮鄉,中寮村,214,131,83,5,219,624,0,35.1,20.99
南投縣,中寮鄉,廣福村,151,56,95,2,153,491,0,31.16,11.41
南投縣,中寮鄉,永福村,420,248,172,5,425,1319,0,32.22,18.8
南投縣,中寮鄉,義和村,370,173,197,3,373,1049,0,35.56,16.49
南投縣,中寮鄉,清水村,240,115,125,10,250,847,0,29.52,13.58
南投縣,中寮鄉,龍安村,236,85,151,4,240,666,0,36.04,12.76
南投縣,中寮鄉,龍岩村,221,113,108,2,223,637,0,35.01,17.74
南投縣,中寮鄉,永和村,170,96,74,3,173,499,0,34.67,19.24
南投縣,中寮鄉,內城村,164,78,86,1,165,454,0,36.34,17.18
南投縣,中寮鄉,永芳村,150,74,76,5,155,454,0,34.14,16.3
南投縣,中寮鄉,爽文村,175,89,86,2,177,477,0,37.11,18.66
南投縣,中寮鄉,合計,4270,2140,2130,68,4338,12820,14137,33.84,16.69
南投縣,魚池鄉,東池村,546,292,254,4,550,1550,0,35.48,18.84
南投縣,魚池鄉,魚池村,663,345,318,7,670,1908,0,35.12,18.08
南投縣,魚池鄉,中明村,307,147,160,4,311,994,0,31.29,14.79
南投縣,魚池鄉,新城村,449,214,235,6,455,1333,0,34.13,16.05
南投縣,魚池鄉,大林村,339,144,195,10,349,1061,0,32.89,13.57
南投縣,魚池鄉,東光村,332,170,162,3,335,1242,0,26.97,13.69
南投縣,魚池鄉,共和村,154,63,91,1,155,501,0,30.94,12.57
南投縣,魚池鄉,大雁村,205,100,105,2,207,625,0,33.12,16.0
南投縣,魚池鄉,五城村,232,129,103,3,235,718,0,32.73,17.97
南投縣,魚池鄉,水社村,300,200,100,2,302,823,0,36.7,24.3
南投縣,魚池鄉,頭社村,253,125,128,8,261,917,0,28.46,13.63
南投縣,魚池鄉,武登村,186,115,71,5,191,574,0,33.28,20.03
南投縣,魚池鄉,日月村,307,171,136,4,311,849,0,36.63,20.14
南投縣,魚池鄉,新城村、共和村,189,98,91,3,192,541,0,35.49,18.11
南投縣,魚池鄉,合計,4462,2313,2149,62,4524,13636,15251,33.18,16.96
南投縣,國姓鄉,國姓村,547,282,265,15,562,1641,0,34.25,17.18
南投縣,國姓鄉,石門村,554,333,221,6,560,1676,0,33.41,19.87
南投縣,國姓鄉,大旗村,183,95,88,3,186,641,0,29.02,14.82
南投縣,國姓鄉,北港村,527,260,267,5,532,1823,0,29.18,14.26
南投縣,國姓鄉,長流村,367,227,140,8,375,1346,0,27.86,16.86
南投縣,國姓鄉,長福村,218,124,94,0,218,688,0,31.69,18.02
南投縣,國姓鄉,福龜村,608,340,268,7,615,1766,0,34.82,19.25
南投縣,國姓鄉,乾溝村,249,135,114,7,256,789,0,32.45,17.11
南投縣,國姓鄉,柑林村,370,231,139,2,372,1117,0,33.3,20.68
南投縣,國姓鄉,北山村,497,253,244,12,509,1459,0,34.89,17.34
南投縣,國姓鄉,南港村,474,298,176,12,486,1547,0,31.42,19.26
南投縣,國姓鄉,大石村,209,117,92,1,210,691,0,30.39,16.93
南投縣,國姓鄉,長豐村,183,123,60,2,185,730,0,25.34,16.85
南投縣,國姓鄉,合計,4986,2818,2168,80,5066,15914,17685,31.83,17.71
南投縣,水里鄉,水里村,221,127,94,0,221,726,0,30.44,17.49
南投縣,水里鄉,農富村,186,92,94,1,187,420,0,44.52,21.9
南投縣,水里鄉,新城村,449,230,219,5,454,1475,0,30.78,15.59
南投縣,水里鄉,中央村,233,145,88,3,236,596,0,39.6,24.33
南投縣,水里鄉,城中村,342,208,134,3,345,839,0,41.12,24.79
南投縣,水里鄉,北埔村,366,205,161,4,370,1004,0,36.85,20.42
南投縣,水里鄉,鉅工村,364,202,162,3,367,922,0,39.8,21.91
南投縣,水里鄉,永豐村,433,234,199,9,442,1346,0,32.84,17.38
南投縣,水里鄉,頂崁村,374,198,176,7,381,1172,0,32.51,16.89
南投縣,水里鄉,車埕村,164,104,60,5,169,436,0,38.76,23.85
南投縣,水里鄉,新興村,155,109,46,3,158,621,0,25.44,17.55
南投縣,水里鄉,新山村,73,43,30,0,73,203,0,35.96,21.18
南投縣,水里鄉,郡坑村,127,82,45,1,128,318,0,40.25,25.79
南投縣,水里鄉,上安村,344,211,133,6,350,1065,0,32.86,19.81
南投縣,水里鄉,民和村,247,115,132,6,253,841,0,30.08,13.67
南投縣,水里鄉,永興村,125,51,74,2,127,313,0,40.58,16.29
南投縣,水里鄉,玉峰村,252,148,104,2,254,813,0,31.24,18.2
南投縣,水里鄉,興隆村,95,53,42,2,97,278,0,34.89,19.06
南投縣,水里鄉,南光村,515,280,235,2,517,1527,0,33.86,18.34
南投縣,水里鄉,合計,5065,2837,2228,64,5129,14915,16810,34.39,19.02
南投縣,信義鄉,人和村,224,175,49,8,232,1166,0,19.9,15.01
南投縣,信義鄉,地利村,255,211,44,3,258,920,0,28.04,22.93
南投縣,信義鄉,潭南村,125,115,10,0,125,558,0,22.4,20.61
南投縣,信義鄉,明德村,503,345,158,6,509,1469,0,34.65,23.49
南投縣,信義鄉,愛國村,140,86,54,0,140,481,0,29.11,17.88
南投縣,信義鄉,自強村,209,102,107,5,214,713,0,30.01,14.31
南投縣,信義鄉,羅娜村,339,252,87,3,342,1338,0,25.56,18.83
南投縣,信義鄉,望美村,325,205,120,5,330,1516,0,21.77,13.52
南投縣,信義鄉,同富村,410,221,189,7,417,1399,0,29.81,15.8
南投縣,信義鄉,神木村,160,97,63,5,165,629,0,26.23,15.42
南投縣,信義鄉,東埔村,218,150,68,2,220,988,0,22.27,15.18
南投縣,信義鄉,雙龍村,78,56,22,1,79,610,0,12.95,9.18
南投縣,信義鄉,新鄉村,150,116,34,1,151,587,0,25.72,19.76
南投縣,信義鄉,豐丘村,157,85,72,2,159,628,0,25.32,13.54
南投縣,信義鄉,合計,3293,2216,1077,48,3341,13002,15798,25.7,17.04
南投縣,仁愛鄉,法治村,167,126,41,4,171,801,0,21.35,15.73
南投縣,仁愛鄉,中正村,212,184,28,4,216,907,0,23.81,20.29
南投縣,仁愛鄉,互助村,351,310,41,7,358,1143,0,31.32,27.12
南投縣,仁愛鄉,新生村,162,145,17,1,163,398,0,40.95,36.43
南投縣,仁愛鄉,力行村,96,79,17,4,100,504,0,19.84,15.67
南投縣,仁愛鄉,發祥村,140,113,27,3,143,749,0,19.09,15.09
南投縣,仁愛鄉,親愛村,249,207,42,1,250,1118,0,22.36,18.52
南投縣,仁愛鄉,大同村,543,414,129,5,548,1616,0,33.91,25.62
南投縣,仁愛鄉,南豐村,379,298,81,2,381,1223,0,31.15,24.37
南投縣,仁愛鄉,春陽村,240,198,42,3,243,955,0,25.45,20.73
南投縣,仁愛鄉,精英村,163,134,29,4,167,647,0,25.81,20.71
南投縣,仁愛鄉,萬豐村,110,90,20,1,111,633,0,17.54,14.22
南投縣,仁愛鄉,榮興村,22,22,0,0,22,55,0,40.0,40.0
南投縣,仁愛鄉,翠華村,106,77,29,2,108,507,0,21.3,15.19
南投縣,仁愛鄉,都達村,111,99,12,2,113,627,0,18.02,15.79
南投縣,仁愛鄉,德鹿谷村,93,77,16,0,93,614,0,15.15,12.54
南投縣,仁愛鄉,合計,3144,2573,571,43,3187,12497,15736,25.5,20.59
南投縣,合計,合計,155814,84903,70911,1754,157568,420687,487743,37.45,20.18
雲林縣,斗六市,忠孝里,629,330,299,6,635,1390,0,45.68,23.74
雲林縣,斗六市,仁愛里,478,210,268,3,481,1065,0,45.16,19.72
雲林縣,斗六市,信義里,307,140,167,2,309,609,0,50.74,22.99
雲林縣,斗六市,四維里,274,126,148,7,281,599,0,46.91,21.04
雲林縣,斗六市,太平里,337,179,158,4,341,756,0,45.11,23.68
雲林縣,斗六市,中和里,341,142,199,2,343,767,0,44.72,18.51
雲林縣,斗六市,光興里,311,151,160,3,314,707,0,44.41,21.36
雲林縣,斗六市,三平里,1988,1112,876,22,2010,4843,0,41.5,22.96
雲林縣,斗六市,八德里,1242,645,597,24,1266,3154,0,40.14,20.45
雲林縣,斗六市,鎮北里,1163,666,497,11,1174,2723,0,43.11,24.46
雲林縣,斗六市,龍潭里,772,402,370,7,779,1734,0,44.93,23.18
雲林縣,斗六市,鎮南里,1507,838,669,9,1516,3444,0,44.02,24.33
雲林縣,斗六市,林頭里,1575,838,737,9,1584,4187,0,37.83,20.01
雲林縣,斗六市,重光里,822,395,427,5,827,2303,0,35.91,17.15
雲林縣,斗六市,溝埧里,302,178,124,4,306,657,0,46.58,27.09
雲林縣,斗六市,江厝里,810,398,412,3,813,2185,0,37.21,18.22
雲林縣,斗六市,三光里,209,91,118,4,213,538,0,39.59,16.91
雲林縣,斗六市,崙峯里,986,600,386,7,993,2450,0,40.53,24.49
雲林縣,斗六市,嘉東里,569,277,292,10,579,1451,0,39.9,19.09
雲林縣,斗六市,久安里,979,532,447,12,991,2391,0,41.45,22.25
雲林縣,斗六市,長平里,729,333,396,13,742,1873,0,39.62,17.78
雲林縣,斗六市,保庄里,2272,1183,1089,15,2287,5409,0,42.28,21.87
雲林縣,斗六市,虎溪里,1240,605,635,13,1253,3399,0,36.86,17.8
雲林縣,斗六市,梅林里,714,328,386,14,728,1849,0,39.37,17.74
雲林縣,斗六市,湖山里,413,180,233,5,418,1112,0,37.59,16.19
雲林縣,斗六市,榴中里,1682,804,878,22,1704,4461,0,38.2,18.02
雲林縣,斗六市,榴北里,375,169,206,5,380,1076,0,35.32,15.71
雲林縣,斗六市,榴南里,688,334,354,10,698,2144,0,32.56,15.58
雲林縣,斗六市,溪洲里,1183,583,600,14,1197,3219,0,37.19,18.11
雲林縣,斗六市,長安里,1107,494,613,15,1122,3070,0,36.55,16.09
雲林縣,斗六市,十三里,423,141,282,8,431,1106,0,38.97,12.75
雲林縣,斗六市,鎮東里,1029,598,431,3,1032,2279,0,45.28,26.24
雲林縣,斗六市,鎮西里,1437,745,692,9,1446,3722,0,38.85,20.02
雲林縣,斗六市,公正里,1153,642,511,19,1172,2734,0,42.87,23.48
雲林縣,斗六市,社口里,960,525,435,10,970,2247,0,43.17,23.36
雲林縣,斗六市,公誠里,860,478,382,7,867,2111,0,41.07,22.64
雲林縣,斗六市,明德里,1481,757,724,16,1497,3620,0,41.35,20.91
雲林縣,斗六市,成功里,1185,612,573,6,1191,2596,0,45.88,23.57
雲林縣,斗六市,文化里,965,542,423,5,970,2294,0,42.28,23.63
雲林縣,斗六市,正心里,820,436,384,7,827,1970,0,41.98,22.13
雲林縣,斗六市,合計,36317,18739,17578,370,36687,90244,108508,40.65,20.76
雲林縣,斗南鎮,東仁里,504,235,269,9,513,1125,0,45.6,20.89
雲林縣,斗南鎮,西岐里,890,456,434,3,893,2068,0,43.18,22.05
雲林縣,斗南鎮,南昌里,817,361,456,9,826,2193,0,37.67,16.46
雲林縣,斗南鎮,北銘里,612,328,284,6,618,1430,0,43.22,22.94
雲林縣,斗南鎮,中天里,499,214,285,2,501,1217,0,41.17,17.58
雲林縣,斗南鎮,舊社里,1015,460,555,6,1021,2651,0,38.51,17.35
雲林縣,斗南鎮,林子里,504,212,292,5,509,1321,0,38.53,16.05
雲林縣,斗南鎮,石龜里,318,132,186,3,321,738,0,43.5,17.89
雲林縣,斗南鎮,靖興里,284,139,145,2,286,860,0,33.26,16.16
雲林縣,斗南鎮,新南里,259,111,148,7,266,705,0,37.73,15.74
雲林縣,斗南鎮,阿丹里,386,169,217,7,393,1113,0,35.31,15.18
雲林縣,斗南鎮,將軍里,623,257,366,7,630,1683,0,37.43,15.27
雲林縣,斗南鎮,東明里,382,162,220,7,389,970,0,40.1,16.7
雲林縣,斗南鎮,新光里,1048,415,633,16,1064,2768,0,38.44,14.99
雲林縣,斗南鎮,田頭里,797,355,442,6,803,2175,0,36.92,16.32
雲林縣,斗南鎮,明昌里,1286,631,655,15,1301,3315,0,39.25,19.03
雲林縣,斗南鎮,大東里,320,145,175,5,325,854,0,38.06,16.98
雲林縣,斗南鎮,埤麻里,306,162,144,4,310,792,0,39.14,20.45
雲林縣,斗南鎮,西伯里,308,165,143,4,312,823,0,37.91,20.05
雲林縣,斗南鎮,新崙里,521,225,296,9,530,1470,0,36.05,15.31
雲林縣,斗南鎮,小東里,560,181,379,9,569,1433,0,39.71,12.63
雲林縣,斗南鎮,石溪里,329,137,192,8,337,851,0,39.6,16.1
雲林縣,斗南鎮,大同里,1134,592,542,11,1145,2831,0,40.45,20.91
雲林縣,斗南鎮,僑真里,833,408,425,7,840,2236,0,37.57,18.25
雲林縣,斗南鎮,合計,14535,6652,7883,167,14702,37622,43841,39.08,17.68
雲林縣,虎尾鎮,中山里,364,180,184,4,368,914,0,40.26,19.69
雲林縣,虎尾鎮,新興里,645,324,321,5,650,1655,0,39.27,19.58
雲林縣,虎尾鎮,東仁里,1019,546,473,9,1028,2525,0,40.71,21.62
雲林縣,虎尾鎮,公安里,1182,623,559,9,1191,2771,0,42.98,22.48
雲林縣,虎尾鎮,德興里,940,534,406,10,950,2473,0,38.41,21.59
雲林縣,虎尾鎮,西安里,1189,651,538,11,1200,3168,0,37.88,20.55
雲林縣,虎尾鎮,安慶里,610,336,274,7,617,1361,0,45.33,24.69
雲林縣,虎尾鎮,平和里,1622,873,749,10,1632,4499,0,36.27,19.4
雲林縣,虎尾鎮,興南里,867,444,423,12,879,2323,0,37.84,19.11
雲林縣,虎尾鎮,新吉里,1443,693,750,15,1458,3807,0,38.3,18.2
雲林縣,虎尾鎮,穎川里,775,387,388,6,781,2017,0,38.72,19.19
雲林縣,虎尾鎮,延平里,418,210,208,4,422,1123,0,37.58,18.7
雲林縣,虎尾鎮,三合里,473,254,219,9,482,1313,0,36.71,19.35
雲林縣,虎尾鎮,北溪里,300,154,146,3,303,828,0,36.59,18.6
雲林縣,虎尾鎮,墾地里,579,242,337,9,588,1952,0,30.12,12.4
雲林縣,虎尾鎮,西屯里,505,208,297,3,508,1478,0,34.37,14.07
雲林縣,虎尾鎮,芳草里,262,75,187,1,263,872,0,30.16,8.6
雲林縣,虎尾鎮,埒內里,931,380,551,7,938,2607,0,35.98,14.58
雲林縣,虎尾鎮,堀頭里,296,165,131,5,301,844,0,35.66,19.55
雲林縣,虎尾鎮,安溪里,574,256,318,17,591,1767,0,33.45,14.49
雲林縣,虎尾鎮,興中里,586,281,305,8,594,1633,0,36.37,17.21
雲林縣,虎尾鎮,廉使里,1199,491,708,6,1205,3437,0,35.06,14.29
雲林縣,虎尾鎮,惠來里,758,325,433,15,773,2304,0,33.55,14.11
雲林縣,虎尾鎮,頂溪里,826,330,496,11,837,2528,0,33.11,13.05
雲林縣,虎尾鎮,中溪里,486,215,271,2,488,1339,0,36.45,16.06
雲林縣,虎尾鎮,下溪里,547,256,291,7,554,1501,0,36.91,17.06
雲林縣,虎尾鎮,建國里,165,99,66,4,169,515,0,32.82,19.22
雲林縣,虎尾鎮,立仁里,1395,793,602,5,1400,3651,0,38.35,21.72
雲林縣,虎尾鎮,東屯里,377,172,205,5,382,1211,0,31.54,14.2
雲林縣,虎尾鎮,合計,21333,10497,10836,219,21552,58416,70772,36.89,17.97
雲林縣,西螺鎮,振興里,533,173,360,5,538,1509,0,35.65,11.46
雲林縣,西螺鎮,大園里,654,276,378,8,662,1720,0,38.49,16.05
雲林縣,西螺鎮,廣福里,752,361,391,6,758,2061,0,36.78,17.52
雲林縣,西螺鎮,正興里,1108,507,601,9,1117,2893,0,38.61,17.53
雲林縣,西螺鎮,永安里,151,59,92,0,151,325,0,46.46,18.15
雲林縣,西螺鎮,中和里,233,91,142,3,236,549,0,42.99,16.58
雲林縣,西螺鎮,福興里,225,92,133,1,226,568,0,39.79,16.2
雲林縣,西螺鎮,光華里,372,162,210,7,379,1004,0,37.75,16.14
雲林縣,西螺鎮,中興里,1068,444,624,6,1074,2870,0,37.42,15.47
雲林縣,西螺鎮,漢光里,1591,599,992,18,1609,4547,0,35.39,13.17
雲林縣,西螺鎮,新安里,454,106,348,9,463,1277,0,36.26,8.3
雲林縣,西螺鎮,新豐里,524,135,389,9,533,1475,0,36.14,9.15
雲林縣,西螺鎮,詔安里,369,153,216,11,380,972,0,39.09,15.74
雲林縣,西螺鎮,河南里,342,124,218,6,348,1105,0,31.49,11.22
雲林縣,西螺鎮,安定里,549,172,377,8,557,1776,0,31.36,9.68
雲林縣,西螺鎮,福田里,502,137,365,12,514,1499,0,34.29,9.14
雲林縣,西螺鎮,大新里,564,182,382,4,568,1573,0,36.11,11.57
雲林縣,西螺鎮,埤頭里,319,88,231,8,327,872,0,37.5,10.09
雲林縣,西螺鎮,東興里,390,96,294,3,393,935,0,42.03,10.27
雲林縣,西螺鎮,廣興里,328,152,176,3,331,854,0,38.76,17.8
雲林縣,西螺鎮,鹿場里,529,154,375,3,532,1477,0,36.02,10.43
雲林縣,西螺鎮,頂湳里,382,119,263,7,389,963,0,40.39,12.36
雲林縣,西螺鎮,下湳里,242,140,102,4,246,809,0,30.41,17.31
雲林縣,西螺鎮,九隆里,278,87,191,2,280,727,0,38.51,11.97
雲林縣,西螺鎮,吳厝里,385,123,262,3,388,1287,0,30.15,9.56
雲林縣,西螺鎮,七座里,309,98,211,6,315,862,0,36.54,11.37
雲林縣,西螺鎮,公舘里,456,131,325,10,466,1346,0,34.62,9.73
雲林縣,西螺鎮,合計,13609,4961,8648,171,13780,37855,45246,36.4,13.11
雲林縣,土庫鎮,忠正里,316,139,177,4,320,765,0,41.83,18.17
雲林縣,土庫鎮,順天里,330,136,194,1,331,868,0,38.13,15.67
雲林縣,土庫鎮,宮北里,567,264,303,6,573,1345,0,42.6,19.63
雲林縣,土庫鎮,越港里,449,229,220,2,451,1052,0,42.87,21.77
雲林縣,土庫鎮,溪邊里,337,142,195,7,344,1083,0,31.76,13.11
雲林縣,土庫鎮,興新里,498,207,291,4,502,1401,0,35.83,14.78
雲林縣,土庫鎮,奮起里,401,170,231,9,410,1267,0,32.36,13.42
雲林縣,土庫鎮,埤腳里,418,178,240,7,425,1221,0,34.81,14.58
雲林縣,土庫鎮,大荖里,311,126,185,4,315,854,0,36.89,14.75
雲林縣,土庫鎮,石廟里,909,427,482,11,920,2844,0,32.35,15.01
雲林縣,土庫鎮,東平里,636,208,428,10,646,1845,0,35.01,11.27
雲林縣,土庫鎮,南平里,615,290,325,6,621,1750,0,35.49,16.57
雲林縣,土庫鎮,北平里,281,98,183,6,287,830,0,34.58,11.81
雲林縣,土庫鎮,西平里,573,225,348,9,582,1773,0,32.83,12.69
雲林縣,土庫鎮,後埔里,682,283,399,7,689,2272,0,30.33,12.46
雲林縣,土庫鎮,崙內里,437,182,255,9,446,1501,0,29.71,12.13
雲林縣,土庫鎮,新庄里,454,179,275,7,461,1425,0,32.35,12.56
雲林縣,土庫鎮,合計,8214,3483,4731,109,8323,24096,28137,34.54,14.45
雲林縣,北港鎮,東陽里,308,106,202,5,313,692,0,45.23,15.32
雲林縣,北港鎮,光民里,276,88,188,2,278,655,0,42.44,13.44
雲林縣,北港鎮,東華里,181,76,105,1,182,437,0,41.65,17.39
雲林縣,北港鎮,南安里,372,133,239,7,379,831,0,45.61,16.0
雲林縣,北港鎮,中和里,148,52,96,1,149,329,0,45.29,15.81
雲林縣,北港鎮,義民里,157,77,80,0,157,385,0,40.78,20.0
雲林縣,北港鎮,共榮里,152,45,107,2,154,355,0,43.38,12.68
雲林縣,北港鎮,西勢里,366,147,219,4,370,907,0,40.79,16.21
雲林縣,北港鎮,仁和里,200,75,125,2,202,469,0,43.07,15.99
雲林縣,北港鎮,賜福里,143,53,90,1,144,312,0,46.15,16.99
雲林縣,北港鎮,公舘里,205,79,126,1,206,525,0,39.24,15.05
雲林縣,北港鎮,大同里,437,168,269,3,440,1132,0,38.87,14.84
雲林縣,北港鎮,仁安里,203,90,113,4,207,425,0,48.71,21.18
雲林縣,北港鎮,華勝里,1910,776,1134,23,1933,4762,0,40.59,16.3
雲林縣,北港鎮,光復里,633,311,322,2,635,1679,0,37.82,18.52
雲林縣,北港鎮,新街里,2353,1059,1294,25,2378,6248,0,38.06,16.95
雲林縣,北港鎮,劉厝里,397,124,273,6,403,1122,0,35.92,11.05
雲林縣,北港鎮,府番里,232,108,124,3,235,794,0,29.6,13.6
雲林縣,北港鎮,草湖里,397,107,290,4,401,1344,0,29.84,7.96
雲林縣,北港鎮,溝皂里,383,119,264,5,388,1120,0,34.64,10.63
雲林縣,北港鎮,後溝里,338,111,227,5,343,969,0,35.4,11.46
雲林縣,北港鎮,番溝里,227,68,159,10,237,760,0,31.18,8.95
雲林縣,北港鎮,大北里,173,47,126,4,177,537,0,32.96,8.75
雲林縣,北港鎮,好收里,533,191,342,10,543,1571,0,34.56,12.16
雲林縣,北港鎮,樹腳里,1112,416,696,6,1118,2928,0,38.18,14.21
雲林縣,北港鎮,扶朝里,417,81,336,4,421,958,0,43.95,8.46
雲林縣,北港鎮,水埔里,150,48,102,3,153,470,0,32.55,10.21
雲林縣,北港鎮,新厝里,129,52,77,4,133,380,0,35.0,13.68
雲林縣,北港鎮,合計,12532,4807,7725,147,12679,33096,38748,38.31,14.52
雲林縣,古坑鄉,水碓村,432,190,242,4,436,1190,0,36.64,15.97
雲林縣,古坑鄉,田心村,418,228,190,3,421,1080,0,38.98,21.11
雲林縣,古坑鄉,高林村,399,162,237,5,404,1106,0,36.53,14.65
雲林縣,古坑鄉,荷苞村,491,232,259,7,498,1397,0,35.65,16.61
雲林縣,古坑鄉,東和村,1047,449,598,12,1059,3146,0,33.66,14.27
雲林縣,古坑鄉,新庄村,585,228,357,8,593,1472,0,40.29,15.49
雲林縣,古坑鄉,棋盤村,692,247,445,17,709,2048,0,34.62,12.06
雲林縣,古坑鄉,華山村,216,79,137,2,218,708,0,30.79,11.16
雲林縣,古坑鄉,華南村,105,30,75,0,105,278,0,37.77,10.79
雲林縣,古坑鄉,永光村,680,305,375,13,693,2109,0,32.86,14.46
雲林縣,古坑鄉,桂林村,342,99,243,2,344,1061,0,32.42,9.33
雲林縣,古坑鄉,崁腳村,358,179,179,8,366,1155,0,31.69,15.5
雲林縣,古坑鄉,樟湖村,105,50,55,0,105,429,0,24.48,11.66
雲林縣,古坑鄉,草嶺村,198,82,116,1,199,543,0,36.65,15.1
雲林縣,古坑鄉,永昌村,747,334,413,13,760,2065,0,36.8,16.17
雲林縣,古坑鄉,麻園村,324,117,207,11,335,761,0,44.02,15.37
雲林縣,古坑鄉,古坑村,776,390,386,12,788,2241,0,35.16,17.4
雲林縣,古坑鄉,朝陽村,762,387,375,14,776,2080,0,37.31,18.61
雲林縣,古坑鄉,西平村,580,258,322,4,584,1501,0,38.91,17.19
雲林縣,古坑鄉,湳仔村,247,116,131,4,251,672,0,37.35,17.26
雲林縣,古坑鄉,合計,9504,4162,5342,140,9644,27042,30632,35.66,15.39
雲林縣,大埤鄉,北和村,289,123,166,2,291,737,0,39.48,16.69
雲林縣,大埤鄉,南和村,807,317,490,10,817,2148,0,38.04,14.76
雲林縣,大埤鄉,大德村,351,155,196,4,355,959,0,37.02,16.16
雲林縣,大埤鄉,松竹村,320,83,237,10,330,908,0,36.34,9.14
雲林縣,大埤鄉,尚義村,661,260,401,15,676,1893,0,35.71,13.73
雲林縣,大埤鄉,嘉興村,675,296,379,7,682,1830,0,37.27,16.17
雲林縣,大埤鄉,豐田村,574,249,325,11,585,1532,0,38.19,16.25
雲林縣,大埤鄉,三結村,385,142,243,5,390,1179,0,33.08,12.04
雲林縣,大埤鄉,吉田村,238,83,155,5,243,716,0,33.94,11.59
雲林縣,大埤鄉,豐岡村,198,94,104,2,200,583,0,34.31,16.12
雲林縣,大埤鄉,聯美村,325,123,202,4,329,1045,0,31.48,11.77
雲林縣,大埤鄉,怡然村,275,124,151,1,276,743,0,37.15,16.69
雲林縣,大埤鄉,北鎮村,246,86,160,2,248,670,0,37.01,12.84
雲林縣,大埤鄉,興安村,236,84,152,3,239,669,0,35.72,12.56
雲林縣,大埤鄉,西鎮村,220,91,129,5,225,701,0,32.1,12.98
雲林縣,大埤鄉,合計,5800,2310,3490,86,5886,16313,18555,36.08,14.16
雲林縣,莿桐鄉,莿桐村,1671,665,1006,17,1688,4116,0,41.01,16.16
雲林縣,莿桐鄉,甘厝村,335,94,241,4,339,864,0,39.24,10.88
雲林縣,莿桐鄉,甘西村,591,168,423,5,596,1530,0,38.95,10.98
雲林縣,莿桐鄉,興桐村,500,198,302,7,507,1177,0,43.08,16.82
雲林縣,莿桐鄉,義和村,378,125,253,5,383,1068,0,35.86,11.7
雲林縣,莿桐鄉,埔子村,747,247,500,11,758,2015,0,37.62,12.26
雲林縣,莿桐鄉,大美村,1197,526,671,2,1199,3053,0,39.27,17.23
雲林縣,莿桐鄉,埔尾村,524,200,324,6,530,1250,0,42.4,16.0
雲林縣,莿桐鄉,饒平村,396,158,238,5,401,1135,0,35.33,13.92
雲林縣,莿桐鄉,興貴村,684,264,420,14,698,1882,0,37.09,14.03
雲林縣,莿桐鄉,四合村,627,271,356,8,635,1725,0,36.81,15.71
雲林縣,莿桐鄉,麻園村,497,199,298,11,508,1453,0,34.96,13.7
雲林縣,莿桐鄉,五華村,465,169,296,7,472,1313,0,35.95,12.87
雲林縣,莿桐鄉,六合村,678,219,459,10,688,1767,0,38.94,12.39
雲林縣,莿桐鄉,合計,9290,3503,5787,112,9402,24348,28143,38.62,14.39
雲林縣,林內鄉,林南村,359,177,182,5,364,1004,0,36.25,17.63
雲林縣,林內鄉,林中村,1290,599,691,23,1313,3548,0,37.01,16.88
雲林縣,林內鄉,林北村,758,314,444,15,773,2097,0,36.86,14.97
雲林縣,林內鄉,坪頂村,170,93,77,5,175,505,0,34.65,18.42
雲林縣,林內鄉,林茂村,288,151,137,4,292,802,0,36.41,18.83
雲林縣,林內鄉,九芎村,823,379,444,17,840,2594,0,32.38,14.61
雲林縣,林內鄉,湖本村,227,87,140,1,228,627,0,36.36,13.88
雲林縣,林內鄉,烏塗村,380,178,202,11,391,1115,0,35.07,15.96
雲林縣,林內鄉,烏麻村,343,192,151,6,349,1016,0,34.35,18.9
雲林縣,林內鄉,重興村,640,232,408,8,648,1798,0,36.04,12.9
雲林縣,林內鄉,合計,5278,2402,2876,95,5373,15106,17408,35.57,15.9
雲林縣,二崙鄉,崙東村,526,218,308,6,532,1442,0,36.89,15.12
雲林縣,二崙鄉,崙西村,626,272,354,7,633,1698,0,37.28,16.02
雲林縣,二崙鄉,來惠村,526,170,356,4,530,1596,0,33.21,10.65
雲林縣,二崙鄉,三和村,503,168,335,11,514,1474,0,34.87,11.4
雲林縣,二崙鄉,湳仔村,414,190,224,4,418,1126,0,37.12,16.87
雲林縣,二崙鄉,田尾村,647,238,409,4,651,1839,0,35.4,12.94
雲林縣,二崙鄉,定安村,301,108,193,6,307,861,0,35.66,12.54
雲林縣,二崙鄉,大華村,342,91,251,2,344,873,0,39.4,10.42
雲林縣,二崙鄉,義庄村,279,54,225,4,283,748,0,37.83,7.22
雲林縣,二崙鄉,楊賢村,456,111,345,7,463,1464,0,31.63,7.58
雲林縣,二崙鄉,港後村,614,181,433,11,625,1782,0,35.07,10.16
雲林縣,二崙鄉,大義村,272,78,194,4,276,821,0,33.62,9.5
雲林縣,二崙鄉,油車村,649,245,404,9,658,1719,0,38.28,14.25
雲林縣,二崙鄉,大庄村,407,127,280,8,415,1223,0,33.93,10.38
雲林縣,二崙鄉,庄西村,229,69,160,3,232,907,0,25.58,7.61
雲林縣,二崙鄉,大同村,278,84,194,5,283,824,0,34.34,10.19
雲林縣,二崙鄉,復興村,265,100,165,3,268,983,0,27.26,10.17
雲林縣,二崙鄉,永定村,559,168,391,5,564,1406,0,40.11,11.95
雲林縣,二崙鄉,合計,7893,2672,5221,103,7996,22786,25808,35.09,11.73
雲林縣,崙背鄉,東明村,422,174,248,2,424,1134,0,37.39,15.34
雲林縣,崙背鄉,西榮村,505,227,278,7,512,1437,0,35.63,15.8
雲林縣,崙背鄉,南陽村,833,381,452,3,836,2263,0,36.94,16.84
雲林縣,崙背鄉,崙前村,731,254,477,11,742,2078,0,35.71,12.22
雲林縣,崙背鄉,羅厝村,738,262,476,16,754,2042,0,36.92,12.83
雲林縣,崙背鄉,港尾村,420,123,297,8,428,1250,0,34.24,9.84
雲林縣,崙背鄉,阿勸村,588,265,323,10,598,2022,0,29.57,13.11
雲林縣,崙背鄉,五魁村,257,167,90,8,265,782,0,33.89,21.36
雲林縣,崙背鄉,大有村,433,184,249,12,445,1484,0,29.99,12.4
雲林縣,崙背鄉,豐榮村,499,183,316,9,508,1710,0,29.71,10.7
雲林縣,崙背鄉,草湖村,426,193,233,5,431,1413,0,30.5,13.66
雲林縣,崙背鄉,舊庄村,266,110,156,6,272,1102,0,24.68,9.98
雲林縣,崙背鄉,水尾村,440,115,325,8,448,1181,0,37.93,9.74
雲林縣,崙背鄉,枋南村,235,95,140,2,237,749,0,31.64,12.68
雲林縣,崙背鄉,合計,6793,2733,4060,107,6900,20647,23741,33.42,13.24
雲林縣,麥寮鄉,麥津村,1122,607,515,11,1133,4277,0,26.49,14.19
雲林縣,麥寮鄉,麥豐村,1936,1047,889,17,1953,7460,0,26.18,14.03
雲林縣,麥寮鄉,瓦磘村,513,206,307,10,523,1968,0,26.58,10.47
雲林縣,麥寮鄉,興華村,754,325,429,11,765,2867,0,26.68,11.34
雲林縣,麥寮鄉,崙後村,637,348,289,5,642,2721,0,23.59,12.79
雲林縣,麥寮鄉,後安村,659,384,275,9,668,3051,0,21.89,12.59
雲林縣,麥寮鄉,海豐村,509,264,245,5,514,2216,0,23.19,11.91
雲林縣,麥寮鄉,三盛村,517,236,281,5,522,2141,0,24.38,11.02
雲林縣,麥寮鄉,橋頭村,1007,474,533,14,1021,4026,0,25.36,11.77
雲林縣,麥寮鄉,新吉村,302,139,163,3,305,1156,0,26.38,12.02
雲林縣,麥寮鄉,施厝村,931,403,528,16,947,3617,0,26.18,11.14
雲林縣,麥寮鄉,雷厝村,544,273,271,12,556,2222,0,25.02,12.29
雲林縣,麥寮鄉,中興村,369,186,183,2,371,1548,0,23.97,12.02
雲林縣,麥寮鄉,合計,9800,4892,4908,120,9920,39270,48001,25.26,12.46
雲林縣,東勢鄉,東南村,557,299,258,8,565,1442,0,39.18,20.74
雲林縣,東勢鄉,東北村,383,188,195,5,388,1155,0,33.59,16.28
雲林縣,東勢鄉,嘉隆村,437,186,251,6,443,1536,0,28.84,12.11
雲林縣,東勢鄉,復興村,199,88,111,1,200,511,0,39.14,17.22
雲林縣,東勢鄉,月眉村,338,125,213,5,343,1160,0,29.57,10.78
雲林縣,東勢鄉,程海村,182,81,101,2,184,532,0,34.59,15.23
雲林縣,東勢鄉,龍潭村,263,77,186,8,271,778,0,34.83,9.9
雲林縣,東勢鄉,安南村,212,92,120,2,214,812,0,26.35,11.33
雲林縣,東勢鄉,昌南村,277,111,166,6,283,825,0,34.3,13.45
雲林縣,東勢鄉,同安村,552,264,288,15,567,1857,0,30.53,14.22
雲林縣,東勢鄉,新坤村,314,143,171,1,315,1015,0,31.03,14.09
雲林縣,東勢鄉,四美村,288,130,158,6,294,989,0,29.73,13.14
雲林縣,東勢鄉,合計,4002,1784,2218,65,4067,12612,13963,32.25,14.15
雲林縣,褒忠鄉,中民村,701,313,388,5,706,1848,0,38.2,16.94
雲林縣,褒忠鄉,埔姜村,525,244,281,5,530,1415,0,37.46,17.24
雲林縣,褒忠鄉,中勝村,518,216,302,6,524,1455,0,36.01,14.85
雲林縣,褒忠鄉,新湖村,437,165,272,8,445,1158,0,38.43,14.25
雲林縣,褒忠鄉,馬鳴村,503,191,312,12,515,1437,0,35.84,13.29
雲林縣,褒忠鄉,有才村,296,111,185,3,299,806,0,37.1,13.77
雲林縣,褒忠鄉,田洋村,281,127,154,1,282,774,0,36.43,16.41
雲林縣,褒忠鄉,龍岩村,390,189,201,4,394,1187,0,33.19,15.92
雲林縣,褒忠鄉,潮厝村,309,131,178,6,315,853,0,36.93,15.36
雲林縣,褒忠鄉,合計,3960,1687,2273,50,4010,10933,12368,36.68,15.43
雲林縣,臺西鄉,台西村,415,255,160,7,422,1177,0,35.85,21.67
雲林縣,臺西鄉,海北村,321,178,143,6,327,1060,0,30.85,16.79
雲林縣,臺西鄉,海南村,312,165,147,5,317,1093,0,29.0,15.1
雲林縣,臺西鄉,海口村,492,291,201,9,501,1980,0,25.3,14.7
雲林縣,臺西鄉,溪頂村,363,165,198,8,371,1449,0,25.6,11.39
雲林縣,臺西鄉,牛厝村,454,193,261,13,467,1828,0,25.55,10.56
雲林縣,臺西鄉,泉州村,158,74,84,2,160,592,0,27.03,12.5
雲林縣,臺西鄉,光華村,220,110,110,4,224,672,0,33.33,16.37
雲林縣,臺西鄉,五榔村,139,39,100,4,143,450,0,31.78,8.67
雲林縣,臺西鄉,山寮村,211,126,85,2,213,811,0,26.26,15.54
雲林縣,臺西鄉,富琦村,387,207,180,3,390,1466,0,26.6,14.12
雲林縣,臺西鄉,永豐村,368,194,174,5,373,1332,0,28.0,14.56
雲林縣,臺西鄉,和豐村,760,375,385,18,778,2935,0,26.51,12.78
雲林縣,臺西鄉,蚊港村,429,253,176,9,438,1741,0,25.16,14.53
雲林縣,臺西鄉,五港村,459,255,204,10,469,1781,0,26.33,14.32
雲林縣,臺西鄉,合計,5488,2880,2608,105,5593,20367,22792,27.46,14.14
雲林縣,元長鄉,長南村,1022,398,624,8,1030,3218,0,32.01,12.37
雲林縣,元長鄉,長北村,486,187,299,9,495,1454,0,34.04,12.86
雲林縣,元長鄉,子茂村,408,148,260,6,414,1308,0,31.65,11.31
雲林縣,元長鄉,後湖村,228,71,157,7,235,705,0,33.33,10.07
雲林縣,元長鄉,山內村,288,121,167,6,294,936,0,31.41,12.93
雲林縣,元長鄉,合和村,297,100,197,5,302,1030,0,29.32,9.71
雲林縣,元長鄉,五塊村,286,131,155,6,292,890,0,32.81,14.72
雲林縣,元長鄉,潭西村,259,68,191,7,266,715,0,37.2,9.51
雲林縣,元長鄉,潭東村,176,87,89,3,179,570,0,31.4,15.26
雲林縣,元長鄉,客厝村,221,110,111,1,222,836,0,26.56,13.16
雲林縣,元長鄉,卓運村,138,30,108,2,140,351,0,39.89,8.55
雲林縣,元長鄉,頂寮村,289,106,183,8,297,1112,0,26.71,9.53
雲林縣,元長鄉,下寮村,438,174,264,8,446,1457,0,30.61,11.94
雲林縣,元長鄉,龍岩村,317,77,240,0,317,958,0,33.09,8.04
雲林縣,元長鄉,西莊村,249,92,157,4,253,813,0,31.12,11.32
雲林縣,元長鄉,鹿北村,311,113,198,0,311,1127,0,27.6,10.03
雲林縣,元長鄉,鹿南村,265,106,159,3,268,816,0,32.84,12.99
雲林縣,元長鄉,瓦磘村,413,129,284,4,417,1472,0,28.33,8.76
雲林縣,元長鄉,內寮村,171,51,120,2,173,578,0,29.93,8.82
雲林縣,元長鄉,崙仔村,197,76,121,3,200,803,0,24.91,9.46
雲林縣,元長鄉,新吉村,227,95,132,1,228,686,0,33.24,13.85
雲林縣,元長鄉,合計,6686,2470,4216,93,6779,21835,24426,31.05,11.31
雲林縣,四湖鄉,四湖村,583,262,321,6,589,1728,0,34.09,15.16
雲林縣,四湖鄉,新庄村,184,67,117,2,186,626,0,29.71,10.7
雲林縣,四湖鄉,溪底村,257,104,153,2,259,902,0,28.71,11.53
雲林縣,四湖鄉,鹿場村,258,101,157,5,263,883,0,29.78,11.44
雲林縣,四湖鄉,湖西村,749,391,358,15,764,2201,0,34.71,17.76
雲林縣,四湖鄉,施湖村,291,140,151,3,294,1152,0,25.52,12.15
雲林縣,四湖鄉,湖寮村,184,74,110,7,191,712,0,26.83,10.39
雲林縣,四湖鄉,蔡厝村,211,92,119,2,213,828,0,25.72,11.11
雲林縣,四湖鄉,飛沙村,226,114,112,1,227,846,0,26.83,13.48
雲林縣,四湖鄉,三姓村,86,34,52,0,86,352,0,24.43,9.66
雲林縣,四湖鄉,內湖村,188,65,123,4,192,743,0,25.84,8.75
雲林縣,四湖鄉,羊調村,219,98,121,8,227,898,0,25.28,10.91
雲林縣,四湖鄉,崙北村,381,175,206,3,384,1669,0,23.01,10.49
雲林縣,四湖鄉,崙南村,179,87,92,1,180,782,0,23.02,11.13
雲林縣,四湖鄉,廣溝村,134,71,63,4,138,683,0,20.2,10.4
雲林縣,四湖鄉,萡子村,238,76,162,6,244,878,0,27.79,8.66
雲林縣,四湖鄉,林厝村,277,107,170,7,284,1016,0,27.95,10.53
雲林縣,四湖鄉,林東村,214,106,108,11,225,958,0,23.49,11.06
雲林縣,四湖鄉,溪尾村,164,85,79,5,169,724,0,23.34,11.74
雲林縣,四湖鄉,飛東村,157,55,102,3,160,533,0,30.02,10.32
雲林縣,四湖鄉,萡東村,270,55,215,5,275,1007,0,27.31,5.46
雲林縣,四湖鄉,合計,5450,2359,3091,100,5550,20121,22100,27.58,11.72
雲林縣,口湖鄉,湖東村,378,165,213,5,383,1198,0,31.97,13.77
雲林縣,口湖鄉,口湖村,350,156,194,5,355,1068,0,33.24,14.61
雲林縣,口湖鄉,頂湖村,167,75,92,0,167,614,0,27.2,12.21
雲林縣,口湖鄉,埔北村,262,80,182,3,265,851,0,31.14,9.4
雲林縣,口湖鄉,埔南村,252,83,169,6,258,694,0,37.18,11.96
雲林縣,口湖鄉,謝厝村,343,85,258,10,353,973,0,36.28,8.74
雲林縣,口湖鄉,蚵寮村,400,112,288,15,415,1405,0,29.54,7.97
雲林縣,口湖鄉,下崙村,548,180,368,6,554,2020,0,27.43,8.91
雲林縣,口湖鄉,崙中村,404,138,266,7,411,1473,0,27.9,9.37
雲林縣,口湖鄉,崙東村,396,157,239,8,404,1410,0,28.65,11.13
雲林縣,口湖鄉,青蚶村,139,38,101,5,144,511,0,28.18,7.44
雲林縣,口湖鄉,港東村,426,163,263,8,434,1493,0,29.07,10.92
雲林縣,口湖鄉,港西村,255,92,163,5,260,806,0,32.26,11.41
雲林縣,口湖鄉,台子村,637,101,536,9,646,1888,0,34.22,5.35
雲林縣,口湖鄉,成龍村,283,101,182,4,287,896,0,32.03,11.27
雲林縣,口湖鄉,湖口村,296,75,221,6,302,980,0,30.82,7.65
雲林縣,口湖鄉,水井村,324,122,202,13,337,925,0,36.43,13.19
雲林縣,口湖鄉,後厝村,228,82,146,4,232,686,0,33.82,11.95
雲林縣,口湖鄉,梧南村,663,204,459,5,668,1773,0,37.68,11.51
雲林縣,口湖鄉,梧北村,483,113,370,6,489,1154,0,42.37,9.79
雲林縣,口湖鄉,過港村,183,78,105,6,189,595,0,31.76,13.11
雲林縣,口湖鄉,合計,7417,2400,5017,136,7553,23413,26186,32.26,10.25
雲林縣,水林鄉,水北村,652,226,426,6,658,2131,0,30.88,10.61
雲林縣,水林鄉,水南村,721,244,477,9,730,1971,0,37.04,12.38
雲林縣,水林鄉,海埔村,354,86,268,7,361,969,0,37.25,8.88
雲林縣,水林鄉,土厝村,409,95,314,4,413,1149,0,35.94,8.27
雲林縣,水林鄉,春埔村,314,92,222,7,321,944,0,34.0,9.75
雲林縣,水林鄉,西井村,196,80,116,3,199,598,0,33.28,13.38
雲林縣,水林鄉,車港村,182,68,114,4,186,597,0,31.16,11.39
雲林縣,水林鄉,蘇秦村,298,81,217,5,303,943,0,32.13,8.59
雲林縣,水林鄉,灣東村,175,83,92,7,182,603,0,30.18,13.76
雲林縣,水林鄉,灣西村,288,106,182,3,291,905,0,32.15,11.71
雲林縣,水林鄉,萬興村,209,53,156,5,214,680,0,31.47,7.79
雲林縣,水林鄉,尖山村,202,47,155,2,204,627,0,32.54,7.5
雲林縣,水林鄉,大山村,360,99,261,7,367,1006,0,36.48,9.84
雲林縣,水林鄉,大溝村,338,101,237,9,347,967,0,35.88,10.44
雲林縣,水林鄉,順興村,264,79,185,7,271,803,0,33.75,9.84
雲林縣,水林鄉,蕃薯村,319,92,227,6,325,927,0,35.06,9.92
雲林縣,水林鄉,山腳村,244,66,178,7,251,776,0,32.35,8.51
雲林縣,水林鄉,松北村,280,111,169,11,291,989,0,29.42,11.22
雲林縣,水林鄉,松中村,188,47,141,1,189,484,0,39.05,9.71
雲林縣,水林鄉,松西村,193,41,152,7,200,647,0,30.91,6.34
雲林縣,水林鄉,瓊埔村,223,39,184,6,229,655,0,34.96,5.95
雲林縣,水林鄉,塭底村,188,40,148,5,193,653,0,29.56,6.13
雲林縣,水林鄉,後寮村,225,75,150,6,231,653,0,35.38,11.49
雲林縣,水林鄉,溪墘村,242,91,151,15,257,765,0,33.59,11.9
雲林縣,水林鄉,合計,7064,2142,4922,149,7213,21442,23934,33.64,9.99
雲林縣,合計,合計,200965,87535,113430,2644,203609,577564,673309,35.25,15.16
嘉義縣,太保市,太保里,869,409,460,12,881,2315,0,38.06,17.67
嘉義縣,太保市,後庄里,190,46,144,0,190,466,0,40.77,9.87
嘉義縣,太保市,前潭里,616,200,416,6,622,1453,0,42.81,13.76
嘉義縣,太保市,後潭里,725,282,443,11,736,1685,0,43.68,16.74
嘉義縣,太保市,梅埔里,474,189,285,7,481,1133,0,42.45,16.68
嘉義縣,太保市,春珠里,382,121,261,3,385,1105,0,34.84,10.95
嘉義縣,太保市,崙頂里,329,136,193,4,333,817,0,40.76,16.65
嘉義縣,太保市,東勢里,768,344,424,5,773,1799,0,42.97,19.12
嘉義縣,太保市,新埤里,489,152,337,8,497,1244,0,39.95,12.22
嘉義縣,太保市,舊埤里,910,341,569,6,916,2556,0,35.84,13.34
嘉義縣,太保市,田尾里,293,108,185,1,294,724,0,40.61,14.92
嘉義縣,太保市,港尾里,217,89,128,4,221,547,0,40.4,16.27
嘉義縣,太保市,過溝里,1394,489,905,11,1405,3489,0,40.27,14.02
嘉義縣,太保市,麻寮里,1680,624,1056,13,1693,4625,0,36.61,13.49
嘉義縣,太保市,南新里,712,219,493,4,716,1819,0,39.36,12.04
嘉義縣,太保市,北新里,1117,394,723,10,1127,3112,0,36.21,12.66
嘉義縣,太保市,埤鄉里,271,107,164,3,274,679,0,40.35,15.76
嘉義縣,太保市,安仁里,1042,504,538,5,1047,2639,0,39.67,19.1
嘉義縣,太保市,合計,12478,4754,7724,113,12591,32207,38651,39.09,14.76
嘉義縣,朴子市,安福里,721,356,365,6,727,1887,0,38.53,18.87
嘉義縣,朴子市,平和里,946,428,518,6,952,2322,0,41.0,18.43
嘉義縣,朴子市,內厝里,482,177,305,2,484,1092,0,44.32,16.21
嘉義縣,朴子市,開元里,178,63,115,1,179,377,0,47.48,16.71
嘉義縣,朴子市,順天里,262,109,153,1,263,610,0,43.11,17.87
嘉義縣,朴子市,中正里,293,131,162,5,298,618,0,48.22,21.2
嘉義縣,朴子市,博厚里,327,139,188,2,329,819,0,40.17,16.97
嘉義縣,朴子市,文化里,704,309,395,5,709,1676,0,42.3,18.44
嘉義縣,朴子市,永和里,934,318,616,9,943,2498,0,37.75,12.73
嘉義縣,朴子市,竹圍里,1732,758,974,15,1747,4243,0,41.17,17.86
嘉義縣,朴子市,新寮里,241,85,156,0,241,669,0,36.02,12.71
嘉義縣,朴子市,双溪里,187,65,122,5,192,608,0,31.58,10.69
嘉義縣,朴子市,溪口里,270,87,183,5,275,768,0,35.81,11.33
嘉義縣,朴子市,德興里,410,110,300,4,414,1015,0,40.79,10.84
嘉義縣,朴子市,仁和里,671,288,383,5,676,1769,0,38.21,16.28
嘉義縣,朴子市,大鄉里,1104,422,682,19,1123,3190,0,35.2,13.23
嘉義縣,朴子市,大葛里,1087,465,622,8,1095,2926,0,37.42,15.89
嘉義縣,朴子市,佳禾里,248,87,161,4,252,742,0,33.96,11.73
嘉義縣,朴子市,竹村里,412,160,252,4,416,1040,0,40.0,15.38
嘉義縣,朴子市,崁前里,323,103,220,11,334,870,0,38.39,11.84
嘉義縣,朴子市,順安里,110,38,72,5,115,246,0,46.75,15.45
嘉義縣,朴子市,崁後里,268,81,187,7,275,709,0,38.79,11.42
嘉義縣,朴子市,德家里,263,84,179,3,266,767,0,34.68,10.95
嘉義縣,朴子市,新庄里,269,122,147,4,273,678,0,40.27,17.99
嘉義縣,朴子市,梅華里,417,84,333,5,422,1019,0,41.41,8.24
嘉義縣,朴子市,松華里,425,99,326,4,429,1190,0,36.05,8.32
嘉義縣,朴子市,南竹里,195,33,162,4,199,486,0,40.95,6.79
嘉義縣,朴子市,合計,13479,5201,8278,149,13628,34834,41439,39.12,14.93
嘉義縣,布袋鎮,岱江里,231,112,119,3,234,593,0,39.46,18.89
嘉義縣,布袋鎮,九龍里,144,75,69,3,147,356,0,41.29,21.07
嘉義縣,布袋鎮,岑海里,791,353,438,11,802,2143,0,37.42,16.47
嘉義縣,布袋鎮,興中里,385,167,218,4,389,1064,0,36.56,15.7
嘉義縣,布袋鎮,光復里,679,309,370,11,690,1593,0,43.31,19.4
嘉義縣,布袋鎮,見龍里,301,106,195,1,302,860,0,35.12,12.33
嘉義縣,布袋鎮,新厝里,196,92,104,9,205,683,0,30.01,13.47
嘉義縣,布袋鎮,龍江里,229,99,130,3,232,742,0,31.27,13.34
嘉義縣,布袋鎮,新岑里,387,105,282,14,401,920,0,43.59,11.41
嘉義縣,布袋鎮,新民里,381,146,235,4,385,1287,0,29.91,11.34
嘉義縣,布袋鎮,復興里,758,281,477,7,765,2276,0,33.61,12.35
嘉義縣,布袋鎮,好美里,333,125,208,7,340,1106,0,30.74,11.3
嘉義縣,布袋鎮,永安里,363,168,195,6,369,1090,0,33.85,15.41
嘉義縣,布袋鎮,東港里,683,231,452,13,696,1861,0,37.4,12.41
嘉義縣,布袋鎮,江山里,106,45,61,0,106,281,0,37.72,16.01
嘉義縣,布袋鎮,菜舖里,139,57,82,4,143,385,0,37.14,14.81
嘉義縣,布袋鎮,考試里,127,45,82,0,127,288,0,44.1,15.63
嘉義縣,布袋鎮,振寮里,237,124,113,5,242,713,0,33.94,17.39
嘉義縣,布袋鎮,西安里,420,165,255,6,426,1117,0,38.14,14.77
嘉義縣,布袋鎮,東安里,540,168,372,6,546,1286,0,42.46,13.06
嘉義縣,布袋鎮,中安里,470,139,331,6,476,1350,0,35.26,10.3
嘉義縣,布袋鎮,樹林里,193,67,126,6,199,518,0,38.42,12.93
嘉義縣,布袋鎮,貴舍里,235,62,173,4,239,632,0,37.82,9.81
嘉義縣,布袋鎮,合計,8328,3241,5087,133,8461,23144,25692,36.56,14.0
嘉義縣,大林鎮,東林里,216,89,127,1,217,467,0,46.47,19.06
嘉義縣,大林鎮,西林里,813,344,469,5,818,1816,0,45.04,18.94
嘉義縣,大林鎮,吉林里,385,181,204,2,387,885,0,43.73,20.45
嘉義縣,大林鎮,平林里,2380,1081,1299,15,2395,5889,0,40.67,18.36
嘉義縣,大林鎮,明華里,477,169,308,9,486,1127,0,43.12,15.0
嘉義縣,大林鎮,明和里,657,297,360,8,665,1783,0,37.3,16.66
嘉義縣,大林鎮,排路里,268,68,200,1,269,595,0,45.21,11.43
嘉義縣,大林鎮,西結里,258,64,194,4,262,703,0,37.27,9.1
嘉義縣,大林鎮,湖北里,266,93,173,3,269,612,0,43.95,15.2
嘉義縣,大林鎮,大糖里,73,39,34,2,75,184,0,40.76,21.2
嘉義縣,大林鎮,大美里,552,243,309,5,557,1563,0,35.64,15.55
嘉義縣,大林鎮,過溪里,522,203,319,10,532,1405,0,37.86,14.45
嘉義縣,大林鎮,中坑里,528,204,324,6,534,1327,0,40.24,15.37
嘉義縣,大林鎮,上林里,316,131,185,7,323,793,0,40.73,16.52
嘉義縣,大林鎮,中林里,639,197,442,13,652,1546,0,42.17,12.74
嘉義縣,大林鎮,三和里,732,309,423,8,740,2009,0,36.83,15.38
嘉義縣,大林鎮,溝背里,346,122,224,4,350,905,0,38.67,13.48
嘉義縣,大林鎮,義和里,255,123,132,3,258,656,0,39.33,18.75
嘉義縣,大林鎮,內林里,272,128,144,5,277,644,0,43.01,19.88
嘉義縣,大林鎮,三角里,293,129,164,3,296,817,0,36.23,15.79
嘉義縣,大林鎮,三村里,340,130,210,4,344,820,0,41.95,15.85
嘉義縣,大林鎮,合計,10588,4344,6244,118,10706,26546,30237,40.33,16.36
嘉義縣,民雄鄉,東榮村,938,411,527,6,944,2300,0,41.04,17.87
嘉義縣,民雄鄉,中樂村,676,329,347,7,683,1528,0,44.7,21.53
嘉義縣,民雄鄉,西安村,1398,543,855,11,1409,3338,0,42.21,16.27
嘉義縣,民雄鄉,寮頂村,874,339,535,9,883,2158,0,40.92,15.71
嘉義縣,民雄鄉,福權村,676,233,443,9,685,1567,0,43.71,14.87
嘉義縣,民雄鄉,東湖村,641,260,381,8,649,1827,0,35.52,14.23
嘉義縣,民雄鄉,頂崙村,565,244,321,8,573,1469,0,39.01,16.61
嘉義縣,民雄鄉,菁埔村,688,189,499,11,699,1708,0,40.93,11.07
嘉義縣,民雄鄉,中和村,365,162,203,4,369,962,0,38.36,16.84
嘉義縣,民雄鄉,平和村,349,119,230,4,353,817,0,43.21,14.57
嘉義縣,民雄鄉,西昌村,347,99,248,2,349,821,0,42.51,12.06
嘉義縣,民雄鄉,豊收村,834,373,461,10,844,2163,0,39.02,17.24
嘉義縣,民雄鄉,三興村,604,247,357,4,608,1346,0,45.17,18.35
嘉義縣,民雄鄉,東興村,208,85,123,1,209,523,0,39.96,16.25
嘉義縣,民雄鄉,鎮北村,461,183,278,9,470,1154,0,40.73,15.86
嘉義縣,民雄鄉,興中村,668,251,417,5,673,1837,0,36.64,13.66
嘉義縣,民雄鄉,興南村,930,379,551,13,943,2740,0,34.42,13.83
嘉義縣,民雄鄉,福興村,845,311,534,13,858,1995,0,43.01,15.59
嘉義縣,民雄鄉,文隆村,987,438,549,18,1005,2450,0,41.02,17.88
嘉義縣,民雄鄉,山中村,1372,487,885,26,1398,3513,0,39.8,13.86
嘉義縣,民雄鄉,中央村,510,165,345,10,520,1281,0,40.59,12.88
嘉義縣,民雄鄉,北斗村,1936,798,1138,13,1949,5279,0,36.92,15.12
嘉義縣,民雄鄉,双福村,952,466,486,12,964,2449,0,39.36,19.03
嘉義縣,民雄鄉,大崎村,884,362,522,9,893,2361,0,37.82,15.33
嘉義縣,民雄鄉,秀林村,1029,340,689,16,1045,2602,0,40.16,13.07
嘉義縣,民雄鄉,松山村,591,228,363,5,596,1690,0,35.27,13.49
嘉義縣,民雄鄉,金興村,1135,470,665,10,1145,2956,0,38.73,15.9
嘉義縣,民雄鄉,福樂村,2567,1107,1460,22,2589,6649,0,38.94,16.65
嘉義縣,民雄鄉,合計,24030,9618,14412,275,24305,61483,71044,39.53,15.64
嘉義縣,溪口鄉,溪東村,513,194,319,5,518,1277,0,40.56,15.19
嘉義縣,溪口鄉,溪西村,292,100,192,3,295,653,0,45.18,15.31
嘉義縣,溪口鄉,溪北村,231,79,152,5,236,636,0,37.11,12.42
嘉義縣,溪口鄉,游東村,395,105,290,4,399,952,0,41.91,11.03
嘉義縣,溪口鄉,游西村,258,54,204,5,263,656,0,40.09,8.23
嘉義縣,溪口鄉,柴林村,279,88,191,5,284,758,0,37.47,11.61
嘉義縣,溪口鄉,林腳村,259,65,194,5,264,803,0,32.88,8.09
嘉義縣,溪口鄉,美南村,362,86,276,11,373,1113,0,33.51,7.73
嘉義縣,溪口鄉,美北村,332,103,229,3,335,971,0,34.5,10.61
嘉義縣,溪口鄉,本厝村,369,130,239,4,373,921,0,40.5,14.12
嘉義縣,溪口鄉,柳溝村,501,168,333,6,507,1264,0,40.11,13.29
嘉義縣,溪口鄉,疊溪村,395,123,272,3,398,1013,0,39.29,12.14
嘉義縣,溪口鄉,妙崙村,243,75,168,2,245,680,0,36.03,11.03
嘉義縣,溪口鄉,坪頂村,357,111,246,5,362,878,0,41.23,12.64
嘉義縣,溪口鄉,合計,4786,1481,3305,66,4852,12575,13890,38.58,11.78
嘉義縣,新港鄉,宮前村,984,421,563,8,992,2204,0,45.01,19.1
嘉義縣,新港鄉,宮後村,651,222,429,9,660,1541,0,42.83,14.41
嘉義縣,新港鄉,大興村,587,210,377,4,591,1424,0,41.5,14.75
嘉義縣,新港鄉,福德村,632,251,381,10,642,1618,0,39.68,15.51
嘉義縣,新港鄉,古民村,528,110,418,9,537,1375,0,39.05,8.0
嘉義縣,新港鄉,中庄村,639,184,455,14,653,1582,0,41.28,11.63
嘉義縣,新港鄉,大潭村,630,183,447,8,638,1618,0,39.43,11.31
嘉義縣,新港鄉,西庄村,379,140,239,5,384,931,0,41.25,15.04
嘉義縣,新港鄉,埤子村,213,57,156,4,217,549,0,39.53,10.38
嘉義縣,新港鄉,南崙村,360,54,306,7,367,886,0,41.42,6.09
嘉義縣,新港鄉,北崙村,166,29,137,6,172,465,0,36.99,6.24
嘉義縣,新港鄉,海瀛村,194,63,131,3,197,486,0,40.53,12.96
嘉義縣,新港鄉,月眉村,752,200,552,11,763,1627,0,46.9,12.29
嘉義縣,新港鄉,月潭村,587,158,429,6,593,1538,0,38.56,10.27
嘉義縣,新港鄉,溪北村,506,150,356,8,514,1308,0,39.3,11.47
嘉義縣,新港鄉,三間村,556,237,319,5,561,1492,0,37.6,15.88
嘉義縣,新港鄉,中洋村,405,157,248,6,411,1023,0,40.18,15.35
嘉義縣,新港鄉,菜公村,372,125,247,5,377,947,0,39.81,13.2
嘉義縣,新港鄉,安和村,356,80,276,6,362,985,0,36.75,8.12
嘉義縣,新港鄉,潭大村,428,131,297,5,433,1118,0,38.73,11.72
嘉義縣,新港鄉,南港村,383,115,268,2,385,1017,0,37.86,11.31
嘉義縣,新港鄉,板頭村,207,61,146,2,209,548,0,38.14,11.13
嘉義縣,新港鄉,共和村,326,108,218,4,330,838,0,39.38,12.89
嘉義縣,新港鄉,合計,10841,3446,7395,147,10988,27120,30952,40.52,12.71
嘉義縣,六腳鄉,蒜頭村,440,183,257,0,440,1127,0,39.04,16.24
嘉義縣,六腳鄉,蒜東村,272,99,173,4,276,788,0,35.03,12.56
嘉義縣,六腳鄉,蒜南村,321,95,226,4,325,829,0,39.2,11.46
嘉義縣,六腳鄉,工廠村,99,65,34,1,100,211,0,47.39,30.81
嘉義縣,六腳鄉,灣南村,420,145,275,10,430,1153,0,37.29,12.58
嘉義縣,六腳鄉,灣北村,366,165,201,7,373,1165,0,32.02,14.16
嘉義縣,六腳鄉,雙涵村,325,96,229,10,335,861,0,38.91,11.15
嘉義縣,六腳鄉,塗師村,242,72,170,9,251,615,0,40.81,11.71
嘉義縣,六腳鄉,三義村,260,65,195,5,265,725,0,36.55,8.97
嘉義縣,六腳鄉,港美村,264,48,216,6,270,677,0,39.88,7.09
嘉義縣,六腳鄉,豐美村,394,117,277,5,399,996,0,40.06,11.75
嘉義縣,六腳鄉,六斗村,306,92,214,6,312,905,0,34.48,10.17
嘉義縣,六腳鄉,崙陽村,355,113,242,7,362,1019,0,35.53,11.09
嘉義縣,六腳鄉,蘇厝村,486,143,343,4,490,1433,0,34.19,9.98
嘉義縣,六腳鄉,竹本村,202,64,138,2,204,594,0,34.34,10.77
嘉義縣,六腳鄉,永賢村,147,36,111,3,150,467,0,32.12,7.71
嘉義縣,六腳鄉,魚寮村,212,68,144,3,215,611,0,35.19,11.13
嘉義縣,六腳鄉,潭墘村,291,107,184,3,294,838,0,35.08,12.77
嘉義縣,六腳鄉,正義村,594,156,438,8,602,1392,0,43.25,11.21
嘉義縣,六腳鄉,溪厝村,214,62,152,7,221,578,0,38.24,10.73
嘉義縣,六腳鄉,六腳村,269,118,151,2,271,734,0,36.92,16.08
嘉義縣,六腳鄉,六南村,169,58,111,5,174,521,0,33.4,11.13
嘉義縣,六腳鄉,崩山村,237,72,165,2,239,627,0,38.12,11.48
嘉義縣,六腳鄉,古林村,265,56,209,1,266,659,0,40.36,8.5
嘉義縣,六腳鄉,更寮村,193,64,129,2,195,563,0,34.64,11.37
嘉義縣,六腳鄉,合計,7343,2359,4984,116,7459,20088,21914,37.13,11.74
嘉義縣,東石鄉,東石村,668,239,429,14,682,1898,0,35.93,12.59
嘉義縣,東石鄉,猿樹村,296,110,186,10,306,922,0,33.19,11.93
嘉義縣,東石鄉,型厝村,419,161,258,4,423,1320,0,32.05,12.2
嘉義縣,東石鄉,塭港村,543,242,301,5,548,1622,0,33.79,14.92
嘉義縣,東石鄉,三家村,323,125,198,10,333,1120,0,29.73,11.16
嘉義縣,東石鄉,永屯村,208,88,120,4,212,701,0,30.24,12.55
嘉義縣,東石鄉,海埔村,139,55,84,5,144,388,0,37.11,14.18
嘉義縣,東石鄉,龍港村,291,164,127,12,303,839,0,36.11,19.55
嘉義縣,東石鄉,副瀨村,317,107,210,7,324,857,0,37.81,12.49
嘉義縣,東石鄉,下揖村,252,72,180,8,260,714,0,36.41,10.08
嘉義縣,東石鄉,頂揖村,143,53,90,1,144,368,0,39.13,14.4
嘉義縣,東石鄉,溪下村,260,149,111,4,264,957,0,27.59,15.57
嘉義縣,東石鄉,港墘村,469,169,300,9,478,1185,0,40.34,14.26
嘉義縣,東石鄉,蔦松村,271,91,180,8,279,821,0,33.98,11.08
嘉義縣,東石鄉,圍潭村,221,84,137,0,221,650,0,34.0,12.92
嘉義縣,東石鄉,洲仔村,243,86,157,9,252,795,0,31.7,10.82
嘉義縣,東石鄉,東崙村,227,87,140,8,235,670,0,35.07,12.99
嘉義縣,東石鄉,西崙村,409,145,264,8,417,1074,0,38.83,13.5
嘉義縣,東石鄉,塭仔村,331,82,249,4,335,893,0,37.51,9.18
嘉義縣,東石鄉,網寮村,372,159,213,4,376,1167,0,32.22,13.62
嘉義縣,東石鄉,掌潭村,326,137,189,1,327,757,0,43.2,18.1
嘉義縣,東石鄉,港口村,84,35,49,2,86,284,0,30.28,12.32
嘉義縣,東石鄉,鰲鼓村,416,145,271,4,420,1233,0,34.06,11.76
嘉義縣,東石鄉,合計,7228,2785,4443,141,7369,21235,23594,34.7,13.12
嘉義縣,義竹鄉,岸腳村,259,94,165,7,266,663,0,40.12,14.18
嘉義縣,義竹鄉,義竹村,600,205,395,14,614,1416,0,43.36,14.48
嘉義縣,義竹鄉,六桂村,454,195,259,7,461,1125,0,40.98,17.33
嘉義縣,義竹鄉,仁里村,355,159,196,3,358,829,0,43.18,19.18
嘉義縣,義竹鄉,傳芳村,280,108,172,7,287,749,0,38.32,14.42
嘉義縣,義竹鄉,頭竹村,463,150,313,12,475,1195,0,39.75,12.55
嘉義縣,義竹鄉,五厝村,148,54,94,1,149,368,0,40.49,14.67
嘉義縣,義竹鄉,中平村,171,81,90,6,177,412,0,42.96,19.66
嘉義縣,義竹鄉,埤前村,321,137,184,8,329,721,0,45.63,19.0
嘉義縣,義竹鄉,平溪村,173,53,120,1,174,422,0,41.23,12.56
嘉義縣,義竹鄉,後鎮村,183,83,100,5,188,417,0,45.08,19.9
嘉義縣,義竹鄉,北華村,246,96,150,6,252,591,0,42.64,16.24
嘉義縣,義竹鄉,新店村,479,179,300,6,485,1447,0,33.52,12.37
嘉義縣,義竹鄉,東過村,241,92,149,4,245,826,0,29.66,11.14
嘉義縣,義竹鄉,西過村,263,69,194,2,265,777,0,34.11,8.88
嘉義縣,義竹鄉,官和村,286,58,228,11,297,796,0,37.31,7.29
嘉義縣,義竹鄉,官順村,148,50,98,2,150,422,0,35.55,11.85
嘉義縣,義竹鄉,新富村,182,92,90,8,190,520,0,36.54,17.69
嘉義縣,義竹鄉,東光村,292,98,194,3,295,724,0,40.75,13.54
嘉義縣,義竹鄉,東榮村,151,54,97,1,152,363,0,41.87,14.88
嘉義縣,義竹鄉,龍蛟村,196,68,128,5,201,554,0,36.28,12.27
嘉義縣,義竹鄉,溪洲村,296,89,207,3,299,636,0,47.01,13.99
嘉義縣,義竹鄉,合計,6187,2264,3923,122,6309,15973,17439,39.5,14.17
嘉義縣,鹿草鄉,後寮村,177,49,128,3,180,512,0,35.16,9.57
嘉義縣,鹿草鄉,鹿東村,218,61,157,2,220,540,0,40.74,11.3
嘉義縣,鹿草鄉,鹿草村,463,169,294,3,466,1289,0,36.15,13.11
嘉義縣,鹿草鄉,西井村,479,208,271,5,484,1319,0,36.69,15.77
嘉義縣,鹿草鄉,豊稠村,178,80,98,2,180,736,0,24.46,10.87
嘉義縣,鹿草鄉,重寮村,396,126,270,3,399,1002,0,39.82,12.57
嘉義縣,鹿草鄉,施家村,157,42,115,4,161,427,0,37.7,9.84
嘉義縣,鹿草鄉,下潭村,325,85,240,8,333,799,0,41.68,10.64
嘉義縣,鹿草鄉,光潭村,384,108,276,3,387,982,0,39.41,11.0
嘉義縣,鹿草鄉,碧潭村,333,140,193,2,335,937,0,35.75,14.94
嘉義縣,鹿草鄉,松竹村,297,127,170,3,300,927,0,32.36,13.7
嘉義縣,鹿草鄉,竹山村,342,88,254,8,350,895,0,39.11,9.83
嘉義縣,鹿草鄉,後堀村,437,150,287,6,443,1126,0,39.34,13.32
嘉義縣,鹿草鄉,三角村,576,187,389,9,585,1379,0,42.42,13.56
嘉義縣,鹿草鄉,下麻村,276,123,153,4,280,599,0,46.74,20.53
嘉義縣,鹿草鄉,合計,5038,1743,3295,65,5103,13469,14778,37.89,12.94
嘉義縣,水上鄉,水上村,1624,728,896,18,1642,4025,0,40.8,18.09
嘉義縣,水上鄉,水頭村,1050,475,575,11,1061,2466,0,43.03,19.26
嘉義縣,水上鄉,大堀村,779,251,528,6,785,1615,0,48.61,15.54
嘉義縣,水上鄉,大崙村,789,266,523,4,793,2073,0,38.25,12.83
嘉義縣,水上鄉,塗溝村,344,104,240,4,348,782,0,44.5,13.3
嘉義縣,水上鄉,粗溪村,607,273,334,10,617,1540,0,40.06,17.73
嘉義縣,水上鄉,下寮村,745,335,410,9,754,1867,0,40.39,17.94
嘉義縣,水上鄉,三和村,679,323,356,6,685,1779,0,38.5,18.16
嘉義縣,水上鄉,回歸村,181,83,98,3,184,427,0,43.09,19.44
嘉義縣,水上鄉,三鎮村,241,149,92,4,245,614,0,39.9,24.27
嘉義縣,水上鄉,靖和村,213,92,121,1,214,384,0,55.73,23.96
嘉義縣,水上鄉,南和村,520,179,341,3,523,1345,0,38.88,13.31
嘉義縣,水上鄉,龍德村,838,259,579,5,843,1915,0,44.02,13.52
嘉義縣,水上鄉,溪洲村,427,139,288,5,432,1028,0,42.02,13.52
嘉義縣,水上鄉,柳林村,715,284,431,11,726,2028,0,35.8,14.0
嘉義縣,水上鄉,柳鄉村,799,271,528,6,805,1983,0,40.6,13.67
嘉義縣,水上鄉,柳新村,684,327,357,8,692,1782,0,38.83,18.35
嘉義縣,水上鄉,寬士村,1649,655,994,18,1667,4357,0,38.26,15.03
嘉義縣,水上鄉,民生村,1210,530,680,11,1221,2967,0,41.15,17.86
嘉義縣,水上鄉,忠和村,710,314,396,9,719,1853,0,38.8,16.95
嘉義縣,水上鄉,中庄村,646,270,376,4,650,1779,0,36.54,15.18
嘉義縣,水上鄉,南鄉村,336,128,208,3,339,910,0,37.25,14.07
嘉義縣,水上鄉,三界村,379,140,239,6,385,971,0,39.65,14.42
嘉義縣,水上鄉,國姓村,426,132,294,5,431,1239,0,34.79,10.65
嘉義縣,水上鄉,內溪村,433,172,261,3,436,1179,0,36.98,14.59
嘉義縣,水上鄉,義興村,308,122,186,2,310,792,0,39.14,15.4
嘉義縣,水上鄉,合計,17332,7001,10331,175,17507,43700,48786,40.06,16.02
嘉義縣,中埔鄉,中埔村,615,230,385,6,621,1790,0,34.69,12.85
嘉義縣,中埔鄉,塩舘村,372,154,218,3,375,935,0,40.11,16.47
嘉義縣,中埔鄉,龍門村,324,140,184,2,326,787,0,41.42,17.79
嘉義縣,中埔鄉,裕民村,342,85,257,4,346,862,0,40.14,9.86
嘉義縣,中埔鄉,金蘭村,463,188,275,5,468,1500,0,31.2,12.53
嘉義縣,中埔鄉,富收村,1059,421,638,11,1070,2900,0,36.9,14.52
嘉義縣,中埔鄉,和睦村,1234,486,748,15,1249,3322,0,37.6,14.63
嘉義縣,中埔鄉,和美村,2666,1151,1515,16,2682,7020,0,38.21,16.4
嘉義縣,中埔鄉,和興村,2018,809,1209,34,2052,5652,0,36.31,14.31
嘉義縣,中埔鄉,隆興村,646,273,373,5,651,1825,0,35.67,14.96
嘉義縣,中埔鄉,義仁村,516,159,357,4,520,1490,0,34.9,10.67
嘉義縣,中埔鄉,社口村,716,289,427,7,723,2097,0,34.48,13.78
嘉義縣,中埔鄉,灣潭村,320,107,213,3,323,1020,0,31.67,10.49
嘉義縣,中埔鄉,石硦村,412,163,249,8,420,1122,0,37.43,14.53
嘉義縣,中埔鄉,頂埔村,343,108,235,5,348,932,0,37.34,11.59
嘉義縣,中埔鄉,同仁村,659,219,440,6,665,1851,0,35.93,11.83
嘉義縣,中埔鄉,瑞豐村,225,100,125,2,227,723,0,31.4,13.83
嘉義縣,中埔鄉,沄水村,340,118,222,5,345,966,0,35.71,12.22
嘉義縣,中埔鄉,三層村,197,62,135,1,198,634,0,31.23,9.78
嘉義縣,中埔鄉,深坑村,257,107,150,5,262,714,0,36.69,14.99
嘉義縣,中埔鄉,東興村,153,66,87,3,156,356,0,43.82,18.54
嘉義縣,中埔鄉,中崙村,105,53,52,1,106,291,0,36.43,18.21
嘉義縣,中埔鄉,合計,13982,5488,8494,151,14133,38789,43935,36.44,14.15
嘉義縣,竹崎鄉,竹崎村,963,405,558,8,971,2455,0,39.55,16.5
嘉義縣,竹崎鄉,和平村,726,273,453,11,737,2167,0,34.01,12.6
嘉義縣,竹崎鄉,坑頭村,233,101,132,3,236,750,0,31.47,13.47
嘉義縣,竹崎鄉,沙坑村,307,82,225,7,314,813,0,38.62,10.09
嘉義縣,竹崎鄉,獅埜村,500,165,335,10,510,1212,0,42.08,13.61
嘉義縣,竹崎鄉,義和村,295,110,185,4,299,603,0,49.59,18.24
嘉義縣,竹崎鄉,義仁村,309,103,206,1,310,1025,0,30.24,10.05
嘉義縣,竹崎鄉,灣橋村,1989,895,1094,18,2007,5214,0,38.49,17.17
嘉義縣,竹崎鄉,鹿滿村,549,207,342,4,553,1401,0,39.47,14.78
嘉義縣,竹崎鄉,紫雲村,465,202,263,10,475,1362,0,34.88,14.83
嘉義縣,竹崎鄉,內埔村,619,228,391,11,630,1562,0,40.33,14.6
嘉義縣,竹崎鄉,昇平村,483,167,316,7,490,1738,0,28.19,9.61
嘉義縣,竹崎鄉,白杞村,177,76,101,3,180,611,0,29.46,12.44
嘉義縣,竹崎鄉,桃源村,308,129,179,4,312,998,0,31.26,12.93
嘉義縣,竹崎鄉,塘興村,295,152,143,6,301,851,0,35.37,17.86
嘉義縣,竹崎鄉,義隆村,216,91,125,2,218,624,0,34.94,14.58
嘉義縣,竹崎鄉,龍山村,607,183,424,9,616,1756,0,35.08,10.42
嘉義縣,竹崎鄉,文峯村,219,87,132,5,224,626,0,35.78,13.9
嘉義縣,竹崎鄉,金獅村,157,63,94,0,157,416,0,37.74,15.14
嘉義縣,竹崎鄉,復金村,633,226,407,9,642,1845,0,34.8,12.25
嘉義縣,竹崎鄉,緞繻村,270,122,148,3,273,903,0,30.23,13.51
嘉義縣,竹崎鄉,仁壽村,66,14,52,0,66,238,0,27.73,5.88
嘉義縣,竹崎鄉,中和村,242,97,145,0,242,766,0,31.59,12.66
嘉義縣,竹崎鄉,光華村,206,108,98,4,210,681,0,30.84,15.86
嘉義縣,竹崎鄉,合計,10834,4286,6548,139,10973,30617,34503,35.84,14.0
嘉義縣,梅山鄉,梅東村,806,312,494,10,816,2182,0,37.4,14.3
嘉義縣,梅山鄉,梅南村,355,172,183,1,356,869,0,40.97,19.79
嘉義縣,梅山鄉,過山村,192,68,124,4,196,540,0,36.3,12.59
嘉義縣,梅山鄉,梅北村,1542,627,915,22,1564,4337,0,36.06,14.46
嘉義縣,梅山鄉,圳南村,147,57,90,2,149,393,0,37.91,14.5
嘉義縣,梅山鄉,永興村,182,82,100,1,183,500,0,36.6,16.4
嘉義縣,梅山鄉,半天村,108,34,74,2,110,355,0,30.99,9.58
嘉義縣,梅山鄉,圳北村,182,71,111,3,185,579,0,31.95,12.26
嘉義縣,梅山鄉,大南村,558,229,329,5,563,1618,0,34.8,14.15
嘉義縣,梅山鄉,双溪村,205,79,126,5,210,548,0,38.32,14.42
嘉義縣,梅山鄉,安靖村,223,88,135,3,226,814,0,27.76,10.81
嘉義縣,梅山鄉,太平村,139,64,75,1,140,488,0,28.69,13.11
嘉義縣,梅山鄉,碧湖村,84,38,46,0,84,275,0,30.55,13.82
嘉義縣,梅山鄉,太興村,152,87,65,1,153,414,0,36.96,21.01
嘉義縣,梅山鄉,瑞峯村,208,108,100,5,213,703,0,30.3,15.36
嘉義縣,梅山鄉,瑞里村,181,111,70,3,184,610,0,30.16,18.2
嘉義縣,梅山鄉,太和村,238,93,145,4,242,929,0,26.05,10.01
嘉義縣,梅山鄉,龍眼村,125,31,94,1,126,400,0,31.5,7.75
嘉義縣,梅山鄉,合計,5627,2351,3276,73,5700,16554,18481,34.43,14.2
嘉義縣,番路鄉,江西村,438,228,210,6,444,1143,0,38.85,19.95
嘉義縣,番路鄉,內甕村,168,73,95,1,169,440,0,38.41,16.59
嘉義縣,番路鄉,新福村,410,165,245,3,413,1282,0,32.22,12.87
嘉義縣,番路鄉,下坑村,665,305,360,10,675,1748,0,38.62,17.45
嘉義縣,番路鄉,番路村,296,117,179,3,299,835,0,35.81,14.01
嘉義縣,番路鄉,民和村,311,143,168,3,314,849,0,36.98,16.84
嘉義縣,番路鄉,觸口村,406,172,234,7,413,1220,0,33.85,14.1
嘉義縣,番路鄉,大湖村,154,60,94,6,160,596,0,26.85,10.07
嘉義縣,番路鄉,公田村,251,113,138,0,251,956,0,26.26,11.82
嘉義縣,番路鄉,公興村,144,57,87,4,148,498,0,29.72,11.45
嘉義縣,番路鄉,草山村,97,73,24,2,99,364,0,27.2,20.05
嘉義縣,番路鄉,合計,3340,1506,1834,45,3385,9931,11097,34.09,15.16
嘉義縣,大埔鄉,大埔村,353,144,209,4,357,1448,0,24.65,9.94
嘉義縣,大埔鄉,和平村,171,59,112,3,174,650,0,26.77,9.08
嘉義縣,大埔鄉,永樂村,118,64,54,0,118,420,0,28.1,15.24
嘉義縣,大埔鄉,茄苳村,183,82,101,5,188,923,0,20.37,8.88
嘉義縣,大埔鄉,西興村,177,94,83,0,177,567,0,31.22,16.58
嘉義縣,大埔鄉,合計,1002,443,559,12,1014,4008,4553,25.3,11.05
嘉義縣,阿里山鄉,中山村,110,62,48,1,111,367,0,30.25,16.89
嘉義縣,阿里山鄉,中正村,62,49,13,3,65,184,0,35.33,26.63
嘉義縣,阿里山鄉,香林村,42,28,14,0,42,142,0,29.58,19.72
嘉義縣,阿里山鄉,十字村,82,50,32,1,83,316,0,26.27,15.82
嘉義縣,阿里山鄉,來吉村,129,99,30,1,130,292,0,44.52,33.9
嘉義縣,阿里山鄉,豐山村,82,51,31,1,83,303,0,27.39,16.83
嘉義縣,阿里山鄉,達邦村,247,192,55,4,251,819,0,30.65,23.44
嘉義縣,阿里山鄉,樂野村,299,178,121,8,307,939,0,32.69,18.96
嘉義縣,阿里山鄉,里佳村,86,70,16,0,86,244,0,35.25,28.69
嘉義縣,阿里山鄉,山美村,131,103,28,0,131,472,0,27.75,21.82
嘉義縣,阿里山鄉,新美村,93,68,25,1,94,289,0,32.53,23.53
嘉義縣,阿里山鄉,茶山村,82,40,42,0,82,254,0,32.28,15.75
嘉義縣,阿里山鄉,合計,1445,990,455,20,1465,4621,5455,31.7,21.42
嘉義縣,合計,合計,163888,63301,100587,2060,165948,436894,496440,37.98,14.49
屏東縣,屏東市,維新里,1142,434,708,9,1151,2604,0,44.2,16.67
屏東縣,屏東市,橋南里,598,262,336,5,603,1528,0,39.46,17.15
屏東縣,屏東市,橋北里,395,176,219,5,400,843,0,47.45,20.88
屏東縣,屏東市,長春里,825,386,439,3,828,1836,0,45.1,21.02
屏東縣,屏東市,豐榮里,1199,553,646,17,1216,2467,0,49.29,22.42
屏東縣,屏東市,豐源里,1641,817,824,13,1654,3454,0,47.89,23.65
屏東縣,屏東市,豐田里,1717,811,906,9,1726,3905,0,44.2,20.77
屏東縣,屏東市,大連里,4207,2218,1989,29,4236,9028,0,46.92,24.57
屏東縣,屏東市,湖西里,673,208,465,5,678,1482,0,45.75,14.04
屏東縣,屏東市,湖南里,437,125,312,3,440,1032,0,42.64,12.11
屏東縣,屏東市,歸心里,473,120,353,7,480,1115,0,43.05,10.76
屏東縣,屏東市,瑞光里,3123,1563,1560,31,3154,7115,0,44.33,21.97
屏東縣,屏東市,新生里,2269,968,1301,20,2289,5421,0,42.22,17.86
屏東縣,屏東市,頂宅里,238,78,160,3,241,510,0,47.25,15.29
屏東縣,屏東市,厚生里,1239,427,812,11,1250,2821,0,44.31,15.14
屏東縣,屏東市,擇仁里,359,127,232,3,362,796,0,45.48,15.95
屏東縣,屏東市,建國里,407,194,213,6,413,900,0,45.89,21.56
屏東縣,屏東市,一心里,559,308,251,2,561,1173,0,47.83,26.26
屏東縣,屏東市,萬年里,301,104,197,0,301,678,0,44.4,15.34
屏東縣,屏東市,義勇里,557,334,223,7,564,1104,0,51.09,30.25
屏東縣,屏東市,光華里,274,107,167,3,277,655,0,42.29,16.34
屏東縣,屏東市,永安里,2903,1237,1666,28,2931,6960,0,42.11,17.77
屏東縣,屏東市,新興里,981,358,623,15,996,2467,0,40.37,14.51
屏東縣,屏東市,公館里,670,200,470,9,679,1488,0,45.63,13.44
屏東縣,屏東市,龍華里,931,329,602,8,939,2203,0,42.62,14.93
屏東縣,屏東市,玉成里,621,136,485,6,627,1481,0,42.34,9.18
屏東縣,屏東市,頂柳里,465,131,334,4,469,1083,0,43.31,12.1
屏東縣,屏東市,大湖里,711,259,452,8,719,1791,0,40.15,14.46
屏東縣,屏東市,安鎮里,839,294,545,13,852,1995,0,42.71,14.74
屏東縣,屏東市,永光里,449,179,270,5,454,1004,0,45.22,17.83
屏東縣,屏東市,大洲里,522,133,389,8,530,1166,0,45.45,11.41
屏東縣,屏東市,大武里,3408,1572,1836,40,3448,8068,0,42.74,19.48
屏東縣,屏東市,前進里,1212,443,769,12,1224,2872,0,42.62,15.42
屏東縣,屏東市,清溪里,1679,783,896,10,1689,4077,0,41.43,19.21
屏東縣,屏東市,長安里,839,301,538,6,845,1956,0,43.2,15.39
屏東縣,屏東市,斯文里,760,378,382,2,762,1637,0,46.55,23.09
屏東縣,屏東市,華山里,2001,1053,948,19,2020,4657,0,43.38,22.61
屏東縣,屏東市,興樂里,341,182,159,2,343,730,0,46.99,24.93
屏東縣,屏東市,明正里,261,128,133,4,265,652,0,40.64,19.63
屏東縣,屏東市,太平里,300,129,171,5,305,626,0,48.72,20.61
屏東縣,屏東市,中正里,1972,1038,934,16,1988,4603,0,43.19,22.55
屏東縣,屏東市,勝利里,2023,1103,920,18,2041,5471,0,37.31,20.16
屏東縣,屏東市,永城里,770,372,398,13,783,1912,0,40.95,19.46
屏東縣,屏東市,溝美里,984,456,528,14,998,2231,0,44.73,20.44
屏東縣,屏東市,北勢里,1085,500,585,11,1096,2284,0,47.99,21.89
屏東縣,屏東市,北興里,2561,1293,1268,18,2579,6059,0,42.56,21.34
屏東縣,屏東市,仁愛里,1017,471,546,11,1028,2149,0,47.84,21.92
屏東縣,屏東市,廣興里,875,404,471,10,885,2058,0,43.0,19.63
屏東縣,屏東市,崇蘭里,5166,2972,2194,44,5210,12298,0,42.36,24.17
屏東縣,屏東市,空翔里,802,542,260,7,809,1655,0,48.88,32.75
屏東縣,屏東市,潭墘里,4540,2685,1855,36,4576,11543,0,39.64,23.26
屏東縣,屏東市,三山里,570,189,381,8,578,1324,0,43.66,14.27
屏東縣,屏東市,海豐里,372,103,269,3,375,849,0,44.17,12.13
屏東縣,屏東市,仁義里,426,137,289,12,438,1089,0,40.22,12.58
屏東縣,屏東市,和興里,422,133,289,6,428,941,0,45.48,14.13
屏東縣,屏東市,信和里,689,182,507,3,692,1560,0,44.36,11.67
屏東縣,屏東市,崇武里,1252,928,324,12,1264,2890,0,43.74,32.11
屏東縣,屏東市,武廟里、大同里、端正里,538,175,363,1,539,1053,0,51.19,16.62
屏東縣,屏東市,文明里、泰安里,289,150,139,7,296,675,0,43.85,22.22
屏東縣,屏東市,光榮里、民權里,629,262,367,6,635,1310,0,48.47,20.0
屏東縣,屏東市,大埔里、必信里,555,217,338,6,561,1240,0,45.24,17.5
屏東縣,屏東市,崇智里、崇禮里,305,100,205,2,307,654,0,46.94,15.29
屏東縣,屏東市,楠樹里、扶風里、慶春里,602,207,395,5,607,1166,0,52.06,17.75
屏東縣,屏東市,安樂里、平和里,487,192,295,2,489,1039,0,47.06,18.48
屏東縣,屏東市,金泉里、勝豐里,508,185,323,7,515,1018,0,50.59,18.17
屏東縣,屏東市,凌雲里、鵬程里,216,124,92,1,217,525,0,41.33,23.62
屏東縣,屏東市,永順里、永昌里,236,105,131,5,241,520,0,46.35,20.19
屏東縣,屏東市,合計,72417,33770,38647,679,73096,167496,196653,43.64,20.16
屏東縣,潮州鎮,潮州里,224,124,100,2,226,505,0,44.75,24.55
屏東縣,潮州鎮,同榮里,297,103,194,5,302,582,0,51.89,17.7
屏東縣,潮州鎮,新榮里,547,220,327,8,555,1227,0,45.23,17.93
屏東縣,潮州鎮,新生里,415,160,255,2,417,983,0,42.42,16.28
屏東縣,潮州鎮,光華里,1747,782,965,10,1757,4770,0,36.83,16.39
屏東縣,潮州鎮,彭城里,375,108,267,3,378,859,0,44.0,12.57
屏東縣,潮州鎮,三星里,2284,1029,1255,23,2307,5434,0,42.45,18.94
屏東縣,潮州鎮,三共里,2766,1235,1531,18,2784,6463,0,43.08,19.11
屏東縣,潮州鎮,三和里,879,391,488,7,886,2106,0,42.07,18.57
屏東縣,潮州鎮,五魁里,548,211,337,7,555,1387,0,40.01,15.21
屏東縣,潮州鎮,蓬萊里,927,335,592,5,932,2401,0,38.82,13.95
屏東縣,潮州鎮,八爺里,921,360,561,7,928,2381,0,38.98,15.12
屏東縣,潮州鎮,永春里,2667,1149,1518,18,2685,7120,0,37.71,16.14
屏東縣,潮州鎮,富春里,452,191,261,3,455,1172,0,38.82,16.3
屏東縣,潮州鎮,光春里,553,215,338,8,561,1413,0,39.7,15.22
屏東縣,潮州鎮,興美里,313,107,206,1,314,881,0,35.64,12.15
屏東縣,潮州鎮,檨子里,169,61,108,0,169,468,0,36.11,13.03
屏東縣,潮州鎮,九塊里,623,177,446,11,634,1633,0,38.82,10.84
屏東縣,潮州鎮,泗林里,695,252,443,7,702,1615,0,43.47,15.6
屏東縣,潮州鎮,四春里,685,208,477,10,695,1694,0,41.03,12.28
屏東縣,潮州鎮,崙東里,609,189,420,7,616,1535,0,40.13,12.31
屏東縣,潮州鎮,合計,18696,7607,11089,162,18858,46629,53851,40.44,16.31
屏東縣,東港鎮,新勝里,950,309,641,7,957,1975,0,48.46,15.65
屏東縣,東港鎮,東和里,242,92,150,1,243,631,0,38.51,14.58
屏東縣,東港鎮,朝安里,594,164,430,9,603,1575,0,38.29,10.41
屏東縣,東港鎮,八德里,330,113,217,3,333,734,0,45.37,15.4
屏東縣,東港鎮,東隆里,435,145,290,6,441,1192,0,37.0,12.16
屏東縣,東港鎮,豐漁里,239,82,157,3,242,559,0,43.29,14.67
屏東縣,東港鎮,盛漁里,490,125,365,5,495,1329,0,37.25,9.41
屏東縣,東港鎮,興漁里,702,180,522,8,710,1804,0,39.36,9.98
屏東縣,東港鎮,鎮海里,1043,254,789,9,1052,2840,0,37.04,8.94
屏東縣,東港鎮,嘉蓮里,664,183,481,4,668,1680,0,39.76,10.89
屏東縣,東港鎮,南平里,530,203,327,6,536,1562,0,34.31,13.0
屏東縣,東港鎮,船頭里,2101,742,1359,17,2118,5363,0,39.49,13.84
屏東縣,東港鎮,下廍里,787,170,617,17,804,1937,0,41.51,8.78
屏東縣,東港鎮,大潭里,594,183,411,6,600,1532,0,39.16,11.95
屏東縣,東港鎮,興東里,3483,1334,2149,24,3507,9392,0,37.34,14.2
屏東縣,東港鎮,興農里,549,194,355,5,554,1324,0,41.84,14.65
屏東縣,東港鎮,興和里,420,100,320,7,427,1049,0,40.71,9.53
屏東縣,東港鎮,共和里,285,199,86,5,290,664,0,43.67,29.97
屏東縣,東港鎮,頂新里、頂中里,378,133,245,4,382,852,0,44.84,15.61
屏東縣,東港鎮,興台里、中興里,488,210,278,4,492,1133,0,43.42,18.53
屏東縣,東港鎮,合計,15304,5115,10189,150,15454,39127,46590,39.5,13.07
屏東縣,恆春鎮,城南里,293,157,136,4,297,896,0,33.15,17.52
屏東縣,恆春鎮,城北里,711,344,367,3,714,2205,0,32.38,15.6
屏東縣,恆春鎮,城西里,321,163,158,7,328,1109,0,29.58,14.7
屏東縣,恆春鎮,山腳里,1198,606,592,7,1205,4194,0,28.73,14.45
屏東縣,恆春鎮,網紗里,895,434,461,11,906,3117,0,29.07,13.92
屏東縣,恆春鎮,仁壽里,228,96,132,2,230,856,0,26.87,11.21
屏東縣,恆春鎮,茄湖里,170,61,109,3,173,504,0,34.33,12.1
屏東縣,恆春鎮,頭溝里,165,65,100,2,167,473,0,35.31,13.74
屏東縣,恆春鎮,四溝里,274,111,163,4,278,1021,0,27.23,10.87
屏東縣,恆春鎮,德和里,249,101,148,5,254,928,0,27.37,10.88
屏東縣,恆春鎮,龍水里,283,138,145,2,285,1079,0,26.41,12.79
屏東縣,恆春鎮,山海里,481,147,334,9,490,1560,0,31.41,9.42
屏東縣,恆春鎮,大光里,532,266,266,9,541,2199,0,24.6,12.1
屏東縣,恆春鎮,水泉里,318,103,215,6,324,1388,0,23.34,7.42
屏東縣,恆春鎮,南灣里,479,255,224,5,484,1686,0,28.71,15.12
屏東縣,恆春鎮,墾丁里,461,197,264,3,464,1205,0,38.51,16.35
屏東縣,恆春鎮,鵝鑾里,333,168,165,6,339,1082,0,31.33,15.53
屏東縣,恆春鎮,合計,7391,3412,3979,88,7479,25502,30236,29.33,13.38
屏東縣,萬丹鄉,萬安村,245,81,164,1,246,587,0,41.91,13.8
屏東縣,萬丹鄉,萬惠村,360,135,225,3,363,817,0,44.43,16.52
屏東縣,萬丹鄉,萬全村,1462,523,939,15,1477,3322,0,44.46,15.74
屏東縣,萬丹鄉,萬後村,240,81,159,1,241,711,0,33.9,11.39
屏東縣,萬丹鄉,萬生村,611,255,356,6,617,1403,0,43.98,18.18
屏東縣,萬丹鄉,寶厝村,861,350,511,6,867,2249,0,38.55,15.56
屏東縣,萬丹鄉,四維村,823,282,541,10,833,2047,0,40.69,13.78
屏東縣,萬丹鄉,竹林村,692,220,472,11,703,1671,0,42.07,13.17
屏東縣,萬丹鄉,廣安村,1021,330,691,7,1028,2276,0,45.17,14.5
屏東縣,萬丹鄉,田厝村,441,116,325,6,447,973,0,45.94,11.92
屏東縣,萬丹鄉,崙頂村,713,224,489,9,722,1835,0,39.35,12.21
屏東縣,萬丹鄉,厦北村,681,192,489,11,692,1593,0,43.44,12.05
屏東縣,萬丹鄉,厦南村,564,195,369,7,571,1407,0,40.58,13.86
屏東縣,萬丹鄉,上村村,365,105,260,3,368,822,0,44.77,12.77
屏東縣,萬丹鄉,加興村,542,113,429,5,547,1248,0,43.83,9.05
屏東縣,萬丹鄉,社口村,556,199,357,12,568,1471,0,38.61,13.53
屏東縣,萬丹鄉,磚寮村,417,130,287,7,424,943,0,44.96,13.79
屏東縣,萬丹鄉,社皮村,835,272,563,13,848,1968,0,43.09,13.82
屏東縣,萬丹鄉,社上村,711,213,498,10,721,1666,0,43.28,12.79
屏東縣,萬丹鄉,社中村,717,202,515,7,724,1692,0,42.79,11.94
屏東縣,萬丹鄉,水泉村,766,274,492,11,777,1694,0,45.87,16.17
屏東縣,萬丹鄉,新庄村,871,341,530,7,878,2075,0,42.31,16.43
屏東縣,萬丹鄉,香社村,621,214,407,9,630,1508,0,41.78,14.19
屏東縣,萬丹鄉,後村村,451,137,314,3,454,977,0,46.47,14.02
屏東縣,萬丹鄉,新鐘村,724,314,410,9,733,2019,0,36.31,15.55
屏東縣,萬丹鄉,灣內村,527,150,377,7,534,1343,0,39.76,11.17
屏東縣,萬丹鄉,興全村,474,168,306,7,481,1145,0,42.01,14.67
屏東縣,萬丹鄉,興安村,353,101,252,3,356,828,0,43.0,12.2
屏東縣,萬丹鄉,水仙村,231,98,133,4,235,546,0,43.04,17.95
屏東縣,萬丹鄉,甘棠村,131,53,78,3,134,394,0,34.01,13.45
屏東縣,萬丹鄉,合計,18006,6068,11938,213,18219,43230,49955,42.14,14.04
屏東縣,長治鄉,進興村,1104,461,643,15,1119,2655,0,42.15,17.36
屏東縣,長治鄉,新潭村,1508,704,804,12,1520,3605,0,42.16,19.53
屏東縣,長治鄉,潭頭村,886,375,511,8,894,1921,0,46.54,19.52
屏東縣,長治鄉,香楊村,1165,509,656,11,1176,2628,0,44.75,19.37
屏東縣,長治鄉,長興村,476,205,271,3,479,1056,0,45.36,19.41
屏東縣,長治鄉,德成村,408,161,247,2,410,859,0,47.73,18.74
屏東縣,長治鄉,德協村,469,164,305,3,472,1045,0,45.17,15.69
屏東縣,長治鄉,復興村,663,236,427,11,674,1475,0,45.69,16.0
屏東縣,長治鄉,崙上村,702,301,401,3,705,1639,0,43.01,18.36
屏東縣,長治鄉,德榮村,521,167,354,8,529,1144,0,46.24,14.6
屏東縣,長治鄉,德和村,268,72,196,5,273,743,0,36.74,9.69
屏東縣,長治鄉,繁華村,922,238,684,8,930,2349,0,39.59,10.13
屏東縣,長治鄉,繁昌村,668,213,455,9,677,1719,0,39.38,12.39
屏東縣,長治鄉,繁榮村,483,156,327,7,490,1404,0,34.9,11.11
屏東縣,長治鄉,繁隆村,396,144,252,9,405,1127,0,35.94,12.78
屏東縣,長治鄉,榮華村,303,191,112,3,306,710,0,43.1,26.9
屏東縣,長治鄉,合計,10942,4297,6645,117,11059,26079,29381,42.41,16.48
屏東縣,麟洛鄉,新田村,1001,340,661,12,1013,2127,0,47.63,15.98
屏東縣,麟洛鄉,麟頂村,436,163,273,3,439,925,0,47.46,17.62
屏東縣,麟洛鄉,麟蹄村,736,254,482,8,744,1484,0,50.13,17.12
屏東縣,麟洛鄉,麟趾村,1180,415,765,10,1190,2480,0,47.98,16.73
屏東縣,麟洛鄉,田中村,558,183,375,2,560,1156,0,48.44,15.83
屏東縣,麟洛鄉,田心村,417,163,254,4,421,846,0,49.76,19.27
屏東縣,麟洛鄉,田道村,350,118,232,1,351,671,0,52.31,17.59
屏東縣,麟洛鄉,合計,4678,1636,3042,40,4718,9689,10711,48.69,16.89
屏東縣,九如鄉,九清村,599,162,437,4,603,1438,0,41.93,11.27
屏東縣,九如鄉,九塊村,585,154,431,7,592,1353,0,43.75,11.38
屏東縣,九如鄉,九明村,788,200,588,11,799,1675,0,47.7,11.94
屏東縣,九如鄉,玉水村,508,146,362,12,520,1222,0,42.55,11.95
屏東縣,九如鄉,大坵村,473,161,312,5,478,1155,0,41.39,13.94
屏東縣,九如鄉,三塊村,610,140,470,4,614,1563,0,39.28,8.96
屏東縣,九如鄉,後庄村,801,194,607,19,820,1747,0,46.94,11.1
屏東縣,九如鄉,耆老村,538,142,396,7,545,1257,0,43.36,11.3
屏東縣,九如鄉,洽興村,620,177,443,5,625,1454,0,42.98,12.17
屏東縣,九如鄉,東寧村,2007,655,1352,14,2021,4613,0,43.81,14.2
屏東縣,九如鄉,玉泉村,709,242,467,7,716,1586,0,45.15,15.26
屏東縣,九如鄉,合計,8238,2373,5865,95,8333,19063,21784,43.71,12.45
屏東縣,里港鄉,玉田村,1307,419,888,13,1320,3156,0,41.83,13.28
屏東縣,里港鄉,大平村,473,176,297,8,481,1106,0,43.49,15.91
屏東縣,里港鄉,永春村,341,104,237,2,343,840,0,40.83,12.38
屏東縣,里港鄉,春林村,578,191,387,4,582,1323,0,43.99,14.44
屏東縣,里港鄉,過江村,817,251,566,10,827,1992,0,41.52,12.6
屏東縣,里港鄉,鐵店村,596,186,410,7,603,1418,0,42.52,13.12
屏東縣,里港鄉,塔樓村,637,180,457,8,645,1522,0,42.38,11.83
屏東縣,里港鄉,潮厝村,596,164,432,5,601,1564,0,38.43,10.49
屏東縣,里港鄉,茄苳村,656,167,489,10,666,1502,0,44.34,11.12
屏東縣,里港鄉,載興村,988,238,750,14,1002,2297,0,43.62,10.36
屏東縣,里港鄉,土庫村,847,424,423,8,855,1980,0,43.18,21.41
屏東縣,里港鄉,三廍村,719,293,426,17,736,1815,0,40.55,16.14
屏東縣,里港鄉,中和村,348,126,222,5,353,956,0,36.92,13.18
屏東縣,里港鄉,瀰力村,258,67,191,6,264,514,0,51.36,13.04
屏東縣,里港鄉,合計,9161,2986,6175,117,9278,21985,25657,42.2,13.58
屏東縣,鹽埔鄉,新圍村,1072,334,738,26,1098,3077,0,35.68,10.85
屏東縣,鹽埔鄉,高朗村,901,284,617,13,914,2767,0,33.03,10.26
屏東縣,鹽埔鄉,鹽北村,583,269,314,6,589,1800,0,32.72,14.94
屏東縣,鹽埔鄉,鹽中村,781,373,408,12,793,2311,0,34.31,16.14
屏東縣,鹽埔鄉,鹽南村,558,263,295,8,566,1683,0,33.63,15.63
屏東縣,鹽埔鄉,仕絨村,354,190,164,2,356,1022,0,34.83,18.59
屏東縣,鹽埔鄉,振興村,600,232,368,18,618,1803,0,34.28,12.87
屏東縣,鹽埔鄉,永隆村,213,59,154,3,216,537,0,40.22,10.99
屏東縣,鹽埔鄉,久愛村,343,147,196,8,351,908,0,38.66,16.19
屏東縣,鹽埔鄉,洛陽村,641,257,384,7,648,1606,0,40.35,16.0
屏東縣,鹽埔鄉,新二村,1248,548,700,11,1259,3450,0,36.49,15.88
屏東縣,鹽埔鄉,彭厝村,381,156,225,5,386,957,0,40.33,16.3
屏東縣,鹽埔鄉,合計,7675,3112,4563,119,7794,21921,24795,35.55,14.2
屏東縣,高樹鄉,高樹村,959,236,723,10,969,2093,0,46.3,11.28
屏東縣,高樹鄉,長榮村,539,113,426,6,545,1236,0,44.09,9.14
屏東縣,高樹鄉,東興村,328,68,260,4,332,707,0,46.96,9.62
屏東縣,高樹鄉,東振村,240,63,177,5,245,578,0,42.39,10.9
屏東縣,高樹鄉,源泉村,440,129,311,5,445,995,0,44.72,12.96
屏東縣,高樹鄉,建興村,438,98,340,10,448,1135,0,39.47,8.63
屏東縣,高樹鄉,大埔村,252,75,177,3,255,592,0,43.07,12.67
屏東縣,高樹鄉,菜寮村,306,54,252,9,315,727,0,43.33,7.43
屏東縣,高樹鄉,司馬村,210,67,143,7,217,618,0,35.11,10.84
屏東縣,高樹鄉,舊寮村,483,141,342,1,484,1183,0,40.91,11.92
屏東縣,高樹鄉,新豐村,508,140,368,6,514,1416,0,36.3,9.89
屏東縣,高樹鄉,泰山村,654,168,486,12,666,1828,0,36.43,9.19
屏東縣,高樹鄉,南華村,464,128,336,10,474,1231,0,38.51,10.4
屏東縣,高樹鄉,廣福村,435,120,315,9,444,1041,0,42.65,11.53
屏東縣,高樹鄉,廣興村,359,111,248,6,365,1085,0,33.64,10.23
屏東縣,高樹鄉,舊庄村,393,100,293,8,401,988,0,40.59,10.12
屏東縣,高樹鄉,田子村,410,112,298,9,419,1054,0,39.75,10.63
屏東縣,高樹鄉,鹽樹村,535,151,384,8,543,1172,0,46.33,12.88
屏東縣,高樹鄉,新南村,543,136,407,11,554,1483,0,37.36,9.17
屏東縣,高樹鄉,合計,8496,2210,6286,139,8635,21162,23583,40.8,10.44
屏東縣,萬巒鄉,萬巒村,507,143,364,5,512,1171,0,43.72,12.21
屏東縣,萬巒鄉,萬全村,312,109,203,2,314,715,0,43.92,15.24
屏東縣,萬巒鄉,萬和村,766,246,520,7,773,1663,0,46.48,14.79
屏東縣,萬巒鄉,鹿寮村,405,118,287,5,410,885,0,46.33,13.33
屏東縣,萬巒鄉,硫黃村,274,72,202,2,276,530,0,52.08,13.58
屏東縣,萬巒鄉,泗溝村,482,190,292,10,492,1083,0,45.43,17.54
屏東縣,萬巒鄉,五溝村,477,165,312,6,483,990,0,48.79,16.67
屏東縣,萬巒鄉,成德村,578,198,380,9,587,1392,0,42.17,14.22
屏東縣,萬巒鄉,萬金村,785,226,559,10,795,1976,0,40.23,11.44
屏東縣,萬巒鄉,赤山村,563,207,356,8,571,1657,0,34.46,12.49
屏東縣,萬巒鄉,佳佐村,623,151,472,5,628,1673,0,37.54,9.03
屏東縣,萬巒鄉,佳和村,527,200,327,5,532,1374,0,38.72,14.56
屏東縣,萬巒鄉,新厝村,480,118,362,6,486,1233,0,39.42,9.57
屏東縣,萬巒鄉,新置村,429,155,274,3,432,1162,0,37.18,13.34
屏東縣,萬巒鄉,合計,7208,2298,4910,83,7291,17504,20028,41.65,13.13
屏東縣,內埔鄉,內埔村,1621,666,955,12,1633,3943,0,41.42,16.89
屏東縣,內埔鄉,內田村,1283,490,793,14,1297,3127,0,41.48,15.67
屏東縣,內埔鄉,興南村,595,217,378,9,604,1261,0,47.9,17.21
屏東縣,內埔鄉,義亭村,247,87,160,2,249,565,0,44.07,15.4
屏東縣,內埔鄉,美和村,926,357,569,10,936,2169,0,43.15,16.46
屏東縣,內埔鄉,和興村,1138,472,666,7,1145,2795,0,40.97,16.89
屏東縣,內埔鄉,東寧村,1877,707,1170,16,1893,4356,0,43.46,16.23
屏東縣,內埔鄉,豐田村,1246,456,790,14,1260,3045,0,41.38,14.98
屏東縣,內埔鄉,振豐村,763,275,488,6,769,1580,0,48.67,17.41
屏東縣,內埔鄉,富田村,830,237,593,5,835,1847,0,45.21,12.83
屏東縣,內埔鄉,竹圍村,797,258,539,8,805,1835,0,43.87,14.06
屏東縣,內埔鄉,東勢村,1191,365,826,15,1206,2856,0,42.23,12.78
屏東縣,內埔鄉,東片村,478,149,329,8,486,920,0,52.83,16.2
屏東縣,內埔鄉,上樹村,497,146,351,7,504,1079,0,46.71,13.53
屏東縣,內埔鄉,老埤村,751,234,517,11,762,2282,0,33.39,10.25
屏東縣,內埔鄉,中林村,556,142,414,3,559,1517,0,36.85,9.36
屏東縣,內埔鄉,龍泉村,884,414,470,13,897,2397,0,37.42,17.27
屏東縣,內埔鄉,龍潭村,758,405,353,9,767,2350,0,32.64,17.23
屏東縣,內埔鄉,建興村,362,142,220,6,368,782,0,47.06,18.16
屏東縣,內埔鄉,大新村,701,283,418,11,712,1726,0,41.25,16.4
屏東縣,內埔鄉,黎明村,843,253,590,11,854,2405,0,35.51,10.52
屏東縣,內埔鄉,隘寮村,414,140,274,5,419,1260,0,33.25,11.11
屏東縣,內埔鄉,水門村,329,142,187,6,335,795,0,42.14,17.86
屏東縣,內埔鄉,合計,19087,7037,12050,208,19295,46892,52910,41.15,15.01
屏東縣,竹田鄉,竹田村,662,246,416,3,665,1447,0,45.96,17.0
屏東縣,竹田鄉,竹南村,409,117,292,5,414,868,0,47.7,13.48
屏東縣,竹田鄉,糶糴村,333,122,211,5,338,676,0,50.0,18.05
屏東縣,竹田鄉,履豐村,276,92,184,5,281,577,0,48.7,15.94
屏東縣,竹田鄉,頭崙村,572,176,396,5,577,1289,0,44.76,13.65
屏東縣,竹田鄉,二崙村,474,165,309,3,477,969,0,49.23,17.03
屏東縣,竹田鄉,美崙村,316,120,196,2,318,621,0,51.21,19.32
屏東縣,竹田鄉,南勢村,253,76,177,1,254,459,0,55.34,16.56
屏東縣,竹田鄉,西勢村,1096,413,683,11,1107,2368,0,46.75,17.44
屏東縣,竹田鄉,福田村,237,86,151,4,241,477,0,50.52,18.03
屏東縣,竹田鄉,永豐村,353,124,229,0,353,881,0,40.07,14.07
屏東縣,竹田鄉,六巷村,359,128,231,7,366,796,0,45.98,16.08
屏東縣,竹田鄉,泗洲村,426,159,267,12,438,1099,0,39.85,14.47
屏東縣,竹田鄉,大湖村,499,156,343,5,504,1186,0,42.5,13.15
屏東縣,竹田鄉,鳳明村,458,192,266,8,466,1180,0,39.49,16.27
屏東縣,竹田鄉,合計,6723,2372,4351,76,6799,14893,16409,45.65,15.93
屏東縣,新埤鄉,新埤村,831,380,451,8,839,1959,0,42.83,19.4
屏東縣,新埤鄉,建功村,533,200,333,2,535,1030,0,51.94,19.42
屏東縣,新埤鄉,打鐵村,384,168,216,8,392,860,0,45.58,19.53
屏東縣,新埤鄉,南豐村,341,119,222,3,344,734,0,46.87,16.21
屏東縣,新埤鄉,萬隆村,565,242,323,7,572,1713,0,33.39,14.13
屏東縣,新埤鄉,箕湖村,360,127,233,8,368,1100,0,33.45,11.55
屏東縣,新埤鄉,餉潭村,364,98,266,8,372,1253,0,29.69,7.82
屏東縣,新埤鄉,合計,3378,1334,2044,44,3422,8649,9464,39.57,15.42
屏東縣,枋寮鄉,枋寮村,463,230,233,3,466,1196,0,38.96,19.23
屏東縣,枋寮鄉,新龍村,320,175,145,7,327,865,0,37.8,20.23
屏東縣,枋寮鄉,保生村,353,120,233,3,356,906,0,39.29,13.25
屏東縣,枋寮鄉,中寮村,251,76,175,2,253,573,0,44.15,13.26
屏東縣,枋寮鄉,安樂村,614,205,409,7,621,1578,0,39.35,12.99
屏東縣,枋寮鄉,隆山村,1528,479,1049,22,1550,4151,0,37.34,11.54
屏東縣,枋寮鄉,天時村,798,264,534,11,809,1866,0,43.35,14.15
屏東縣,枋寮鄉,地利村,651,252,399,3,654,1416,0,46.19,17.8
屏東縣,枋寮鄉,人和村,830,308,522,6,836,2027,0,41.24,15.19
屏東縣,枋寮鄉,內寮村,250,64,186,3,253,695,0,36.4,9.21
屏東縣,枋寮鄉,新開村,234,92,142,3,237,874,0,27.12,10.53
屏東縣,枋寮鄉,太源村,286,124,162,6,292,927,0,31.5,13.38
屏東縣,枋寮鄉,玉泉村,120,56,64,2,122,428,0,28.5,13.08
屏東縣,枋寮鄉,東海村,1015,432,583,15,1030,2680,0,38.43,16.12
屏東縣,枋寮鄉,大庄村,233,71,162,2,235,604,0,38.91,11.75
屏東縣,枋寮鄉,合計,7946,2948,4998,95,8041,20786,23466,38.68,14.18
屏東縣,新園鄉,瓦磘村,672,180,492,6,678,1629,0,41.62,11.05
屏東縣,新園鄉,仙吉村,908,282,626,11,919,2479,0,37.07,11.38
屏東縣,新園鄉,田洋村,818,223,595,9,827,2135,0,38.74,10.44
屏東縣,新園鄉,港墘村,306,107,199,2,308,807,0,38.17,13.26
屏東縣,新園鄉,內庄村,357,117,240,6,363,820,0,44.27,14.27
屏東縣,新園鄉,新東村,826,318,508,13,839,2294,0,36.57,13.86
屏東縣,新園鄉,新園村,881,282,599,8,889,2190,0,40.59,12.88
屏東縣,新園鄉,烏龍村,502,141,361,7,509,1194,0,42.63,11.81
屏東縣,新園鄉,興龍村,903,243,660,5,908,2092,0,43.4,11.62
屏東縣,新園鄉,中洲村,639,125,514,13,652,1553,0,41.98,8.05
屏東縣,新園鄉,南龍村,569,146,423,7,576,1368,0,42.11,10.67
屏東縣,新園鄉,港西村,800,253,547,7,807,2061,0,39.16,12.28
屏東縣,新園鄉,五房村,1059,346,713,11,1070,2733,0,39.15,12.66
屏東縣,新園鄉,鹽埔村,1609,407,1202,23,1632,4335,0,37.65,9.39
屏東縣,新園鄉,共和村,773,160,613,15,788,2284,0,34.5,7.01
屏東縣,新園鄉,合計,11622,3330,8292,143,11765,29974,33639,39.25,11.11
屏東縣,崁頂鄉,崁頂村,845,321,524,7,852,2220,0,38.38,14.46
屏東縣,崁頂鄉,園寮村,794,300,494,8,802,1996,0,40.18,15.03
屏東縣,崁頂鄉,圍內村,492,175,317,5,497,1200,0,41.42,14.58
屏東縣,崁頂鄉,力社村,505,144,361,8,513,1272,0,40.33,11.32
屏東縣,崁頂鄉,洲子村,369,115,254,4,373,1046,0,35.66,10.99
屏東縣,崁頂鄉,北勢村,600,188,412,15,615,1466,0,41.95,12.82
屏東縣,崁頂鄉,越溪村,357,124,233,1,358,905,0,39.56,13.7
屏東縣,崁頂鄉,港東村,724,194,530,5,729,1834,0,39.75,10.58
屏東縣,崁頂鄉,合計,4686,1561,3125,53,4739,11939,15223,39.69,13.07
屏東縣,林邊鄉,林邊村,624,203,421,6,630,1392,0,45.26,14.58
屏東縣,林邊鄉,光林村,623,193,430,5,628,1509,0,41.62,12.79
屏東縣,林邊鄉,仁和村,693,217,476,7,700,1603,0,43.67,13.54
屏東縣,林邊鄉,中林村,322,125,197,4,326,690,0,47.25,18.12
屏東縣,林邊鄉,永樂村,1376,437,939,14,1390,3098,0,44.87,14.11
屏東縣,林邊鄉,水利村,641,246,395,13,654,1761,0,37.14,13.97
屏東縣,林邊鄉,崎峯村,429,157,272,9,438,1241,0,35.29,12.65
屏東縣,林邊鄉,田厝村,348,111,237,7,355,895,0,39.66,12.4
屏東縣,林邊鄉,竹林村,756,231,525,9,765,1885,0,40.58,12.25
屏東縣,林邊鄉,鎮安村,463,155,308,8,471,1086,0,43.37,14.27
屏東縣,林邊鄉,合計,6275,2075,4200,82,6357,15160,17145,41.93,13.69
屏東縣,南州鄉,溪洲村,689,241,448,6,695,1652,0,42.07,14.59
屏東縣,南州鄉,溪南村,395,149,246,4,399,908,0,43.94,16.41
屏東縣,南州鄉,仁里村,221,80,141,2,223,487,0,45.79,16.43
屏東縣,南州鄉,溪北村,308,184,124,3,311,673,0,46.21,27.34
屏東縣,南州鄉,七塊村,365,128,237,4,369,1011,0,36.5,12.66
屏東縣,南州鄉,萬華村,367,133,234,1,368,965,0,38.13,13.78
屏東縣,南州鄉,米崙村,455,172,283,5,460,1028,0,44.75,16.73
屏東縣,南州鄉,壽元村,425,78,347,6,431,1050,0,41.05,7.43
屏東縣,南州鄉,同安村,420,97,323,6,426,965,0,44.15,10.05
屏東縣,南州鄉,南安村,235,64,171,5,240,515,0,46.6,12.43
屏東縣,南州鄉,合計,3880,1326,2554,42,3922,9254,10249,42.38,14.33
屏東縣,佳冬鄉,佳冬村,582,213,369,8,590,1467,0,40.22,14.52
屏東縣,佳冬鄉,六根村,542,190,352,6,548,1302,0,42.09,14.59
屏東縣,佳冬鄉,賴家村,343,102,241,2,345,733,0,47.07,13.92
屏東縣,佳冬鄉,萬建村,694,250,444,2,696,1793,0,38.82,13.94
屏東縣,佳冬鄉,石光村,802,213,589,7,809,1922,0,42.09,11.08
屏東縣,佳冬鄉,玉光村,793,203,590,13,806,2056,0,39.2,9.87
屏東縣,佳冬鄉,昌隆村,402,121,281,8,410,936,0,43.8,12.93
屏東縣,佳冬鄉,豐隆村,275,95,180,2,277,674,0,41.1,14.09
屏東縣,佳冬鄉,大同村,448,127,321,6,454,1138,0,39.89,11.16
屏東縣,佳冬鄉,羌園村,410,108,302,9,419,1061,0,39.49,10.18
屏東縣,佳冬鄉,燄溫村,359,123,236,1,360,1072,0,33.58,11.47
屏東縣,佳冬鄉,塭豐村,773,334,439,10,783,2355,0,33.25,14.18
屏東縣,佳冬鄉,合計,6423,2079,4344,74,6497,16509,18414,39.35,12.59
屏東縣,琉球鄉,本福村,499,250,249,5,504,2066,0,24.39,12.1
屏東縣,琉球鄉,中福村,271,144,127,3,274,1247,0,21.97,11.55
屏東縣,琉球鄉,漁福村,223,157,66,3,226,975,0,23.18,16.1
屏東縣,琉球鄉,大福村,291,177,114,2,293,1617,0,18.12,10.95
屏東縣,琉球鄉,南福村,193,104,89,1,194,1117,0,17.37,9.31
屏東縣,琉球鄉,天福村,197,108,89,1,198,1101,0,17.98,9.81
屏東縣,琉球鄉,上福村,259,153,106,3,262,1622,0,16.15,9.43
屏東縣,琉球鄉,杉福村,172,87,85,1,173,850,0,20.35,10.24
屏東縣,琉球鄉,合計,2105,1180,925,19,2124,10595,12095,20.05,11.14
屏東縣,車城鄉,福興村,486,209,277,6,492,1315,0,37.41,15.89
屏東縣,車城鄉,福安村,226,60,166,1,227,534,0,42.51,11.24
屏東縣,車城鄉,田中村,156,62,94,1,157,610,0,25.74,10.16
屏東縣,車城鄉,海口村,203,91,112,5,208,717,0,29.01,12.69
屏東縣,車城鄉,統埔村,111,45,66,0,111,370,0,30.0,12.16
屏東縣,車城鄉,溫泉村,267,113,154,6,273,837,0,32.62,13.5
屏東縣,車城鄉,保力村,351,147,204,9,360,1197,0,30.08,12.28
屏東縣,車城鄉,新街村,147,36,111,1,148,418,0,35.41,8.61
屏東縣,車城鄉,埔墘村,110,59,51,2,112,412,0,27.18,14.32
屏東縣,車城鄉,射寮村,151,72,79,3,154,481,0,32.02,14.97
屏東縣,車城鄉,後灣村,155,64,91,3,158,399,0,39.6,16.04
屏東縣,車城鄉,合計,2363,958,1405,37,2400,7290,8221,32.92,13.14
屏東縣,滿州鄉,滿州村,423,202,221,4,427,1429,0,29.88,14.14
屏東縣,滿州鄉,里德村,117,55,62,3,120,392,0,30.61,14.03
屏東縣,滿州鄉,永靖村,370,168,202,4,374,1208,0,30.96,13.91
屏東縣,滿州鄉,港口村,391,133,258,4,395,1223,0,32.3,10.87
屏東縣,滿州鄉,响林村,148,52,96,0,148,526,0,28.14,9.89
屏東縣,滿州鄉,長樂村,266,138,128,6,272,1255,0,21.67,11.0
屏東縣,滿州鄉,九棚村,89,43,46,1,90,348,0,25.86,12.36
屏東縣,滿州鄉,港仔村,98,46,52,0,98,305,0,32.13,15.08
屏東縣,滿州鄉,合計,1902,837,1065,22,1924,6686,7397,28.78,12.52
屏東縣,枋山鄉,枋山村,353,179,174,8,361,966,0,37.37,18.53
屏東縣,枋山鄉,加祿村,691,231,460,11,702,1872,0,37.5,12.34
屏東縣,枋山鄉,楓港村,290,75,215,4,294,962,0,30.56,7.8
屏東縣,枋山鄉,善餘村,248,76,172,3,251,837,0,29.99,9.08
屏東縣,枋山鄉,合計,1582,561,1021,26,1608,4637,5145,34.68,12.1
屏東縣,三地門鄉,三地村,551,438,113,15,566,1460,0,38.77,30.0
屏東縣,三地門鄉,達來村,96,62,34,0,96,341,0,28.15,18.18
屏東縣,三地門鄉,德文村,87,61,26,1,88,566,0,15.55,10.78
屏東縣,三地門鄉,大社村,172,143,29,6,178,639,0,27.86,22.38
屏東縣,三地門鄉,賽嘉村,218,161,57,3,221,725,0,30.48,22.21
屏東縣,三地門鄉,口社村,189,142,47,4,193,550,0,35.09,25.82
屏東縣,三地門鄉,馬兒村,101,69,32,0,101,341,0,29.62,20.23
屏東縣,三地門鄉,安坡村,157,116,41,1,158,468,0,33.76,24.79
屏東縣,三地門鄉,青山村,199,165,34,5,204,694,0,29.39,23.78
屏東縣,三地門鄉,青葉村,166,133,33,2,168,617,0,27.23,21.56
屏東縣,三地門鄉,合計,1936,1490,446,37,1973,6401,7691,30.82,23.28
屏東縣,霧臺鄉,霧台村,351,238,113,0,351,1089,0,32.23,21.85
屏東縣,霧臺鄉,阿禮村,107,90,17,0,107,297,0,36.03,30.3
屏東縣,霧臺鄉,吉露村,72,53,19,0,72,183,0,39.34,28.96
屏東縣,霧臺鄉,大武村,67,39,28,1,68,441,0,15.42,8.84
屏東縣,霧臺鄉,佳暮村,149,125,24,2,151,356,0,42.42,35.11
屏東縣,霧臺鄉,好茶村,184,114,70,3,187,476,0,39.29,23.95
屏東縣,霧臺鄉,合計,930,659,271,6,936,2842,3230,32.93,23.19
屏東縣,瑪家鄉,瑪家村,160,119,41,2,162,443,0,36.57,26.86
屏東縣,瑪家鄉,北葉村,311,244,67,2,313,771,0,40.6,31.65
屏東縣,瑪家鄉,凉山村,283,226,57,0,283,1041,0,27.19,21.71
屏東縣,瑪家鄉,佳義村,305,209,96,5,310,887,0,34.95,23.56
屏東縣,瑪家鄉,排灣村,133,107,26,2,135,419,0,32.22,25.54
屏東縣,瑪家鄉,三和村,781,641,140,8,789,2049,0,38.51,31.28
屏東縣,瑪家鄉,合計,1973,1546,427,19,1992,5610,6706,35.51,27.56
屏東縣,泰武鄉,佳平村,322,276,46,5,327,844,0,38.74,32.7
屏東縣,泰武鄉,武潭村,336,262,74,7,343,950,0,36.11,27.58
屏東縣,泰武鄉,平和村,211,130,81,2,213,610,0,34.92,21.31
屏東縣,泰武鄉,佳興村,116,99,17,2,118,408,0,28.92,24.26
屏東縣,泰武鄉,泰武村,205,172,33,6,211,772,0,27.33,22.28
屏東縣,泰武鄉,萬安村,255,225,30,0,255,748,0,34.09,30.08
屏東縣,泰武鄉,合計,1445,1164,281,22,1467,4332,5365,33.86,26.87
屏東縣,來義鄉,來義村,257,218,39,1,258,909,0,28.38,23.98
屏東縣,來義鄉,義林村,196,155,41,1,197,586,0,33.62,26.45
屏東縣,來義鄉,丹林村,260,224,36,2,262,709,0,36.95,31.59
屏東縣,來義鄉,古樓村,405,348,57,4,409,1112,0,36.78,31.29
屏東縣,來義鄉,文樂村,297,246,51,2,299,840,0,35.6,29.29
屏東縣,來義鄉,望嘉村,347,312,35,3,350,864,0,40.51,36.11
屏東縣,來義鄉,南和村,409,342,67,9,418,1197,0,34.92,28.57
屏東縣,來義鄉,合計,2171,1845,326,22,2193,6217,7400,35.27,29.68
屏東縣,春日鄉,春日村,192,153,39,1,193,923,0,20.91,16.58
屏東縣,春日鄉,古華村,186,135,51,3,189,685,0,27.59,19.71
屏東縣,春日鄉,士文村,57,41,16,4,61,311,0,19.61,13.18
屏東縣,春日鄉,七佳村,281,222,59,6,287,940,0,30.53,23.62
屏東縣,春日鄉,歸崇村,174,131,43,3,177,647,0,27.36,20.25
屏東縣,春日鄉,力里村,124,89,35,8,132,469,0,28.14,18.98
屏東縣,春日鄉,合計,1014,771,243,25,1039,3975,4912,26.14,19.4
屏東縣,獅子鄉,楓林村,225,178,47,1,226,702,0,32.19,25.36
屏東縣,獅子鄉,丹路村,200,170,30,7,207,759,0,27.27,22.4
屏東縣,獅子鄉,草埔村,213,189,24,4,217,626,0,34.66,30.19
屏東縣,獅子鄉,內文村,72,61,11,1,73,229,0,31.88,26.64
屏東縣,獅子鄉,竹坑村,93,72,21,5,98,293,0,33.45,24.57
屏東縣,獅子鄉,獅子村,146,121,25,1,147,490,0,30.0,24.69
屏東縣,獅子鄉,內獅村,220,186,34,5,225,624,0,36.06,29.81
屏東縣,獅子鄉,南世村,111,92,19,4,115,369,0,31.17,24.93
屏東縣,獅子鄉,合計,1280,1069,211,28,1308,4092,4805,31.96,26.12
屏東縣,牡丹鄉,石門村,502,407,95,4,506,1579,0,32.05,25.78
屏東縣,牡丹鄉,牡丹村,221,194,27,8,229,645,0,35.5,30.08
屏東縣,牡丹鄉,東源村,148,126,22,2,150,435,0,34.48,28.97
屏東縣,牡丹鄉,旭海村,128,101,27,2,130,359,0,36.21,28.13
屏東縣,牡丹鄉,高士村,150,119,31,2,152,567,0,26.81,20.99
屏東縣,牡丹鄉,四林村,104,80,24,4,108,549,0,19.67,14.57
屏東縣,牡丹鄉,合計,1253,1027,226,22,1275,4134,4860,30.84,24.84
屏東縣,合計,合計,278186,112053,166133,3104,281290,700254,807970,40.17,16.0
宜蘭縣,宜蘭市,神農里,1056,562,494,8,1064,2534,0,41.99,22.18
宜蘭縣,宜蘭市,民權里,595,324,271,6,601,1744,0,34.46,18.58
宜蘭縣,宜蘭市,進士里,923,465,458,8,931,2115,0,44.02,21.99
宜蘭縣,宜蘭市,南橋里,527,236,291,3,530,1269,0,41.77,18.6
宜蘭縣,宜蘭市,建業里,843,359,484,8,851,1962,0,43.37,18.3
宜蘭縣,宜蘭市,南津里,882,495,387,8,890,2131,0,41.76,23.23
宜蘭縣,宜蘭市,凱旋里,520,220,300,6,526,1298,0,40.52,16.95
宜蘭縣,宜蘭市,黎明里,718,309,409,7,725,1846,0,39.27,16.74
宜蘭縣,宜蘭市,東村里,845,399,446,7,852,2200,0,38.73,18.14
宜蘭縣,宜蘭市,延平里,1188,590,598,15,1203,3263,0,36.87,18.08
宜蘭縣,宜蘭市,七張里,529,204,325,11,540,1459,0,37.01,13.98
宜蘭縣,宜蘭市,慈安里,606,299,307,5,611,1801,0,33.93,16.6
宜蘭縣,宜蘭市,新民里,655,255,400,4,659,1464,0,45.01,17.42
宜蘭縣,宜蘭市,東門里,401,142,259,1,402,951,0,42.27,14.93
宜蘭縣,宜蘭市,小東里,632,275,357,9,641,1595,0,40.19,17.24
宜蘭縣,宜蘭市,菜園里,525,252,273,2,527,1334,0,39.51,18.89
宜蘭縣,宜蘭市,孝廉里,447,163,284,3,450,1122,0,40.11,14.53
宜蘭縣,宜蘭市,新生里,941,370,571,12,953,2678,0,35.59,13.82
宜蘭縣,宜蘭市,茭白里,764,333,431,11,775,2080,0,37.26,16.01
宜蘭縣,宜蘭市,北津里,827,329,498,8,835,2200,0,37.95,14.95
宜蘭縣,宜蘭市,梅洲里,1155,428,727,8,1163,3159,0,36.82,13.55
宜蘭縣,宜蘭市,北門里,488,191,297,4,492,1112,0,44.24,17.18
宜蘭縣,宜蘭市,中山里,346,163,183,4,350,902,0,38.8,18.07
宜蘭縣,宜蘭市,西門里,739,271,468,6,745,1736,0,42.91,15.61
宜蘭縣,宜蘭市,南門里,553,255,298,4,557,1330,0,41.88,19.17
宜蘭縣,宜蘭市,負郭里,1182,566,616,7,1189,2908,0,40.89,19.46
宜蘭縣,宜蘭市,民族里,937,494,443,12,949,2157,0,44.0,22.9
宜蘭縣,宜蘭市,建軍里,646,314,332,8,654,1576,0,41.5,19.92
宜蘭縣,宜蘭市,思源里,1760,983,777,16,1776,4247,0,41.82,23.15
宜蘭縣,宜蘭市,文化里,1229,636,593,7,1236,2966,0,41.67,21.44
宜蘭縣,宜蘭市,復興里,1084,598,486,5,1089,2613,0,41.68,22.89
宜蘭縣,宜蘭市,成功里,1151,563,588,9,1160,3044,0,38.11,18.5
宜蘭縣,宜蘭市,新東里,1169,601,568,14,1183,3099,0,38.17,19.39
宜蘭縣,宜蘭市,七結里,1098,596,502,4,1102,2533,0,43.51,23.53
宜蘭縣,宜蘭市,泰山里,657,352,305,3,660,1969,0,33.52,17.88
宜蘭縣,宜蘭市,大新里,306,139,167,1,307,770,0,39.87,18.05
宜蘭縣,宜蘭市,中興里,1017,479,538,4,1021,2844,0,35.9,16.84
宜蘭縣,宜蘭市,擺厘里,1231,583,648,8,1239,2875,0,43.1,20.28
宜蘭縣,宜蘭市,合計,31172,14793,16379,266,31438,78886,95269,39.85,18.75
宜蘭縣,羅東鎮,大新里,614,255,359,11,625,1532,0,40.8,16.64
宜蘭縣,羅東鎮,東安里,1286,520,766,20,1306,3501,0,37.3,14.85
宜蘭縣,羅東鎮,新群里,1051,364,687,8,1059,2687,0,39.41,13.55
宜蘭縣,羅東鎮,羅莊里,1187,523,664,10,1197,3002,0,39.87,17.42
宜蘭縣,羅東鎮,南昌里,877,392,485,3,880,2352,0,37.41,16.67
宜蘭縣,羅東鎮,南豪里,551,233,318,6,557,1294,0,43.04,18.01
宜蘭縣,羅東鎮,成功里,628,265,363,5,633,1501,0,42.17,17.65
宜蘭縣,羅東鎮,仁德里,489,219,270,1,490,1123,0,43.63,19.5
宜蘭縣,羅東鎮,漢民里,1414,618,796,17,1431,3579,0,39.98,17.27
宜蘭縣,羅東鎮,西安里,1077,453,624,16,1093,2799,0,39.05,16.18
宜蘭縣,羅東鎮,北成里,1090,451,639,12,1102,2795,0,39.43,16.14
宜蘭縣,羅東鎮,賢文里,1387,627,760,16,1403,3502,0,40.06,17.9
宜蘭縣,羅東鎮,公正里,1130,460,670,8,1138,2641,0,43.09,17.42
宜蘭縣,羅東鎮,集祥里,368,147,221,6,374,1099,0,34.03,13.38
宜蘭縣,羅東鎮,信義里,1224,535,689,12,1236,2919,0,42.34,18.33
宜蘭縣,羅東鎮,竹林里,1156,463,693,17,1173,2844,0,41.24,16.28
宜蘭縣,羅東鎮,仁愛里,1484,606,878,12,1496,3570,0,41.9,16.97
宜蘭縣,羅東鎮,樹林里,1553,721,832,14,1567,3337,0,46.96,21.61
宜蘭縣,羅東鎮,國華里,1771,792,979,14,1785,4280,0,41.71,18.5
宜蘭縣,羅東鎮,維揚里,1243,535,708,6,1249,2960,0,42.2,18.07
宜蘭縣,羅東鎮,開明里,570,219,351,6,576,1355,0,42.51,16.16
宜蘭縣,羅東鎮,中山里,535,173,362,4,539,1343,0,40.13,12.88
宜蘭縣,羅東鎮,仁和里,382,143,239,3,385,978,0,39.37,14.62
宜蘭縣,羅東鎮,合計,23067,9714,13353,227,23294,56993,71097,40.87,17.04
宜蘭縣,蘇澳鎮,龍德里,1199,445,754,20,1219,3347,0,36.42,13.3
宜蘭縣,蘇澳鎮,頂寮里,383,125,258,2,385,1020,0,37.75,12.25
宜蘭縣,蘇澳鎮,永榮里,1382,518,864,11,1393,3753,0,37.12,13.8
宜蘭縣,蘇澳鎮,存仁里,345,112,233,7,352,861,0,40.88,13.01
宜蘭縣,蘇澳鎮,港邊里,495,176,319,11,506,1218,0,41.54,14.45
宜蘭縣,蘇澳鎮,隘丁里,1152,457,695,10,1162,3062,0,37.95,14.92
宜蘭縣,蘇澳鎮,新城里,574,218,356,11,585,1452,0,40.29,15.01
宜蘭縣,蘇澳鎮,聖湖里,795,416,379,8,803,2219,0,36.19,18.75
宜蘭縣,蘇澳鎮,蘇西里,882,397,485,11,893,2348,0,38.03,16.91
宜蘭縣,蘇澳鎮,蘇北里,379,194,185,4,383,953,0,40.19,20.36
宜蘭縣,蘇澳鎮,蘇南里,217,92,125,0,217,437,0,49.66,21.05
宜蘭縣,蘇澳鎮,蘇東里,166,82,84,1,167,499,0,33.47,16.43
宜蘭縣,蘇澳鎮,長安里,183,78,105,2,185,521,0,35.51,14.97
宜蘭縣,蘇澳鎮,永光里,184,102,82,1,185,431,0,42.92,23.67
宜蘭縣,蘇澳鎮,永春里,193,80,113,1,194,573,0,33.86,13.96
宜蘭縣,蘇澳鎮,永樂里,149,63,86,4,153,439,0,34.85,14.35
宜蘭縣,蘇澳鎮,南安里,332,148,184,2,334,909,0,36.74,16.28
宜蘭縣,蘇澳鎮,南正里,335,111,224,0,335,893,0,37.51,12.43
宜蘭縣,蘇澳鎮,南成里,330,123,207,7,337,1052,0,32.03,11.69
宜蘭縣,蘇澳鎮,南興里,427,192,235,11,438,1414,0,30.98,13.58
宜蘭縣,蘇澳鎮,南寧里,345,147,198,6,351,1011,0,34.72,14.54
宜蘭縣,蘇澳鎮,南建里,402,138,264,6,408,1165,0,35.02,11.85
宜蘭縣,蘇澳鎮,東澳里,88,46,42,3,91,330,0,27.58,13.94
宜蘭縣,蘇澳鎮,南強里,223,70,153,3,226,691,0,32.71,10.13
宜蘭縣,蘇澳鎮,朝陽里,214,62,152,2,216,584,0,36.99,10.62
宜蘭縣,蘇澳鎮,聖愛里,917,398,519,8,925,2734,0,33.83,14.56
宜蘭縣,蘇澳鎮,合計,12291,4990,7301,152,12443,33916,38592,36.69,14.71
宜蘭縣,頭城鎮,石城里,80,29,51,1,81,304,0,26.64,9.54
宜蘭縣,頭城鎮,大里里,193,93,100,3,196,676,0,28.99,13.76
宜蘭縣,頭城鎮,大溪里,260,100,160,7,267,874,0,30.55,11.44
宜蘭縣,頭城鎮,合興里,86,37,49,0,86,345,0,24.93,10.72
宜蘭縣,頭城鎮,更新里,348,154,194,14,362,1352,0,26.78,11.39
宜蘭縣,頭城鎮,外澳里,242,117,125,1,243,862,0,28.19,13.57
宜蘭縣,頭城鎮,港口里,215,90,125,2,217,678,0,32.01,13.27
宜蘭縣,頭城鎮,武營里,568,309,259,5,573,1576,0,36.36,19.61
宜蘭縣,頭城鎮,大坑里,475,220,255,7,482,1356,0,35.55,16.22
宜蘭縣,頭城鎮,城東里,303,158,145,4,307,710,0,43.24,22.25
宜蘭縣,頭城鎮,城北里,200,124,76,0,200,488,0,40.98,25.41
宜蘭縣,頭城鎮,城西里,195,95,100,0,195,533,0,36.59,17.82
宜蘭縣,頭城鎮,城南里,265,141,124,2,267,645,0,41.4,21.86
宜蘭縣,頭城鎮,竹安里,571,257,314,11,582,2076,0,28.03,12.38
宜蘭縣,頭城鎮,新建里,702,338,364,6,708,2044,0,34.64,16.54
宜蘭縣,頭城鎮,拔雅里,716,350,366,10,726,2076,0,34.97,16.86
宜蘭縣,頭城鎮,福成里,292,131,161,7,299,931,0,32.12,14.07
宜蘭縣,頭城鎮,金面里,591,295,296,7,598,1711,0,34.95,17.24
宜蘭縣,頭城鎮,金盈里,225,110,115,2,227,692,0,32.8,15.9
宜蘭縣,頭城鎮,頂埔里,488,233,255,5,493,1301,0,37.89,17.91
宜蘭縣,頭城鎮,下埔里,308,124,184,3,311,909,0,34.21,13.64
宜蘭縣,頭城鎮,中崙里,311,138,173,2,313,1008,0,31.05,13.69
宜蘭縣,頭城鎮,二城里,339,149,190,7,346,1090,0,31.74,13.67
宜蘭縣,頭城鎮,龜山里,227,104,123,3,230,705,0,32.62,14.75
宜蘭縣,頭城鎮,合計,8200,3896,4304,109,8309,24942,28673,33.31,15.62
宜蘭縣,礁溪鄉,白雲村,528,216,312,5,533,1601,0,33.29,13.49
宜蘭縣,礁溪鄉,玉石村,705,315,390,8,713,1954,0,36.49,16.12
宜蘭縣,礁溪鄉,德陽村,1494,803,691,13,1507,3987,0,37.8,20.14
宜蘭縣,礁溪鄉,大忠村,922,457,465,12,934,2517,0,37.11,18.16
宜蘭縣,礁溪鄉,大義村,228,95,133,4,232,620,0,37.42,15.32
宜蘭縣,礁溪鄉,六結村,573,273,300,9,582,1372,0,42.42,19.9
宜蘭縣,礁溪鄉,二龍村,446,159,287,2,448,1198,0,37.4,13.27
宜蘭縣,礁溪鄉,時潮村,521,159,362,9,530,1460,0,36.3,10.89
宜蘭縣,礁溪鄉,玉田村,829,273,556,8,837,2114,0,39.59,12.91
宜蘭縣,礁溪鄉,三民村,841,323,518,13,854,2406,0,35.49,13.42
宜蘭縣,礁溪鄉,林美村,343,117,226,3,346,1132,0,30.57,10.34
宜蘭縣,礁溪鄉,白鵝村,293,119,174,4,297,830,0,35.78,14.34
宜蘭縣,礁溪鄉,玉光村,423,165,258,3,426,1059,0,40.23,15.58
宜蘭縣,礁溪鄉,光武村,476,173,303,7,483,1359,0,35.54,12.73
宜蘭縣,礁溪鄉,吳沙村,1034,390,644,8,1042,2526,0,41.25,15.44
宜蘭縣,礁溪鄉,龍潭村,1223,428,795,13,1236,3316,0,37.27,12.91
宜蘭縣,礁溪鄉,匏崙村,327,141,186,3,330,921,0,35.83,15.31
宜蘭縣,礁溪鄉,二結村,178,47,131,3,181,422,0,42.89,11.14
宜蘭縣,礁溪鄉,合計,11384,4653,6731,127,11511,30794,35091,37.38,15.11
宜蘭縣,壯圍鄉,吉祥村,977,394,583,9,986,2606,0,37.84,15.12
宜蘭縣,壯圍鄉,美福村,692,299,393,5,697,1928,0,36.15,15.51
宜蘭縣,壯圍鄉,新南村,367,138,229,4,371,931,0,39.85,14.82
宜蘭縣,壯圍鄉,東港村,281,86,195,2,283,979,0,28.91,8.78
宜蘭縣,壯圍鄉,復興村,518,161,357,7,525,1599,0,32.83,10.07
宜蘭縣,壯圍鄉,過嶺村,481,170,311,9,490,1492,0,32.84,11.39
宜蘭縣,壯圍鄉,永鎮村,302,92,210,5,307,792,0,38.76,11.62
宜蘭縣,壯圍鄉,忠孝村,877,318,559,9,886,2369,0,37.4,13.42
宜蘭縣,壯圍鄉,古亭村,591,229,362,4,595,1580,0,37.66,14.49
宜蘭縣,壯圍鄉,功勞村,501,180,321,5,506,1240,0,40.81,14.52
宜蘭縣,壯圍鄉,美城村,851,342,509,9,860,2246,0,38.29,15.23
宜蘭縣,壯圍鄉,新社村,379,136,243,9,388,1058,0,36.67,12.85
宜蘭縣,壯圍鄉,大福村,558,250,308,9,567,1756,0,32.29,14.24
宜蘭縣,壯圍鄉,古結村,419,159,260,3,422,1124,0,37.54,14.15
宜蘭縣,壯圍鄉,合計,7794,2954,4840,89,7883,21700,24419,36.33,13.61
宜蘭縣,員山鄉,員山村,2133,961,1172,31,2164,5810,0,37.25,16.54
宜蘭縣,員山鄉,尚德村,753,314,439,13,766,2164,0,35.4,14.51
宜蘭縣,員山鄉,惠好村,671,237,434,8,679,1676,0,40.51,14.14
宜蘭縣,員山鄉,七賢村,556,253,303,2,558,1505,0,37.08,16.81
宜蘭縣,員山鄉,深溝村,772,313,459,6,778,1941,0,40.08,16.13
宜蘭縣,員山鄉,蓁巷村,442,144,298,5,447,1249,0,35.79,11.53
宜蘭縣,員山鄉,內城村,450,202,248,11,461,1436,0,32.1,14.07
宜蘭縣,員山鄉,中華村,226,75,151,4,230,608,0,37.83,12.34
宜蘭縣,員山鄉,永和村,656,242,414,5,661,1818,0,36.36,13.31
宜蘭縣,員山鄉,頭分村,471,198,273,7,478,1340,0,35.67,14.78
宜蘭縣,員山鄉,枕山村,870,254,616,5,875,2277,0,38.43,11.16
宜蘭縣,員山鄉,同樂村,885,310,575,13,898,2403,0,37.37,12.9
宜蘭縣,員山鄉,湖東村,304,121,183,5,309,888,0,34.8,13.63
宜蘭縣,員山鄉,逸仙村,340,117,223,5,345,926,0,37.26,12.63
宜蘭縣,員山鄉,湖北村,349,132,217,5,354,997,0,35.51,13.24
宜蘭縣,員山鄉,湖西村,439,142,297,14,453,1363,0,33.24,10.42
宜蘭縣,員山鄉,合計,10317,4015,6302,139,10456,28401,32189,36.82,14.14
宜蘭縣,冬山鄉,武淵村,469,128,341,4,473,1262,0,37.48,10.14
宜蘭縣,冬山鄉,珍珠村,695,227,468,10,705,1625,0,43.38,13.97
宜蘭縣,冬山鄉,補城村,453,177,276,5,458,1136,0,40.32,15.58
宜蘭縣,冬山鄉,三奇村,321,114,207,1,322,894,0,36.02,12.75
宜蘭縣,冬山鄉,大興村,345,90,255,10,355,867,0,40.95,10.38
宜蘭縣,冬山鄉,東城村,543,189,354,7,550,1409,0,39.03,13.41
宜蘭縣,冬山鄉,香和村,1093,398,695,12,1105,2951,0,37.44,13.49
宜蘭縣,冬山鄉,南興村,1172,435,737,11,1183,2943,0,40.2,14.78
宜蘭縣,冬山鄉,冬山村,314,122,192,6,320,673,0,47.55,18.13
宜蘭縣,冬山鄉,安平村,281,70,211,3,284,709,0,40.06,9.87
宜蘭縣,冬山鄉,太和村,649,221,428,6,655,1498,0,43.72,14.75
宜蘭縣,冬山鄉,八寶村,358,125,233,3,361,870,0,41.49,14.37
宜蘭縣,冬山鄉,丸山村,545,163,382,5,550,1512,0,36.38,10.78
宜蘭縣,冬山鄉,中山村,207,59,148,1,208,474,0,43.88,12.45
宜蘭縣,冬山鄉,順安村,1831,649,1182,19,1850,4962,0,37.28,13.08
宜蘭縣,冬山鄉,永美村,1196,421,775,9,1205,3096,0,38.92,13.6
宜蘭縣,冬山鄉,群英村,1897,714,1183,26,1923,4619,0,41.63,15.46
宜蘭縣,冬山鄉,清溝村,1522,612,910,15,1537,3769,0,40.78,16.24
宜蘭縣,冬山鄉,鹿埔村,880,271,609,14,894,2557,0,34.96,10.6
宜蘭縣,冬山鄉,得安村,369,165,204,2,371,1080,0,34.35,15.28
宜蘭縣,冬山鄉,廣興村,925,338,587,12,937,2509,0,37.35,13.47
宜蘭縣,冬山鄉,廣安村,693,286,407,5,698,1680,0,41.55,17.02
宜蘭縣,冬山鄉,柯林村,751,287,464,3,754,1761,0,42.82,16.3
宜蘭縣,冬山鄉,大進村,309,101,208,4,313,780,0,40.13,12.95
宜蘭縣,冬山鄉,合計,17818,6362,11456,193,18011,45636,52999,39.47,13.94
宜蘭縣,五結鄉,三興村,803,253,550,7,810,2052,0,39.47,12.33
宜蘭縣,五結鄉,二結村,784,343,441,11,795,1872,0,42.47,18.32
宜蘭縣,五結鄉,鎮安村,1083,407,676,18,1101,2629,0,41.88,15.48
宜蘭縣,五結鄉,上四村,662,267,395,4,666,1563,0,42.61,17.08
宜蘭縣,五結鄉,中興村,500,179,321,4,504,1350,0,37.33,13.26
宜蘭縣,五結鄉,四結村,1112,458,654,8,1120,2551,0,43.9,17.95
宜蘭縣,五結鄉,福興村,738,275,463,8,746,1777,0,41.98,15.48
宜蘭縣,五結鄉,五結村,1349,550,799,11,1360,3725,0,36.51,14.77
宜蘭縣,五結鄉,大吉村,1439,586,853,9,1448,3727,0,38.85,15.72
宜蘭縣,五結鄉,協和村,1207,433,774,17,1224,3260,0,37.55,13.28
宜蘭縣,五結鄉,孝威村,638,194,444,5,643,1654,0,38.88,11.73
宜蘭縣,五結鄉,錦眾村,550,188,362,7,557,1417,0,39.31,13.27
宜蘭縣,五結鄉,利澤村,672,222,450,11,683,1951,0,35.01,11.38
宜蘭縣,五結鄉,成興村,1146,353,793,9,1155,3177,0,36.36,11.11
宜蘭縣,五結鄉,季新村,999,337,662,7,1006,2761,0,36.44,12.21
宜蘭縣,五結鄉,合計,13682,5045,8637,136,13818,35466,40343,38.96,14.22
宜蘭縣,三星鄉,員山村,82,36,46,1,83,207,0,40.1,17.39
宜蘭縣,三星鄉,天山村,146,59,87,4,150,498,0,30.12,11.85
宜蘭縣,三星鄉,天福村,235,85,150,4,239,712,0,33.57,11.94
宜蘭縣,三星鄉,雙賢村,244,78,166,4,248,553,0,44.85,14.1
宜蘭縣,三星鄉,人和村,157,74,83,2,159,448,0,35.49,16.52
宜蘭縣,三星鄉,義德村,406,185,221,2,408,1133,0,36.01,16.33
宜蘭縣,三星鄉,集慶村,427,180,247,7,434,1145,0,37.9,15.72
宜蘭縣,三星鄉,月眉村,307,137,170,3,310,870,0,35.63,15.75
宜蘭縣,三星鄉,拱照村,395,140,255,2,397,1358,0,29.23,10.31
宜蘭縣,三星鄉,大隱村,1539,580,959,12,1551,4328,0,35.84,13.4
宜蘭縣,三星鄉,行健村,332,108,224,5,337,890,0,37.87,12.13
宜蘭縣,三星鄉,萬德村,236,79,157,5,241,586,0,41.13,13.48
宜蘭縣,三星鄉,貴林村,188,83,105,4,192,525,0,36.57,15.81
宜蘭縣,三星鄉,萬富村,282,107,175,3,285,731,0,38.99,14.64
宜蘭縣,三星鄉,大義村,520,168,352,5,525,1266,0,41.47,13.27
宜蘭縣,三星鄉,尚武村,289,118,171,1,290,758,0,38.26,15.57
宜蘭縣,三星鄉,大洲村,746,243,503,8,754,1581,0,47.69,15.37
宜蘭縣,三星鄉,尾塹村,605,197,408,7,612,1458,0,41.98,13.51
宜蘭縣,三星鄉,合計,7136,2657,4479,79,7215,19047,21219,37.88,13.95
宜蘭縣,大同鄉,寒溪村,288,250,38,2,290,923,0,31.42,27.09
宜蘭縣,大同鄉,崙埤村,185,171,14,4,189,629,0,30.05,27.19
宜蘭縣,大同鄉,松羅村,202,146,56,2,204,701,0,29.1,20.83
宜蘭縣,大同鄉,復興村,100,55,45,0,100,262,0,38.17,20.99
宜蘭縣,大同鄉,英士村,97,76,21,2,99,325,0,30.46,23.38
宜蘭縣,大同鄉,樂水村,111,101,10,2,113,392,0,28.83,25.77
宜蘭縣,大同鄉,太平村,18,12,6,0,18,54,0,33.33,22.22
宜蘭縣,大同鄉,四季村,185,160,25,3,188,763,0,24.64,20.97
宜蘭縣,大同鄉,南山村,125,94,31,3,128,659,0,19.42,14.26
宜蘭縣,大同鄉,茂安村,58,47,11,0,58,207,0,28.02,22.71
宜蘭縣,大同鄉,合計,1369,1112,257,18,1387,4915,6099,28.22,22.62
宜蘭縣,南澳鄉,南澳村,301,262,39,4,305,1156,0,26.38,22.66
宜蘭縣,南澳鄉,碧候村,234,205,29,5,239,955,0,25.03,21.47
宜蘭縣,南澳鄉,東岳村,152,134,18,1,153,435,0,35.17,30.8
宜蘭縣,南澳鄉,金岳村,86,80,6,2,88,406,0,21.67,19.7
宜蘭縣,南澳鄉,武塔村,131,106,25,2,133,430,0,30.93,24.65
宜蘭縣,南澳鄉,金洋村,127,106,21,0,127,475,0,26.74,22.32
宜蘭縣,南澳鄉,澳花村,230,208,22,6,236,707,0,33.38,29.42
宜蘭縣,南澳鄉,合計,1261,1101,160,20,1281,4564,5956,28.07,24.12
宜蘭縣,合計,合計,145491,61292,84199,1555,147046,385260,451946,38.17,15.91
花蓮縣,花蓮市,民立里,621,411,210,5,626,1592,0,39.32,25.82
花蓮縣,花蓮市,民運里,831,562,269,8,839,1985,0,42.27,28.31
花蓮縣,花蓮市,民族里,169,105,64,0,169,422,0,40.05,24.88
花蓮縣,花蓮市,主信里,273,170,103,2,275,664,0,41.42,25.6
花蓮縣,花蓮市,主睦里,205,121,84,1,206,558,0,36.92,21.68
花蓮縣,花蓮市,主和里,1091,699,392,13,1104,2927,0,37.72,23.88
花蓮縣,花蓮市,國威里,576,341,235,7,583,1769,0,32.96,19.28
花蓮縣,花蓮市,國風里,1251,833,418,10,1261,3186,0,39.58,26.15
花蓮縣,花蓮市,民德里,655,444,211,4,659,1486,0,44.35,29.88
花蓮縣,花蓮市,民意里,804,669,135,15,819,2020,0,40.54,33.12
花蓮縣,花蓮市,主義里,197,131,66,1,198,464,0,42.67,28.23
花蓮縣,花蓮市,主工里,227,130,97,1,228,492,0,46.34,26.42
花蓮縣,花蓮市,主農里,1332,877,455,11,1343,3477,0,38.63,25.22
花蓮縣,花蓮市,國治里,304,183,121,1,305,821,0,37.15,22.29
花蓮縣,花蓮市,國富里,1955,1311,644,22,1977,4822,0,41.0,27.19
花蓮縣,花蓮市,民政里,1535,1091,444,13,1548,3629,0,42.66,30.06
花蓮縣,花蓮市,民勤里,1251,908,343,18,1269,3092,0,41.04,29.37
花蓮縣,花蓮市,民生里,424,244,180,6,430,1077,0,39.93,22.66
花蓮縣,花蓮市,主商里,216,114,102,0,216,537,0,40.22,21.23
花蓮縣,花蓮市,主學里,718,467,251,5,723,1821,0,39.7,25.65
花蓮縣,花蓮市,國光里,465,322,143,6,471,1214,0,38.8,26.52
花蓮縣,花蓮市,國聯里,1022,647,375,5,1027,2759,0,37.22,23.45
花蓮縣,花蓮市,國強里,640,419,221,6,646,1757,0,36.77,23.85
花蓮縣,花蓮市,民心里,377,262,115,6,383,932,0,41.09,28.11
花蓮縣,花蓮市,民樂里,239,164,75,1,240,616,0,38.96,26.62
花蓮縣,花蓮市,民主里,209,153,56,0,209,549,0,38.07,27.87
花蓮縣,花蓮市,主勤里,333,200,133,2,335,763,0,43.91,26.21
花蓮縣,花蓮市,主力里,1045,651,394,10,1055,2643,0,39.92,24.63
花蓮縣,花蓮市,國安里,198,136,62,2,200,496,0,40.32,27.42
花蓮縣,花蓮市,國魂里,776,501,275,11,787,1849,0,42.56,27.1
花蓮縣,花蓮市,國慶里,405,232,173,4,409,1069,0,38.26,21.7
花蓮縣,花蓮市,民享里,1219,909,310,10,1229,3012,0,40.8,30.18
花蓮縣,花蓮市,民有里,221,132,89,1,222,584,0,38.01,22.6
花蓮縣,花蓮市,民權里,173,124,49,0,173,419,0,41.29,29.59
花蓮縣,花蓮市,主計里,303,192,111,1,304,817,0,37.21,23.5
花蓮縣,花蓮市,主權里,1976,1333,643,22,1998,5198,0,38.44,25.64
花蓮縣,花蓮市,國華里,869,544,325,6,875,2120,0,41.27,25.66
花蓮縣,花蓮市,國防里,317,191,126,0,317,816,0,38.85,23.41
花蓮縣,花蓮市,國福里,466,331,135,4,470,1480,0,31.76,22.36
花蓮縣,花蓮市,國裕里,1616,1136,480,12,1628,4171,0,39.03,27.24
花蓮縣,花蓮市,主安里,855,577,278,11,866,2412,0,35.9,23.92
花蓮縣,花蓮市,國盛里,1237,822,415,8,1245,3671,0,33.91,22.39
花蓮縣,花蓮市,國興里,1685,1189,496,14,1699,4204,0,40.41,28.28
花蓮縣,花蓮市,民孝里,1405,1041,364,17,1422,3438,0,41.36,30.28
花蓮縣,花蓮市,合計,32686,22019,10667,302,32988,83830,101853,39.35,26.27
花蓮縣,鳳林鎮,鳳仁里,437,315,122,7,444,1166,0,38.08,27.02
花蓮縣,鳳林鎮,鳳義里,262,211,51,4,266,631,0,42.16,33.44
花蓮縣,鳳林鎮,鳳禮里,260,178,82,3,263,575,0,45.74,30.96
花蓮縣,鳳林鎮,鳳智里,407,319,88,5,412,1075,0,38.33,29.67
花蓮縣,鳳林鎮,鳳信里,468,361,107,9,477,1332,0,35.81,27.1
花蓮縣,鳳林鎮,山興里,168,131,37,7,175,539,0,32.47,24.3
花蓮縣,鳳林鎮,大榮里,459,302,157,4,463,1250,0,37.04,24.16
花蓮縣,鳳林鎮,北林里,203,110,93,5,208,538,0,38.66,20.45
花蓮縣,鳳林鎮,南平里,210,138,72,1,211,524,0,40.27,26.34
花蓮縣,鳳林鎮,林榮里,334,233,101,8,342,793,0,43.13,29.38
花蓮縣,鳳林鎮,長橋里,318,212,106,10,328,959,0,34.2,22.11
花蓮縣,鳳林鎮,森榮里,44,37,7,0,44,97,0,45.36,38.14
花蓮縣,鳳林鎮,合計,3570,2547,1023,63,3633,9479,10764,38.33,26.87
花蓮縣,玉里鎮,中城里,1747,1190,557,15,1762,5047,0,34.91,23.58
花蓮縣,玉里鎮,啟模里,473,349,124,9,482,1587,0,30.37,21.99
花蓮縣,玉里鎮,永昌里,335,236,99,5,340,1191,0,28.55,19.82
花蓮縣,玉里鎮,泰昌里,338,250,88,1,339,1281,0,26.46,19.52
花蓮縣,玉里鎮,國武里,448,286,162,3,451,1150,0,39.22,24.87
花蓮縣,玉里鎮,源城里,313,226,87,5,318,1204,0,26.41,18.77
花蓮縣,玉里鎮,長良里,147,114,33,5,152,606,0,25.08,18.81
花蓮縣,玉里鎮,樂合里,282,227,55,5,287,963,0,29.8,23.57
花蓮縣,玉里鎮,東豐里,154,117,37,2,156,521,0,29.94,22.46
花蓮縣,玉里鎮,觀音里,403,305,98,7,410,1500,0,27.33,20.33
花蓮縣,玉里鎮,松浦里,302,227,75,14,316,1449,0,21.81,15.67
花蓮縣,玉里鎮,春日里,249,181,68,13,262,838,0,31.26,21.6
花蓮縣,玉里鎮,德武里,204,161,43,8,212,750,0,28.27,21.47
花蓮縣,玉里鎮,三民里,243,158,85,3,246,864,0,28.47,18.29
花蓮縣,玉里鎮,大禹里,282,211,71,3,285,1039,0,27.43,20.31
花蓮縣,玉里鎮,合計,5920,4238,1682,98,6018,19990,23121,30.11,21.2
花蓮縣,新城鄉,新城村,502,314,188,9,511,1249,0,40.91,25.14
花蓮縣,新城鄉,順安村,304,140,164,14,318,901,0,35.29,15.54
花蓮縣,新城鄉,康樂村,804,565,239,14,818,2413,0,33.9,23.41
花蓮縣,新城鄉,北埔村,1438,1038,400,19,1457,4113,0,35.42,25.24
花蓮縣,新城鄉,佳林村,370,247,123,2,372,992,0,37.5,24.9
花蓮縣,新城鄉,嘉里村,1240,930,310,20,1260,3787,0,33.27,24.56
花蓮縣,新城鄉,嘉新村,391,308,83,7,398,1243,0,32.02,24.78
花蓮縣,新城鄉,大漢村,878,691,187,20,898,2511,0,35.76,27.52
花蓮縣,新城鄉,合計,5927,4233,1694,105,6032,17209,20015,35.05,24.6
花蓮縣,吉安鄉,北昌村,2909,1911,998,25,2934,7104,0,41.3,26.9
花蓮縣,吉安鄉,勝安村,2018,1308,710,11,2029,4909,0,41.33,26.64
花蓮縣,吉安鄉,太昌村,1270,796,474,31,1301,3726,0,34.92,21.36
花蓮縣,吉安鄉,永安村,1637,1115,522,16,1653,4253,0,38.87,26.22
花蓮縣,吉安鄉,慶豐村,2600,1770,830,27,2627,6951,0,37.79,25.46
花蓮縣,吉安鄉,吉安村,2022,1397,625,21,2043,5283,0,38.67,26.44
花蓮縣,吉安鄉,福興村,1174,760,414,19,1193,2931,0,40.7,25.93
花蓮縣,吉安鄉,南華村,602,358,244,12,614,1568,0,39.16,22.83
花蓮縣,吉安鄉,干城村,415,318,97,4,419,1280,0,32.73,24.84
花蓮縣,吉安鄉,永興村,1009,740,269,9,1018,2922,0,34.84,25.33
花蓮縣,吉安鄉,稻香村,1217,845,372,13,1230,3170,0,38.8,26.66
花蓮縣,吉安鄉,南昌村,1475,1058,417,10,1485,4138,0,35.89,25.57
花蓮縣,吉安鄉,宜昌村,1515,1022,493,10,1525,3933,0,38.77,25.99
花蓮縣,吉安鄉,仁里村,2293,1611,682,20,2313,5995,0,38.58,26.87
花蓮縣,吉安鄉,東昌村,2011,1458,553,28,2039,5503,0,37.05,26.49
花蓮縣,吉安鄉,仁安村,732,488,244,11,743,2360,0,31.48,20.68
花蓮縣,吉安鄉,仁和村,1514,1034,480,8,1522,4520,0,33.67,22.88
花蓮縣,吉安鄉,光華村,753,592,161,14,767,1987,0,38.6,29.79
花蓮縣,吉安鄉,合計,27166,18581,8585,289,27455,72533,83515,37.85,25.62
花蓮縣,壽豐鄉,樹湖村,137,92,45,2,139,352,0,39.49,26.14
花蓮縣,壽豐鄉,溪口村,383,256,127,8,391,1019,0,38.37,25.12
花蓮縣,壽豐鄉,豐山村,651,440,211,13,664,1879,0,35.34,23.42
花蓮縣,壽豐鄉,豐裡村,472,314,158,5,477,1317,0,36.22,23.84
花蓮縣,壽豐鄉,豐坪村,296,212,84,3,299,900,0,33.22,23.56
花蓮縣,壽豐鄉,共和村,318,225,93,1,319,729,0,43.76,30.86
花蓮縣,壽豐鄉,壽豐村,574,393,181,11,585,1627,0,35.96,24.15
花蓮縣,壽豐鄉,光榮村,285,235,50,3,288,772,0,37.31,30.44
花蓮縣,壽豐鄉,池南村,297,201,96,5,302,747,0,40.43,26.91
花蓮縣,壽豐鄉,平和村,528,314,214,12,540,1402,0,38.52,22.4
花蓮縣,壽豐鄉,志學村,934,568,366,7,941,2522,0,37.31,22.52
花蓮縣,壽豐鄉,米棧村,110,81,29,4,114,259,0,44.02,31.27
花蓮縣,壽豐鄉,月眉村,269,218,51,1,270,816,0,33.09,26.72
花蓮縣,壽豐鄉,水璉村,231,173,58,6,237,700,0,33.86,24.71
花蓮縣,壽豐鄉,鹽寮村,167,114,53,1,168,503,0,33.4,22.66
花蓮縣,壽豐鄉,合計,5652,3836,1816,82,5734,15544,17427,36.89,24.68
花蓮縣,光復鄉,大安村,319,213,106,2,321,809,0,39.68,26.33
花蓮縣,光復鄉,大華村,415,258,157,11,426,1258,0,33.86,20.51
花蓮縣,光復鄉,大平村,272,211,61,11,283,918,0,30.83,22.98
花蓮縣,光復鄉,大馬村,253,211,42,5,258,970,0,26.6,21.75
花蓮縣,光復鄉,大同村,351,254,97,6,357,1018,0,35.07,24.95
花蓮縣,光復鄉,大進村,178,133,45,2,180,435,0,41.38,30.57
花蓮縣,光復鄉,大全村,226,150,76,5,231,765,0,30.2,19.61
花蓮縣,光復鄉,大興村,160,129,31,0,160,454,0,35.24,28.41
花蓮縣,光復鄉,大富村,106,65,41,1,107,302,0,35.43,21.52
花蓮縣,光復鄉,大豐村,141,95,46,6,147,409,0,35.94,23.23
花蓮縣,光復鄉,東富村,291,250,41,9,300,990,0,30.3,25.25
花蓮縣,光復鄉,西富村,310,238,72,8,318,928,0,34.27,25.65
花蓮縣,光復鄉,南富村,253,182,71,10,263,820,0,32.07,22.2
花蓮縣,光復鄉,北富村,257,215,42,3,260,880,0,29.55,24.43
花蓮縣,光復鄉,合計,3532,2604,928,79,3611,10956,12280,32.96,23.77
花蓮縣,豐濱鄉,豐濱村,400,304,96,20,420,1596,0,26.32,19.05
花蓮縣,豐濱鄉,新社村,161,122,39,7,168,614,0,27.36,19.87
花蓮縣,豐濱鄉,磯崎村,119,99,20,1,120,390,0,30.77,25.38
花蓮縣,豐濱鄉,港口村,224,157,67,11,235,721,0,32.59,21.78
花蓮縣,豐濱鄉,靜浦村,180,158,22,8,188,645,0,29.15,24.5
花蓮縣,豐濱鄉,合計,1084,840,244,47,1131,3966,4341,28.52,21.18
花蓮縣,瑞穗鄉,瑞穗村,630,445,185,5,635,1828,0,34.74,24.34
花蓮縣,瑞穗鄉,瑞美村,641,445,196,4,645,1800,0,35.83,24.72
花蓮縣,瑞穗鄉,瑞良村,194,133,61,2,196,520,0,37.69,25.58
花蓮縣,瑞穗鄉,瑞祥村,295,193,102,2,297,923,0,32.18,20.91
花蓮縣,瑞穗鄉,瑞北村,161,124,37,6,167,580,0,28.79,21.38
花蓮縣,瑞穗鄉,舞鶴村,301,207,94,5,306,941,0,32.52,22.0
花蓮縣,瑞穗鄉,鶴岡村,248,199,49,5,253,867,0,29.18,22.95
花蓮縣,瑞穗鄉,奇美村,73,63,10,3,76,332,0,22.89,18.98
花蓮縣,瑞穗鄉,富源村,205,145,60,3,208,740,0,28.11,19.59
花蓮縣,瑞穗鄉,富民村,220,183,37,9,229,825,0,27.76,22.18
花蓮縣,瑞穗鄉,富興村,196,123,73,10,206,579,0,35.58,21.24
花蓮縣,瑞穗鄉,合計,3164,2260,904,54,3218,9935,11248,32.39,22.75
花蓮縣,富里鄉,吳江村,124,94,30,5,129,471,0,27.39,19.96
花蓮縣,富里鄉,東里村,229,145,84,8,237,970,0,24.43,14.95
花蓮縣,富里鄉,萬寧村,173,147,26,6,179,613,0,29.2,23.98
花蓮縣,富里鄉,新興村,142,105,37,7,149,573,0,26.0,18.32
花蓮縣,富里鄉,竹田村,318,244,74,2,320,1040,0,30.77,23.46
花蓮縣,富里鄉,羅山村,128,95,33,3,131,428,0,30.61,22.2
花蓮縣,富里鄉,石牌村,231,169,62,8,239,864,0,27.66,19.56
花蓮縣,富里鄉,明里村,132,93,39,2,134,368,0,36.41,25.27
花蓮縣,富里鄉,富里村,400,253,147,6,406,1306,0,31.09,19.37
花蓮縣,富里鄉,永豐村,148,107,41,3,151,442,0,34.16,24.21
花蓮縣,富里鄉,豐南村,160,134,26,9,169,597,0,28.31,22.45
花蓮縣,富里鄉,富南村,134,86,48,4,138,491,0,28.11,17.52
花蓮縣,富里鄉,學田村,194,113,81,9,203,622,0,32.64,18.17
花蓮縣,富里鄉,合計,2513,1785,728,72,2585,8785,9897,29.43,20.32
花蓮縣,秀林鄉,崇德村,380,318,62,4,384,1423,0,26.99,22.35
花蓮縣,秀林鄉,富世村,577,424,153,9,586,1842,0,31.81,23.02
花蓮縣,秀林鄉,秀林村,523,406,117,7,530,1790,0,29.61,22.68
花蓮縣,秀林鄉,水源村,386,332,54,5,391,1188,0,32.91,27.95
花蓮縣,秀林鄉,銅門村,398,347,51,8,406,1217,0,33.36,28.51
花蓮縣,秀林鄉,文蘭村,347,295,52,0,347,1126,0,30.82,26.2
花蓮縣,秀林鄉,景美村,502,381,121,7,509,1791,0,28.42,21.27
花蓮縣,秀林鄉,佳民村,354,309,45,5,359,1048,0,34.26,29.48
花蓮縣,秀林鄉,和平村,459,348,111,1,460,1541,0,29.85,22.58
花蓮縣,秀林鄉,合計,3926,3160,766,46,3972,12966,16204,30.63,24.37
花蓮縣,萬榮鄉,西林村,299,258,41,4,303,1044,0,29.02,24.71
花蓮縣,萬榮鄉,見晴村,121,107,14,0,121,515,0,23.5,20.78
花蓮縣,萬榮鄉,萬榮村,193,162,31,6,199,757,0,26.29,21.4
花蓮縣,萬榮鄉,明利村,182,160,22,2,184,639,0,28.79,25.04
花蓮縣,萬榮鄉,馬遠村,262,215,47,6,268,1075,0,24.93,20.0
花蓮縣,萬榮鄉,紅葉村,258,217,41,4,262,1050,0,24.95,20.67
花蓮縣,萬榮鄉,合計,1315,1119,196,22,1337,5080,6174,26.32,22.03
花蓮縣,卓溪鄉,崙山村,141,124,17,1,142,523,0,27.15,23.71
花蓮縣,卓溪鄉,立山村,233,207,26,9,242,969,0,24.97,21.36
花蓮縣,卓溪鄉,太平村,234,209,25,9,243,691,0,35.17,30.25
花蓮縣,卓溪鄉,卓溪村,192,170,22,2,194,721,0,26.91,23.58
花蓮縣,卓溪鄉,卓清村,232,212,20,4,236,1017,0,23.21,20.85
花蓮縣,卓溪鄉,古風村,289,251,38,4,293,897,0,32.66,27.98
花蓮縣,卓溪鄉,合計,1321,1173,148,29,1350,4818,5997,28.02,24.35
花蓮縣,合計,合計,97776,68395,29381,1288,99064,275091,322836,36.01,24.86
臺東縣,臺東市,富岡里,454,314,140,7,461,1446,0,31.88,21.72
臺東縣,臺東市,富豐里,254,156,98,7,261,865,0,30.17,18.03
臺東縣,臺東市,岩灣里,758,516,242,9,767,2210,0,34.71,23.35
臺東縣,臺東市,南王里,890,611,279,8,898,2796,0,32.12,21.85
臺東縣,臺東市,卑南里,1238,714,524,7,1245,2822,0,44.12,25.3
臺東縣,臺東市,南榮里,896,615,281,9,905,2707,0,33.43,22.72
臺東縣,臺東市,新生里,2329,1536,793,11,2340,6528,0,35.85,23.53
臺東縣,臺東市,民生里,1280,747,533,15,1295,3035,0,42.67,24.61
臺東縣,臺東市,寶桑里,299,180,119,4,303,826,0,36.68,21.79
臺東縣,臺東市,馬蘭里,951,677,274,4,955,2489,0,38.37,27.2
臺東縣,臺東市,中心里,1197,790,407,13,1210,3004,0,40.28,26.3
臺東縣,臺東市,自強里,1590,1005,585,8,1598,3981,0,40.14,25.24
臺東縣,臺東市,民族里,480,266,214,2,482,1313,0,36.71,20.26
臺東縣,臺東市,四維里,220,149,71,2,222,638,0,34.8,23.35
臺東縣,臺東市,中華里,564,317,247,5,569,1628,0,34.95,19.47
臺東縣,臺東市,強國里,215,131,84,4,219,620,0,35.32,21.13
臺東縣,臺東市,建國里,399,230,169,2,401,1215,0,33.0,18.93
臺東縣,臺東市,民權里,325,197,128,3,328,813,0,40.34,24.23
臺東縣,臺東市,仁愛里,267,146,121,2,269,683,0,39.39,21.38
臺東縣,臺東市,中正里,346,191,155,2,348,768,0,45.31,24.87
臺東縣,臺東市,大同里,272,171,101,3,275,727,0,37.83,23.52
臺東縣,臺東市,成功里,288,151,137,2,290,762,0,38.06,19.82
臺東縣,臺東市,文化里,244,143,101,1,245,941,0,26.04,15.2
臺東縣,臺東市,中山里,319,191,128,0,319,736,0,43.34,25.95
臺東縣,臺東市,復國里,177,114,63,1,178,575,0,30.96,19.83
臺東縣,臺東市,興國里,270,130,140,1,271,711,0,38.12,18.28
臺東縣,臺東市,復興里,135,80,55,1,136,400,0,34.0,20.0
臺東縣,臺東市,鐵花里,154,87,67,1,155,389,0,39.85,22.37
臺東縣,臺東市,新園里,542,355,187,11,553,1604,0,34.48,22.13
臺東縣,臺東市,豐田里,727,400,327,12,739,2224,0,33.23,17.99
臺東縣,臺東市,豐年里,965,637,328,10,975,3044,0,32.03,20.93
臺東縣,臺東市,光明里,974,665,309,6,980,2559,0,38.3,25.99
臺東縣,臺東市,豐樂里,490,317,173,2,492,1481,0,33.22,21.4
臺東縣,臺東市,永樂里,724,457,267,5,729,2117,0,34.44,21.59
臺東縣,臺東市,康樂里,390,248,142,10,400,1309,0,30.56,18.95
臺東縣,臺東市,東海里,1033,666,367,8,1041,2638,0,39.46,25.25
臺東縣,臺東市,新興里,328,187,141,2,330,940,0,35.11,19.89
臺東縣,臺東市,豐榮里,2908,1946,962,18,2926,8103,0,36.11,24.02
臺東縣,臺東市,豐谷里,1495,1033,462,13,1508,5024,0,30.02,20.56
臺東縣,臺東市,豐里里,745,428,317,9,754,2362,0,31.92,18.12
臺東縣,臺東市,豐原里,413,217,196,10,423,1214,0,34.84,17.87
臺東縣,臺東市,建和里,465,324,141,4,469,1392,0,33.69,23.28
臺東縣,臺東市,建興里,340,203,137,8,348,952,0,36.55,21.32
臺東縣,臺東市,建業里,383,238,145,5,388,1256,0,30.89,18.95
臺東縣,臺東市,知本里,458,289,169,7,465,1365,0,34.07,21.17
臺東縣,臺東市,建農里,572,433,139,13,585,1990,0,29.4,21.76
臺東縣,臺東市,合計,30763,19598,11165,287,31050,87202,104445,35.61,22.47
臺東縣,成功鎮,博愛里,204,166,38,8,212,596,0,35.57,27.85
臺東縣,成功鎮,忠孝里,231,159,72,5,236,935,0,25.24,17.01
臺東縣,成功鎮,三仙里,302,221,81,8,310,1337,0,23.19,16.53
臺東縣,成功鎮,三民里,660,516,144,14,674,2619,0,25.74,19.7
臺東縣,成功鎮,忠智里,578,407,171,6,584,1823,0,32.04,22.33
臺東縣,成功鎮,忠仁里,635,411,224,4,639,2079,0,30.74,19.77
臺東縣,成功鎮,和平里,191,141,50,2,193,725,0,26.62,19.45
臺東縣,成功鎮,信義里,497,399,98,13,510,1773,0,28.76,22.5
臺東縣,成功鎮,合計,3298,2420,878,60,3358,11887,13396,28.25,20.36
臺東縣,關山鎮,德高里,451,301,150,17,468,1682,0,27.82,17.9
臺東縣,關山鎮,豐泉里,380,267,113,2,382,1084,0,35.24,24.63
臺東縣,關山鎮,新福里,274,168,106,13,287,865,0,33.18,19.42
臺東縣,關山鎮,中福里,312,186,126,4,316,752,0,42.02,24.73
臺東縣,關山鎮,里壠里,529,386,143,2,531,1611,0,32.96,23.96
臺東縣,關山鎮,電光里,159,108,51,7,166,528,0,31.44,20.45
臺東縣,關山鎮,月眉里,190,110,80,4,194,689,0,28.16,15.97
臺東縣,關山鎮,合計,2295,1526,769,49,2344,7211,8330,32.51,21.16
臺東縣,卑南鄉,嘉豐村,132,80,52,8,140,486,0,28.81,16.46
臺東縣,卑南鄉,利吉村,155,121,34,0,155,449,0,34.52,26.95
臺東縣,卑南鄉,富山村,148,110,38,6,154,467,0,32.98,23.55
臺東縣,卑南鄉,富源村,119,57,62,1,120,333,0,36.04,17.12
臺東縣,卑南鄉,明峰村,343,190,153,3,346,1149,0,30.11,16.54
臺東縣,卑南鄉,初鹿村,363,227,136,7,370,1236,0,29.94,18.37
臺東縣,卑南鄉,美農村,359,172,187,6,365,1068,0,34.18,16.1
臺東縣,卑南鄉,賓朗村,726,411,315,10,736,2211,0,33.29,18.59
臺東縣,卑南鄉,泰安村,325,212,113,4,329,1122,0,29.32,18.89
臺東縣,卑南鄉,太平村,997,686,311,11,1008,3124,0,32.27,21.96
臺東縣,卑南鄉,利嘉村,395,292,103,13,408,1094,0,37.29,26.69
臺東縣,卑南鄉,東興村,391,331,60,9,400,1133,0,35.3,29.21
臺東縣,卑南鄉,溫泉村,346,146,200,4,350,1066,0,32.83,13.7
臺東縣,卑南鄉,合計,4799,3035,1764,82,4881,14938,16897,32.68,20.32
臺東縣,鹿野鄉,瑞和村,144,90,54,7,151,650,0,23.23,13.85
臺東縣,鹿野鄉,瑞豐村,316,131,185,7,323,871,0,37.08,15.04
臺東縣,鹿野鄉,瑞源村,220,131,89,7,227,835,0,27.19,15.69
臺東縣,鹿野鄉,永安村,426,276,150,1,427,1440,0,29.65,19.17
臺東縣,鹿野鄉,瑞隆村,216,145,71,5,221,858,0,25.76,16.9
臺東縣,鹿野鄉,鹿野村,317,233,84,10,327,1026,0,31.87,22.71
臺東縣,鹿野鄉,龍田村,368,177,191,5,373,1033,0,36.11,17.13
臺東縣,鹿野鄉,合計,2007,1183,824,42,2049,6713,7514,30.52,17.62
臺東縣,池上鄉,福文村,300,177,123,4,304,1091,0,27.86,16.22
臺東縣,池上鄉,慶豐村,214,137,77,6,220,660,0,33.33,20.76
臺東縣,池上鄉,大坡村,72,57,15,3,75,322,0,23.29,17.7
臺東縣,池上鄉,大埔村,254,168,86,4,258,773,0,33.38,21.73
臺東縣,池上鄉,福原村,662,392,270,8,670,1890,0,35.45,20.74
臺東縣,池上鄉,錦園村,96,46,50,2,98,337,0,29.08,13.65
臺東縣,池上鄉,新興村,254,143,111,4,258,832,0,31.01,17.19
臺東縣,池上鄉,萬安村,107,48,59,7,114,304,0,37.5,15.79
臺東縣,池上鄉,富興村,127,89,38,1,128,393,0,32.57,22.65
臺東縣,池上鄉,振興村,78,49,29,3,81,428,0,18.93,11.45
臺東縣,池上鄉,合計,2164,1306,858,42,2206,7030,8018,31.38,18.58
臺東縣,東河鄉,北源村,341,257,84,7,348,1544,0,22.54,16.65
臺東縣,東河鄉,泰源村,248,185,63,8,256,1127,0,22.72,16.42
臺東縣,東河鄉,東河村,265,201,64,3,268,951,0,28.18,21.14
臺東縣,東河鄉,尚德村,81,58,23,1,82,252,0,32.54,23.02
臺東縣,東河鄉,隆昌村,163,116,47,1,164,511,0,32.09,22.7
臺東縣,東河鄉,興昌村,294,179,115,2,296,886,0,33.41,20.2
臺東縣,東河鄉,都蘭村,666,439,227,19,685,2087,0,32.82,21.03
臺東縣,東河鄉,合計,2058,1435,623,41,2099,7358,8123,28.53,19.5
臺東縣,長濱鄉,樟原村,188,144,44,3,191,599,0,31.89,24.04
臺東縣,長濱鄉,三間村,331,278,53,13,344,1145,0,30.04,24.28
臺東縣,長濱鄉,忠勇村,123,78,45,6,129,519,0,24.86,15.03
臺東縣,長濱鄉,長濱村,584,401,183,10,594,1898,0,31.3,21.13
臺東縣,長濱鄉,竹湖村,259,166,93,5,264,853,0,30.95,19.46
臺東縣,長濱鄉,寧埔村,351,286,65,7,358,1154,0,31.02,24.78
臺東縣,長濱鄉,合計,1836,1353,483,44,1880,6168,6828,30.48,21.94
臺東縣,太麻里鄉,美和村,379,171,208,5,384,1297,0,29.61,13.18
臺東縣,太麻里鄉,三和村,192,97,95,5,197,589,0,33.45,16.47
臺東縣,太麻里鄉,華源村,188,90,98,4,192,588,0,32.65,15.31
臺東縣,太麻里鄉,北里村,188,104,84,2,190,564,0,33.69,18.44
臺東縣,太麻里鄉,泰和村,443,286,157,10,453,1352,0,33.51,21.15
臺東縣,太麻里鄉,大王村,575,386,189,12,587,1720,0,34.13,22.44
臺東縣,太麻里鄉,香蘭村,266,177,89,6,272,811,0,33.54,21.82
臺東縣,太麻里鄉,金崙村,427,367,60,7,434,1705,0,25.45,21.52
臺東縣,太麻里鄉,多良村,270,234,36,9,279,900,0,31.0,26.0
臺東縣,太麻里鄉,合計,2928,1912,1016,60,2988,9526,10806,31.37,20.07
臺東縣,大武鄉,大竹村,206,184,22,10,216,733,0,29.47,25.1
臺東縣,大武鄉,大鳥村,288,263,25,7,295,1061,0,27.8,24.79
臺東縣,大武鄉,大武村,345,247,98,6,351,1229,0,28.56,20.1
臺東縣,大武鄉,尚武村,337,179,158,6,343,1341,0,25.58,13.35
臺東縣,大武鄉,南興村,170,136,34,4,174,528,0,32.95,25.76
臺東縣,大武鄉,合計,1346,1009,337,33,1379,4892,5663,28.19,20.63
臺東縣,綠島鄉,公舘村,197,156,41,5,202,986,0,20.49,15.82
臺東縣,綠島鄉,中寮村,171,128,43,1,172,1038,0,16.57,12.33
臺東縣,綠島鄉,南寮村,258,196,62,2,260,1538,0,16.91,12.74
臺東縣,綠島鄉,合計,626,480,146,8,634,3562,4083,17.8,13.48
臺東縣,海端鄉,廣原村,194,171,23,3,197,730,0,26.99,23.42
臺東縣,海端鄉,霧鹿村,103,85,18,2,105,251,0,41.83,33.86
臺東縣,海端鄉,利稻村,67,38,29,1,68,261,0,26.05,14.56
臺東縣,海端鄉,海端村,224,190,34,4,228,957,0,23.82,19.85
臺東縣,海端鄉,崁頂村,163,137,26,1,164,575,0,28.52,23.83
臺東縣,海端鄉,加拿村,142,121,21,3,145,501,0,28.94,24.15
臺東縣,海端鄉,合計,893,742,151,14,907,3275,4132,27.69,22.66
臺東縣,延平鄉,武陵村,181,158,23,7,188,593,0,31.7,26.64
臺東縣,延平鄉,永康村,112,104,8,1,113,318,0,35.53,32.7
臺東縣,延平鄉,紅葉村,134,118,16,4,138,421,0,32.78,28.03
臺東縣,延平鄉,鸞山村,143,129,14,5,148,577,0,25.65,22.36
臺東縣,延平鄉,桃源村,293,209,84,6,299,1003,0,29.81,20.84
臺東縣,延平鄉,合計,863,718,145,23,886,2912,3575,30.43,24.66
臺東縣,金峰鄉,新興村,244,215,29,5,249,512,0,48.63,41.99
臺東縣,金峰鄉,正興村,256,239,17,3,259,603,0,42.95,39.64
臺東縣,金峰鄉,嘉蘭村,377,333,44,10,387,1235,0,31.34,26.96
臺東縣,金峰鄉,賓茂村,121,116,5,3,124,325,0,38.15,35.69
臺東縣,金峰鄉,歷坵村,125,109,16,2,127,329,0,38.6,33.13
臺東縣,金峰鄉,合計,1123,1012,111,23,1146,3004,3673,38.15,33.69
臺東縣,達仁鄉,台坂村,231,200,31,4,235,589,0,39.9,33.96
臺東縣,達仁鄉,土坂村,276,241,35,2,278,851,0,32.67,28.32
臺東縣,達仁鄉,新化村,99,80,19,1,100,334,0,29.94,23.95
臺東縣,達仁鄉,安朔村,206,173,33,3,209,548,0,38.14,31.57
臺東縣,達仁鄉,森永村,143,118,25,0,143,359,0,39.83,32.87
臺東縣,達仁鄉,南田村,107,94,13,2,109,309,0,35.28,30.42
臺東縣,達仁鄉,合計,1062,906,156,12,1074,2990,3450,35.92,30.3
臺東縣,蘭嶼鄉,東清村,208,134,74,2,210,1293,0,16.24,10.36
臺東縣,蘭嶼鄉,朗島村,132,67,65,6,138,773,0,17.85,8.67
臺東縣,蘭嶼鄉,紅頭村,271,186,85,6,277,1256,0,22.05,14.81
臺東縣,蘭嶼鄉,椰油村,182,153,29,7,189,968,0,19.52,15.81
臺東縣,蘭嶼鄉,合計,793,540,253,21,814,4290,5199,18.97,12.59
臺東縣,合計,合計,58854,39175,19679,841,59695,182958,214132,32.63,21.41
澎湖縣,馬公市,復興里,137,84,53,0,137,496,0,27.62,16.94
澎湖縣,馬公市,長安里,219,124,95,1,220,534,0,41.2,23.22
澎湖縣,馬公市,中央里,199,99,100,2,201,520,0,38.65,19.04
澎湖縣,馬公市,啟明里,332,148,184,4,336,872,0,38.53,16.97
澎湖縣,馬公市,重慶里,378,170,208,3,381,932,0,40.88,18.24
澎湖縣,馬公市,中興里,270,163,107,1,271,785,0,34.52,20.76
澎湖縣,馬公市,光復里,645,342,303,5,650,1903,0,34.16,17.97
澎湖縣,馬公市,光榮里,1480,1006,474,17,1497,4135,0,36.2,24.33
澎湖縣,馬公市,光明里,410,258,152,5,415,1175,0,35.32,21.96
澎湖縣,馬公市,朝陽里,1661,948,713,9,1670,5179,0,32.25,18.3
澎湖縣,馬公市,陽明里,764,414,350,7,771,2417,0,31.9,17.13
澎湖縣,馬公市,重光里,511,283,228,5,516,1483,0,34.79,19.08
澎湖縣,馬公市,西衛里,1781,1060,721,13,1794,5825,0,30.8,18.2
澎湖縣,馬公市,西文里,995,566,429,7,1002,3202,0,31.29,17.68
澎湖縣,馬公市,東文里,988,563,425,8,996,3283,0,30.34,17.15
澎湖縣,馬公市,案山里,561,301,260,8,569,1855,0,30.67,16.23
澎湖縣,馬公市,光華里,222,134,88,2,224,979,0,22.88,13.69
澎湖縣,馬公市,前寮里,289,139,150,2,291,953,0,30.54,14.59
澎湖縣,馬公市,石泉里,879,545,334,4,883,2661,0,33.18,20.48
澎湖縣,馬公市,菜園里,145,76,69,0,145,439,0,33.03,17.31
澎湖縣,馬公市,東衛里,671,427,244,8,679,2134,0,31.82,20.01
澎湖縣,馬公市,安宅里,201,107,94,3,204,650,0,31.38,16.46
澎湖縣,馬公市,烏崁里,357,142,215,7,364,1060,0,34.34,13.4
澎湖縣,馬公市,興仁里,385,215,170,6,391,1240,0,31.53,17.34
澎湖縣,馬公市,鐵線里,228,82,146,2,230,677,0,33.97,12.11
澎湖縣,馬公市,山水里,516,196,320,5,521,1707,0,30.52,11.48
澎湖縣,馬公市,鎖港里,762,265,497,6,768,2539,0,30.25,10.44
澎湖縣,馬公市,五德里,96,53,43,1,97,470,0,20.64,11.28
澎湖縣,馬公市,井垵里,114,60,54,2,116,378,0,30.69,15.87
澎湖縣,馬公市,嵵裡里,302,190,112,7,309,1162,0,26.59,16.35
澎湖縣,馬公市,風櫃里,384,112,272,3,387,1368,0,28.29,8.19
澎湖縣,馬公市,虎井里,134,86,48,0,134,812,0,16.5,10.59
澎湖縣,馬公市,桶盤里,44,29,15,0,44,314,0,14.01,9.24
澎湖縣,馬公市,合計,17060,9387,7673,153,17213,54139,62912,31.79,17.34
澎湖縣,湖西鄉,湖西村,366,201,165,4,370,1199,0,30.86,16.76
澎湖縣,湖西鄉,湖東村,97,53,44,2,99,358,0,27.65,14.8
澎湖縣,湖西鄉,青螺村,66,40,26,2,68,243,0,27.98,16.46
澎湖縣,湖西鄉,白坑村,86,44,42,5,91,297,0,30.64,14.81
澎湖縣,湖西鄉,南寮村,181,53,128,3,184,683,0,26.94,7.76
澎湖縣,湖西鄉,北寮村,87,49,38,0,87,327,0,26.61,14.98
澎湖縣,湖西鄉,紅羅村,217,92,125,5,222,748,0,29.68,12.3
澎湖縣,湖西鄉,西溪村,167,92,75,4,171,839,0,20.38,10.97
澎湖縣,湖西鄉,成功村,291,136,155,3,294,860,0,34.19,15.81
澎湖縣,湖西鄉,東石村,49,23,26,1,50,123,0,40.65,18.7
澎湖縣,湖西鄉,中西村,73,37,36,2,75,221,0,33.94,16.74
澎湖縣,湖西鄉,潭邊村,108,58,50,2,110,300,0,36.67,19.33
澎湖縣,湖西鄉,鼎灣村,131,76,55,3,134,641,0,20.9,11.86
澎湖縣,湖西鄉,許家村,101,54,47,1,102,389,0,26.22,13.88
澎湖縣,湖西鄉,沙港村,260,67,193,4,264,807,0,32.71,8.3
澎湖縣,湖西鄉,城北村,122,84,38,1,123,334,0,36.83,25.15
澎湖縣,湖西鄉,太武村,30,17,13,2,32,94,0,34.04,18.09
澎湖縣,湖西鄉,隘門村,285,147,138,2,287,911,0,31.5,16.14
澎湖縣,湖西鄉,林投村,293,115,178,10,303,1004,0,30.18,11.45
澎湖縣,湖西鄉,尖山村,194,78,116,1,195,670,0,29.1,11.64
澎湖縣,湖西鄉,龍門村,540,268,272,4,544,1760,0,30.91,15.23
澎湖縣,湖西鄉,菓葉村,227,73,154,6,233,762,0,30.58,9.58
澎湖縣,湖西鄉,合計,3971,1857,2114,67,4038,13570,15248,29.76,13.68
澎湖縣,白沙鄉,中屯村,166,92,74,4,170,525,0,32.38,17.52
澎湖縣,白沙鄉,講美村,207,120,87,0,207,671,0,30.85,17.88
澎湖縣,白沙鄉,城前村,50,29,21,2,52,110,0,47.27,26.36
澎湖縣,白沙鄉,鎮海村,48,38,10,0,48,156,0,30.77,24.36
澎湖縣,白沙鄉,港子村,78,48,30,2,80,297,0,26.94,16.16
澎湖縣,白沙鄉,岐頭村,48,33,15,0,48,216,0,22.22,15.28
澎湖縣,白沙鄉,小赤村,62,34,28,1,63,168,0,37.5,20.24
澎湖縣,白沙鄉,赤崁村,464,250,214,6,470,1719,0,27.34,14.54
澎湖縣,白沙鄉,瓦硐村,90,50,40,0,90,307,0,29.32,16.29
澎湖縣,白沙鄉,後寮村,210,81,129,6,216,766,0,28.2,10.57
澎湖縣,白沙鄉,通梁村,203,87,116,3,206,798,0,25.81,10.9
澎湖縣,白沙鄉,吉貝村,258,57,201,7,265,1412,0,18.77,4.04
澎湖縣,白沙鄉,鳥嶼村,235,181,54,2,237,1110,0,21.35,16.31
澎湖縣,白沙鄉,員貝村,64,57,7,1,65,274,0,23.72,20.8
澎湖縣,白沙鄉,大倉村,50,17,33,1,51,269,0,18.96,6.32
澎湖縣,白沙鄉,合計,2233,1174,1059,35,2268,8798,9915,25.78,13.34
澎湖縣,西嶼鄉,橫礁村,55,21,34,2,57,301,0,18.94,6.98
澎湖縣,西嶼鄉,合界村,100,38,62,0,100,415,0,24.1,9.16
澎湖縣,西嶼鄉,小門村,96,67,29,1,97,285,0,34.04,23.51
澎湖縣,西嶼鄉,竹灣村,219,83,136,3,222,817,0,27.17,10.16
澎湖縣,西嶼鄉,大池村,188,72,116,2,190,665,0,28.57,10.83
澎湖縣,西嶼鄉,二崁村,56,16,40,1,57,145,0,39.31,11.03
澎湖縣,西嶼鄉,池東村,181,85,96,3,184,642,0,28.66,13.24
澎湖縣,西嶼鄉,池西村,63,19,44,1,64,225,0,28.44,8.44
澎湖縣,西嶼鄉,赤馬村,142,46,96,0,142,580,0,24.48,7.93
澎湖縣,西嶼鄉,內垵村,322,101,221,5,327,1265,0,25.85,7.98
澎湖縣,西嶼鄉,外垵村,477,339,138,4,481,2058,0,23.37,16.47
澎湖縣,西嶼鄉,合計,1899,887,1012,22,1921,7398,8309,25.97,11.99
澎湖縣,望安鄉,東安村,131,61,70,2,133,723,0,18.4,8.44
澎湖縣,望安鄉,西安村,92,56,36,0,92,436,0,21.1,12.84
澎湖縣,望安鄉,中社村,54,20,34,1,55,342,0,16.08,5.85
澎湖縣,望安鄉,水垵村,93,36,57,3,96,487,0,19.71,7.39
澎湖縣,望安鄉,將軍村,176,44,132,4,180,1425,0,12.63,3.09
澎湖縣,望安鄉,東坪村,18,10,8,0,18,527,0,3.42,1.9
澎湖縣,望安鄉,西坪村,8,4,4,0,8,220,0,3.64,1.82
澎湖縣,望安鄉,東吉村,37,16,21,1,38,296,0,12.84,5.41
澎湖縣,望安鄉,花嶼村,50,37,13,1,51,323,0,15.79,11.46
澎湖縣,望安鄉,合計,659,284,375,12,671,4779,5401,14.04,5.94
澎湖縣,七美鄉,東湖村,20,9,11,3,23,259,0,8.88,3.47
澎湖縣,七美鄉,西湖村,63,35,28,0,63,573,0,10.99,6.11
澎湖縣,七美鄉,中和村,70,41,29,2,72,643,0,11.2,6.38
澎湖縣,七美鄉,平和村,58,28,30,0,58,367,0,15.8,7.63
澎湖縣,七美鄉,海豐村,46,19,27,0,46,377,0,12.2,5.04
澎湖縣,七美鄉,南港村,140,96,44,6,146,1148,0,12.72,8.36
澎湖縣,七美鄉,合計,397,228,169,11,408,3367,3849,12.12,6.77
澎湖縣,合計,合計,26219,13817,12402,300,26519,92051,105634,28.81,15.01
基隆市,中正區,德義里,308,164,144,1,309,649,0,47.61,25.27
基隆市,中正區,正義里,542,314,228,6,548,1166,0,47.0,26.93
基隆市,中正區,信義里,373,189,184,1,374,874,0,42.79,21.62
基隆市,中正區,義重里,403,227,176,4,407,991,0,41.07,22.91
基隆市,中正區,港通里,583,290,293,4,587,1177,0,49.87,24.64
基隆市,中正區,中船里,463,228,235,4,467,1117,0,41.81,20.41
基隆市,中正區,正船里,536,329,207,4,540,1217,0,44.37,27.03
基隆市,中正區,入船里,321,184,137,7,328,752,0,43.62,24.47
基隆市,中正區,中砂里,549,323,226,4,553,1594,0,34.69,20.26
基隆市,中正區,正砂里,995,618,377,9,1004,2260,0,44.42,27.35
基隆市,中正區,真砂里,604,344,260,7,611,1294,0,47.22,26.58
基隆市,中正區,砂灣里,807,517,290,12,819,1981,0,41.34,26.1
基隆市,中正區,建國里,786,531,255,9,795,1945,0,40.87,27.3
基隆市,中正區,中濱里,510,297,213,4,514,1245,0,41.29,23.86
基隆市,中正區,海濱里,394,255,139,2,396,1125,0,35.2,22.67
基隆市,中正區,社寮里,675,312,363,9,684,1688,0,40.52,18.48
基隆市,中正區,和憲里,297,185,112,6,303,920,0,32.93,20.11
基隆市,中正區,平寮里,459,209,250,1,460,1211,0,37.99,17.26
基隆市,中正區,八斗里,602,177,425,3,605,1442,0,41.96,12.27
基隆市,中正區,碧砂里,402,174,228,3,405,1212,0,33.42,14.36
基隆市,中正區,長潭里,204,56,148,2,206,439,0,46.92,12.76
基隆市,中正區,砂子里,1829,996,833,17,1846,5622,0,32.84,17.72
基隆市,中正區,中正里,576,307,269,2,578,1615,0,35.79,19.01
基隆市,中正區,正濱里,356,215,141,5,361,907,0,39.8,23.7
基隆市,中正區,新豐里,2155,1317,838,9,2164,5731,0,37.76,22.98
基隆市,中正區,新富里,1613,945,668,18,1631,5124,0,31.83,18.44
基隆市,中正區,合計,17342,9703,7639,153,17495,45298,50967,38.62,21.42
基隆市,七堵區,長興里,1394,786,608,20,1414,3732,0,37.89,21.06
基隆市,七堵區,正光里,1022,527,495,6,1028,2522,0,40.76,20.9
基隆市,七堵區,富民里,1461,850,611,14,1475,3476,0,42.43,24.45
基隆市,七堵區,永平里,836,464,372,2,838,1877,0,44.65,24.72
基隆市,七堵區,永安里,936,564,372,11,947,2193,0,43.18,25.72
基隆市,七堵區,八德里,592,314,278,6,598,1482,0,40.35,21.19
基隆市,七堵區,自強里,470,254,216,9,479,1165,0,41.12,21.8
基隆市,七堵區,六堵里,836,428,408,4,840,2268,0,37.04,18.87
基隆市,七堵區,泰安里,1649,920,729,16,1665,4366,0,38.14,21.07
基隆市,七堵區,堵北里,1384,670,714,13,1397,3616,0,38.63,18.53
基隆市,七堵區,堵南里,733,359,374,7,740,2070,0,35.75,17.34
基隆市,七堵區,瑪南里,163,64,99,3,166,402,0,41.29,15.92
基隆市,七堵區,瑪東里,104,57,47,1,105,317,0,33.12,17.98
基隆市,七堵區,瑪西里,130,57,73,3,133,325,0,40.92,17.54
基隆市,七堵區,友一里,916,550,366,5,921,1965,0,46.87,27.99
基隆市,七堵區,友二里,229,89,140,5,234,448,0,52.23,19.87
基隆市,七堵區,正明里,800,443,357,21,821,1879,0,43.69,23.58
基隆市,七堵區,百福里,2129,1058,1071,20,2149,6051,0,35.51,17.48
基隆市,七堵區,實踐里,1394,700,694,7,1401,3772,0,37.14,18.56
基隆市,七堵區,長安里,842,455,387,5,847,2505,0,33.81,18.16
基隆市,七堵區,合計,18020,9609,8411,178,18198,46431,53534,39.19,20.7
基隆市,暖暖區,八西里,561,322,239,2,563,1390,0,40.5,23.17
基隆市,暖暖區,八堵里,275,143,132,5,280,641,0,43.68,22.31
基隆市,暖暖區,八南里,267,136,131,1,268,754,0,35.54,18.04
基隆市,暖暖區,過港里,1487,894,593,19,1506,3626,0,41.53,24.66
基隆市,暖暖區,碇內里,1051,630,421,5,1056,2636,0,40.06,23.9
基隆市,暖暖區,碇和里,1278,855,423,2,1280,2957,0,43.29,28.91
基隆市,暖暖區,暖同里,1003,590,413,9,1012,2529,0,40.02,23.33
基隆市,暖暖區,暖暖里,1092,615,477,8,1100,2563,0,42.92,24.0
基隆市,暖暖區,暖東里,141,70,71,4,145,405,0,35.8,17.28
基隆市,暖暖區,暖西里,1939,1073,866,19,1958,4724,0,41.45,22.71
基隆市,暖暖區,八中里,175,89,86,0,175,408,0,42.89,21.81
基隆市,暖暖區,碇安里,1982,1121,861,35,2017,4877,0,41.36,22.99
基隆市,暖暖區,碇祥里,2203,1326,877,22,2225,5937,0,37.48,22.33
基隆市,暖暖區,合計,13454,7864,5590,131,13585,33447,38494,40.62,23.51
基隆市,仁愛區,林泉里,644,351,293,5,649,1698,0,38.22,20.67
基隆市,仁愛區,花崗里,427,239,188,5,432,1015,0,42.56,23.55
基隆市,仁愛區,虹橋里,638,350,288,4,642,1481,0,43.35,23.63
基隆市,仁愛區,水錦里,698,410,288,3,701,1716,0,40.85,23.89
基隆市,仁愛區,智仁里,912,496,416,5,917,2263,0,40.52,21.92
基隆市,仁愛區,和明里,687,380,307,7,694,1653,0,41.98,22.99
基隆市,仁愛區,忠勇里,359,179,180,2,361,924,0,39.07,19.37
基隆市,仁愛區,玉田里,420,203,217,1,421,945,0,44.55,21.48
基隆市,仁愛區,仁德里,382,192,190,2,384,840,0,45.71,22.86
基隆市,仁愛區,博愛里,690,362,328,5,695,1413,0,49.19,25.62
基隆市,仁愛區,福仁里,330,138,192,6,336,730,0,46.03,18.9
基隆市,仁愛區,誠仁里,386,185,201,4,390,917,0,42.53,20.17
基隆市,仁愛區,吉仁里,987,504,483,8,995,2538,0,39.2,19.86
基隆市,仁愛區,育仁里,277,116,161,2,279,710,0,39.3,16.34
基隆市,仁愛區,英仁里,473,238,235,5,478,1247,0,38.33,19.09
基隆市,仁愛區,龍門里,312,136,176,5,317,770,0,41.17,17.66
基隆市,仁愛區,德厚里,715,397,318,6,721,1698,0,42.46,23.38
基隆市,仁愛區,曲水里,349,161,188,5,354,790,0,44.81,20.38
基隆市,仁愛區,崇文里,388,199,189,4,392,846,0,46.34,23.52
基隆市,仁愛區,文安里,281,122,159,4,285,820,0,34.76,14.88
基隆市,仁愛區,兆連里,298,180,118,5,303,670,0,45.22,26.87
基隆市,仁愛區,獅球里,341,188,153,4,345,957,0,36.05,19.64
基隆市,仁愛區,書院里,374,184,190,5,379,1056,0,35.89,17.42
基隆市,仁愛區,朝棟里,1147,738,409,14,1161,2712,0,42.81,27.21
基隆市,仁愛區,明德里,312,166,146,3,315,676,0,46.6,24.56
基隆市,仁愛區,同風里,247,123,124,1,248,548,0,45.26,22.45
基隆市,仁愛區,文昌里,367,152,215,2,369,692,0,53.32,21.97
基隆市,仁愛區,新店里,279,139,140,3,282,571,0,49.39,24.34
基隆市,仁愛區,光華里,1032,559,473,4,1036,2507,0,41.32,22.3
基隆市,仁愛區,合計,14752,7787,6965,129,14881,35403,42303,42.03,22.0
基隆市,中山區,新建里,353,201,152,4,357,769,0,46.42,26.14
基隆市,中山區,安民里,494,259,235,4,498,992,0,50.2,26.11
基隆市,中山區,安平里,313,160,153,5,318,750,0,42.4,21.33
基隆市,中山區,中山里,374,171,203,5,379,962,0,39.4,17.78
基隆市,中山區,民治里,345,203,142,5,350,749,0,46.73,27.1
基隆市,中山區,中興里,507,302,205,7,514,1221,0,42.1,24.73
基隆市,中山區,仁正里,309,202,107,1,310,742,0,41.78,27.22
基隆市,中山區,健民里,493,260,233,8,501,1138,0,44.02,22.85
基隆市,中山區,通化里,380,234,146,5,385,961,0,40.06,24.35
基隆市,中山區,居仁里,477,282,195,11,488,1266,0,38.55,22.27
基隆市,中山區,通明里,686,353,333,8,694,1710,0,40.58,20.64
基隆市,中山區,協和里,584,309,275,7,591,1512,0,39.09,20.44
基隆市,中山區,文化里,358,190,168,2,360,1271,0,28.32,14.95
基隆市,中山區,仙洞里,227,124,103,4,231,563,0,41.03,22.02
基隆市,中山區,太白里,317,154,163,3,320,864,0,37.04,17.82
基隆市,中山區,西榮里,274,134,140,6,280,654,0,42.81,20.49
基隆市,中山區,西華里,408,205,203,1,409,828,0,49.4,24.76
基隆市,中山區,西定里,343,175,168,4,347,904,0,38.38,19.36
基隆市,中山區,西康里,571,293,278,9,580,1556,0,37.28,18.83
基隆市,中山區,德和里,2470,1503,967,8,2478,5331,0,46.48,28.19
基隆市,中山區,中和里,2142,1289,853,17,2159,5461,0,39.53,23.6
基隆市,中山區,德安里,1557,817,740,15,1572,3826,0,41.09,21.35
基隆市,中山區,和平里,207,133,74,2,209,431,0,48.49,30.86
基隆市,中山區,和慶里,2196,1225,971,17,2213,6516,0,33.96,18.8
基隆市,中山區,合計,16385,9178,7207,158,16543,40977,46058,40.37,22.4
基隆市,安樂區,西川里,450,257,193,2,452,1179,0,38.34,21.8
基隆市,安樂區,定國里,403,204,199,4,407,1020,0,39.9,20.0
基隆市,安樂區,新西里,481,220,261,5,486,1326,0,36.65,16.59
基隆市,安樂區,定邦里,473,257,216,5,478,998,0,47.9,25.75
基隆市,安樂區,慈仁里,337,140,197,1,338,883,0,38.28,15.86
基隆市,安樂區,干城里,701,376,325,6,707,1988,0,35.56,18.91
基隆市,安樂區,永康里,698,356,342,2,700,1900,0,36.84,18.74
基隆市,安樂區,嘉仁里,1353,648,705,14,1367,3163,0,43.22,20.49
基隆市,安樂區,安和里,371,160,211,5,376,821,0,45.8,19.49
基隆市,安樂區,樂一里,220,103,117,2,222,556,0,39.93,18.53
基隆市,安樂區,外寮里,1435,818,617,13,1448,3892,0,37.2,21.02
基隆市,安樂區,中崙里,687,392,295,8,695,1657,0,41.94,23.66
基隆市,安樂區,內寮里,2053,1170,883,13,2066,5349,0,38.62,21.87
基隆市,安樂區,新崙里,1506,832,674,11,1517,4007,0,37.86,20.76
基隆市,安樂區,三民里,1055,543,512,10,1065,2451,0,43.45,22.15
基隆市,安樂區,四維里,2229,1303,926,10,2239,4656,0,48.09,27.99
基隆市,安樂區,五福里,1486,871,615,6,1492,3415,0,43.69,25.51
基隆市,安樂區,六合里,1817,1108,709,12,1829,3876,0,47.19,28.59
基隆市,安樂區,七賢里,1028,536,492,11,1039,2426,0,42.83,22.09
基隆市,安樂區,鶯歌里,1040,619,421,3,1043,2796,0,37.3,22.14
基隆市,安樂區,武崙里,2076,1246,830,14,2090,4808,0,43.47,25.92
基隆市,安樂區,長樂里,1638,1011,627,16,1654,3289,0,50.29,30.74
基隆市,安樂區,興寮里,1703,992,711,24,1727,4694,0,36.79,21.13
基隆市,安樂區,鶯安里,2256,1419,837,14,2270,4907,0,46.26,28.92
基隆市,安樂區,壯觀里,1779,1119,660,13,1792,4239,0,42.27,26.4
基隆市,安樂區,合計,29275,16700,12575,224,29499,70296,81453,41.96,23.76
基隆市,信義區,仁壽里,509,294,215,6,515,1024,0,50.29,28.71
基隆市,信義區,仁義里,597,387,210,5,602,1165,0,51.67,33.22
基隆市,信義區,義昭里,601,351,250,2,603,1243,0,48.51,28.24
基隆市,信義區,義幸里,1088,670,418,4,1092,2232,0,48.92,30.02
基隆市,信義區,義民里,295,161,134,5,300,723,0,41.49,22.27
基隆市,信義區,義和里,567,343,224,4,571,1508,0,37.86,22.75
基隆市,信義區,智慧里,350,215,135,7,357,712,0,50.14,30.2
基隆市,信義區,智誠里,546,275,271,5,551,1483,0,37.15,18.54
基隆市,信義區,禮儀里,713,438,275,7,720,1552,0,46.39,28.22
基隆市,信義區,禮東里,706,460,246,7,713,1439,0,49.55,31.97
基隆市,信義區,信綠里,904,545,359,6,910,1997,0,45.57,27.29
基隆市,信義區,東光里,784,457,327,7,791,1817,0,43.53,25.15
基隆市,信義區,東明里,1466,938,528,7,1473,3468,0,42.47,27.05
基隆市,信義區,東安里,1124,671,453,17,1141,2716,0,42.01,24.71
基隆市,信義區,孝岡里,482,267,215,3,485,1308,0,37.08,20.41
基隆市,信義區,東信里,1865,1181,684,10,1875,4064,0,46.14,29.06
基隆市,信義區,孝深里,1620,950,670,16,1636,4618,0,35.43,20.57
基隆市,信義區,孝賢里,1548,946,602,5,1553,3461,0,44.87,27.33
基隆市,信義區,孝德里,962,542,420,7,969,2604,0,37.21,20.81
基隆市,信義區,孝忠里,2989,1803,1186,15,3004,7553,0,39.77,23.87
基隆市,信義區,合計,19716,11894,7822,145,19861,46687,53082,42.54,25.48
基隆市,合計,合計,128944,72735,56209,1118,130062,318539,365891,40.83,22.83
新竹市,東區,南門里,336,148,188,5,341,689,0,49.49,21.48
新竹市,東區,福德里,652,356,296,5,657,1426,0,46.07,24.96
新竹市,東區,南市里,364,138,226,6,370,860,0,43.02,16.05
新竹市,東區,關帝里,210,91,119,7,217,472,0,45.97,19.28
新竹市,東區,東門里,277,112,165,0,277,527,0,52.56,21.25
新竹市,東區,成功里,279,122,157,5,284,591,0,48.05,20.64
新竹市,東區,寺前里,311,149,162,5,316,712,0,44.38,20.93
新竹市,東區,育賢里,455,256,199,5,460,1657,0,27.76,15.45
新竹市,東區,中正里,242,120,122,3,245,544,0,45.04,22.06
新竹市,東區,公園里,1428,827,601,17,1445,3181,0,45.43,26.0
新竹市,東區,頂竹里,1250,582,668,19,1269,2794,0,45.42,20.83
新竹市,東區,南大里,627,296,331,10,637,1360,0,46.84,21.76
新竹市,東區,振興里,2173,1187,986,26,2199,5451,0,40.34,21.78
新竹市,東區,親仁里,538,310,228,1,539,1058,0,50.95,29.3
新竹市,東區,文華里,2021,1141,880,27,2048,4446,0,46.06,25.66
新竹市,東區,復中里,1894,1079,815,21,1915,4120,0,46.48,26.19
新竹市,東區,三民里,2068,1073,995,15,2083,4584,0,45.44,23.41
新竹市,東區,東園里,2665,1450,1215,28,2693,5827,0,46.22,24.88
新竹市,東區,東勢里,1448,759,689,23,1471,3117,0,47.19,24.35
新竹市,東區,光復里,1311,683,628,19,1330,2796,0,47.57,24.43
新竹市,東區,豐功里,2290,1371,919,22,2312,4392,0,52.64,31.22
新竹市,東區,武功里,2040,1557,483,26,2066,3972,0,52.01,39.2
新竹市,東區,綠水里,2882,1688,1194,30,2912,6185,0,47.08,27.29
新竹市,東區,東山里,1546,936,610,18,1564,3075,0,50.86,30.44
新竹市,東區,光鎮里,1512,803,709,17,1529,3537,0,43.23,22.7
新竹市,東區,新興里,1336,674,662,19,1355,3009,0,45.03,22.4
新竹市,東區,柴橋里,2313,1280,1033,19,2332,5175,0,45.06,24.73
新竹市,東區,高峰里,2453,1314,1139,24,2477,5610,0,44.15,23.42
新竹市,東區,仙宮里,583,339,244,5,588,1240,0,47.42,27.34
新竹市,東區,光明里,1456,941,515,25,1481,2932,0,50.51,32.09
新竹市,東區,立功里,413,318,95,4,417,887,0,47.01,35.85
新竹市,東區,軍功里,1245,855,390,13,1258,2672,0,47.08,32.0
新竹市,東區,建功里,1960,1479,481,24,1984,3777,0,52.53,39.16
新竹市,東區,前溪里,1132,546,586,17,1149,2728,0,42.12,20.01
新竹市,東區,水源里,1436,679,757,31,1467,3260,0,45.0,20.83
新竹市,東區,千甲里,876,486,390,16,892,2117,0,42.14,22.96
新竹市,東區,埔頂里,2628,1360,1268,32,2660,6204,0,42.88,21.92
新竹市,東區,龍山里,4321,2379,1942,42,4363,9368,0,46.57,25.39
新竹市,東區,新莊里,2315,1342,973,26,2341,5305,0,44.13,25.3
新竹市,東區,仙水里,1989,1157,832,24,2013,4355,0,46.22,26.57
新竹市,東區,金山里,2145,1337,808,20,2165,5215,0,41.51,25.64
新竹市,東區,關東里,1955,1196,759,24,1979,4835,0,40.93,24.74
新竹市,東區,科園里,3215,1954,1261,35,3250,6299,0,51.6,31.02
新竹市,東區,建華里,1059,563,496,15,1074,2356,0,45.59,23.9
新竹市,東區,新光里,1439,738,701,23,1462,3398,0,43.03,21.72
新竹市,東區,復興里,2145,1186,959,29,2174,4960,0,43.83,23.91
新竹市,東區,錦華里,848,504,344,9,857,1881,0,45.56,26.79
新竹市,東區,湖濱里,1633,904,729,15,1648,3466,0,47.55,26.08
新竹市,東區,明湖里,1756,1036,720,18,1774,4931,0,35.98,21.01
新竹市,東區,關新里,1921,981,940,16,1937,3964,0,48.86,24.75
新竹市,東區,榮光里、親仁里,429,244,185,4,433,958,0,45.2,25.47
新竹市,東區,下竹里、竹蓮里,530,256,274,9,539,1175,0,45.87,21.79
新竹市,東區,合計,76350,43282,33068,898,77248,169450,221541,45.59,25.54
新竹市,北區,西門里,252,133,119,3,255,555,0,45.95,23.96
新竹市,北區,仁德里,318,136,182,3,321,728,0,44.09,18.68
新竹市,北區,潛園里,330,143,187,6,336,743,0,45.22,19.25
新竹市,北區,中央里,197,76,121,1,198,464,0,42.67,16.38
新竹市,北區,崇禮里,472,194,278,6,478,1063,0,44.97,18.25
新竹市,北區,興南里,524,248,276,12,536,1170,0,45.81,21.2
新竹市,北區,北門里,442,206,236,3,445,975,0,45.64,21.13
新竹市,北區,中興里,407,197,210,3,410,867,0,47.29,22.72
新竹市,北區,大同里,381,212,169,5,386,775,0,49.81,27.35
新竹市,北區,中山里,378,157,221,4,382,826,0,46.25,19.01
新竹市,北區,長和里,600,274,326,4,604,1365,0,44.25,20.07
新竹市,北區,新民里,678,319,359,8,686,1599,0,42.9,19.95
新竹市,北區,民富里,1898,903,995,21,1919,4837,0,39.67,18.67
新竹市,北區,水田里,1344,711,633,11,1355,3018,0,44.9,23.56
新竹市,北區,文雅里,1774,916,858,31,1805,4021,0,44.89,22.78
新竹市,北區,光田里,949,528,421,16,965,2080,0,46.39,25.38
新竹市,北區,士林里,791,351,440,11,802,1845,0,43.47,19.02
新竹市,北區,福林里,1719,1026,693,17,1736,3780,0,45.93,27.14
新竹市,北區,古賢里,351,143,208,10,361,837,0,43.13,17.08
新竹市,北區,湳雅里,1282,696,586,21,1303,2741,0,47.54,25.39
新竹市,北區,舊社里,2615,1421,1194,38,2653,5956,0,44.54,23.86
新竹市,北區,武陵里,2137,1719,418,22,2159,4508,0,47.89,38.13
新竹市,北區,南寮里,2006,1057,949,32,2038,5777,0,35.28,18.3
新竹市,北區,舊港里,224,119,105,3,227,574,0,39.55,20.73
新竹市,北區,康樂里,1198,594,604,18,1216,2946,0,41.28,20.16
新竹市,北區,港北里,747,329,418,12,759,1982,0,38.29,16.6
新竹市,北區,中寮里,1364,708,656,14,1378,3687,0,37.37,19.2
新竹市,北區,海濱里,1422,750,672,19,1441,4195,0,34.35,17.88
新竹市,北區,客雅里,704,356,348,2,706,1590,0,44.4,22.39
新竹市,北區,育英里,1498,731,767,14,1512,3409,0,44.35,21.44
新竹市,北區,曲溪里,1991,1067,924,20,2011,5102,0,39.42,20.91
新竹市,北區,西雅里,1201,540,661,17,1218,2825,0,43.12,19.12
新竹市,北區,南勢里,1500,618,882,20,1520,3409,0,44.59,18.13
新竹市,北區,境福里,2110,1121,989,28,2138,4668,0,45.8,24.01
新竹市,北區,磐石里,2314,1145,1169,30,2344,5381,0,43.56,21.28
新竹市,北區,新雅里,1654,795,859,30,1684,4426,0,38.05,17.96
新竹市,北區,光華里,1495,820,675,13,1508,4165,0,36.21,19.69
新竹市,北區,金華里,2186,1184,1002,22,2208,4801,0,45.99,24.66
新竹市,北區,金竹里,2416,1374,1042,19,2435,5732,0,42.48,23.97
新竹市,北區,湳中里,2962,1732,1230,40,3002,6577,0,45.64,26.33
新竹市,北區,金雅里,1312,677,635,24,1336,2938,0,45.47,23.04
新竹市,北區,台溪里,598,314,284,10,608,1564,0,38.87,20.08
新竹市,北區,中雅里,1552,1058,494,28,1580,3326,0,47.5,31.81
新竹市,北區,石坊里、興南里,338,153,185,4,342,684,0,50.0,22.37
新竹市,北區,南勢里、大鵬里,364,175,189,6,370,995,0,37.19,17.59
新竹市,北區,合計,52995,28126,24869,681,53676,125506,152490,42.77,22.41
新竹市,香山區,港南里,1045,409,636,13,1058,2715,0,38.97,15.06
新竹市,香山區,虎山里,2067,926,1141,38,2105,5496,0,38.3,16.85
新竹市,香山區,虎林里,903,449,454,11,914,2275,0,40.18,19.74
新竹市,香山區,浸水里,827,355,472,8,835,2355,0,35.46,15.07
新竹市,香山區,樹下里,906,335,571,15,921,2096,0,43.94,15.98
新竹市,香山區,埔前里,1305,596,709,19,1324,3186,0,41.56,18.71
新竹市,香山區,中埔里,1277,648,629,15,1292,2869,0,45.03,22.59
新竹市,香山區,牛埔里,1723,894,829,18,1741,4595,0,37.89,19.46
新竹市,香山區,頂埔里,1965,1037,928,16,1981,5017,0,39.49,20.67
新竹市,香山區,東香里,1812,1064,748,25,1837,4051,0,45.35,26.27
新竹市,香山區,香村里,1408,786,622,19,1427,3559,0,40.1,22.08
新竹市,香山區,香山里,1578,798,780,21,1599,4357,0,36.7,18.32
新竹市,香山區,大庄里,1059,470,589,23,1082,2843,0,38.06,16.53
新竹市,香山區,美山里,426,170,256,10,436,1121,0,38.89,15.17
新竹市,香山區,朝山里,773,375,398,10,783,2151,0,36.4,17.43
新竹市,香山區,海山里,875,466,409,15,890,2366,0,37.62,19.7
新竹市,香山區,茄苳里,273,146,127,4,277,924,0,29.98,15.8
新竹市,香山區,大湖里,327,163,164,6,333,862,0,38.63,18.91
新竹市,香山區,南隘里,296,173,123,7,303,770,0,39.35,22.47
新竹市,香山區,中隘里,624,362,262,12,636,1828,0,34.79,19.8
新竹市,香山區,內湖里,1480,741,739,24,1504,4280,0,35.14,17.31
新竹市,香山區,鹽水里,553,266,287,6,559,1479,0,37.8,17.99
新竹市,香山區,南港里,333,145,188,8,341,792,0,43.06,18.31
新竹市,香山區,頂福里,1760,958,802,26,1786,4410,0,40.5,21.72
新竹市,香山區,合計,25595,12732,12863,369,25964,66397,78776,39.1,19.18
新竹市,合計,合計,154940,84140,70800,1948,156888,361353,452807,43.42,23.28
嘉義市,東區,荖藤里,1754,741,1013,6,1760,4525,0,38.9,16.38
嘉義市,東區,後湖里,1365,596,769,9,1374,3379,0,40.66,17.64
嘉義市,東區,仁義里,1184,555,629,5,1189,2803,0,42.42,19.8
嘉義市,東區,中庄里,1317,627,690,11,1328,3208,0,41.4,19.54
嘉義市,東區,頂庄里,903,470,433,5,908,2125,0,42.73,22.12
嘉義市,東區,圳頭里,1768,987,781,14,1782,4239,0,42.04,23.28
嘉義市,東區,新店里,1847,936,911,18,1865,4140,0,45.05,22.61
嘉義市,東區,後庄里,1698,875,823,11,1709,3945,0,43.32,22.18
嘉義市,東區,王田里,1054,539,515,10,1064,2249,0,47.31,23.97
嘉義市,東區,東川里,805,434,371,4,809,1740,0,46.49,24.94
嘉義市,東區,太平里,1784,930,854,8,1792,4209,0,42.58,22.1
嘉義市,東區,盧厝里,803,383,420,5,808,1933,0,41.8,19.81
嘉義市,東區,鹿寮里,382,175,207,0,382,1058,0,36.11,16.54
嘉義市,東區,長竹里,1296,630,666,7,1303,2882,0,45.21,21.86
嘉義市,東區,短竹里,1080,556,524,9,1089,2346,0,46.42,23.7
嘉義市,東區,新開里,854,412,442,4,858,1953,0,43.93,21.1
嘉義市,東區,宣信里,491,204,287,6,497,1241,0,40.05,16.44
嘉義市,東區,興南里,637,229,408,5,642,1578,0,40.68,14.51
嘉義市,東區,豐年里,519,217,302,1,520,1231,0,42.24,17.63
嘉義市,東區,芳草里,1296,576,720,14,1310,3435,0,38.14,16.77
嘉義市,東區,芳安里,943,428,515,14,957,2160,0,44.31,19.81
嘉義市,東區,頂寮里,1064,452,612,12,1076,2474,0,43.49,18.27
嘉義市,東區,安寮里,1125,500,625,11,1136,2693,0,42.18,18.57
嘉義市,東區,興安里,1162,543,619,10,1172,2905,0,40.34,18.69
嘉義市,東區,興村里,1531,732,799,5,1536,3865,0,39.74,18.94
嘉義市,東區,興仁里,1517,785,732,12,1529,3606,0,42.4,21.77
嘉義市,東區,過溝里,905,383,522,5,910,1993,0,45.66,19.22
嘉義市,東區,民族里,664,283,381,5,669,1684,0,39.73,16.81
嘉義市,東區,朝陽里,845,341,504,7,852,1923,0,44.31,17.73
嘉義市,東區,華南里,799,337,462,11,810,1928,0,42.01,17.48
嘉義市,東區,東興里,852,360,492,4,856,1797,0,47.63,20.03
嘉義市,東區,中山里,898,454,444,9,907,1852,0,48.97,24.51
嘉義市,東區,中央里,994,376,618,7,1001,2130,0,47.0,17.65
嘉義市,東區,林森里,971,437,534,4,975,2284,0,42.69,19.13
嘉義市,東區,北門里,953,382,571,11,964,2085,0,46.24,18.32
嘉義市,東區,蘭潭里,909,446,463,4,913,2195,0,41.59,20.32
嘉義市,東區,文雅里,1619,844,775,14,1633,3695,0,44.19,22.84
嘉義市,東區,安業里,781,375,406,1,782,1950,0,40.1,19.23
嘉義市,東區,義教里,1042,475,567,4,1046,2719,0,38.47,17.47
嘉義市,東區,合計,42411,20005,22406,302,42713,100157,119170,42.65,19.97
嘉義市,西區,香湖里,303,124,179,2,305,819,0,37.24,15.14
嘉義市,西區,湖邊里,804,296,508,6,810,2045,0,39.61,14.47
嘉義市,西區,北榮里,1022,395,627,9,1031,2205,0,46.76,17.91
嘉義市,西區,重興里,765,306,459,10,775,1945,0,39.85,15.73
嘉義市,西區,竹圍里,1738,716,1022,16,1754,4451,0,39.41,16.09
嘉義市,西區,新厝里,1737,589,1148,21,1758,4153,0,42.33,14.18
嘉義市,西區,保安里,1303,548,755,8,1311,3225,0,40.65,16.99
嘉義市,西區,北湖里,1179,480,699,2,1181,2954,0,39.98,16.25
嘉義市,西區,下埤里,595,243,352,6,601,1556,0,38.62,15.62
嘉義市,西區,竹村里,429,187,242,4,433,1125,0,38.49,16.62
嘉義市,西區,大溪里,821,305,516,4,825,2143,0,38.5,14.23
嘉義市,西區,福全里,1619,713,906,14,1633,4114,0,39.69,17.33
嘉義市,西區,西平里,1347,557,790,5,1352,3239,0,41.74,17.2
嘉義市,西區,磚磘里,1393,566,827,12,1405,3497,0,40.18,16.19
嘉義市,西區,港坪里,1358,635,723,7,1365,3363,0,40.59,18.88
嘉義市,西區,頭港里,755,312,443,4,759,1847,0,41.09,16.89
嘉義市,西區,劉厝里,2648,1257,1391,25,2673,6843,0,39.06,18.37
嘉義市,西區,新西里,793,339,454,10,803,2010,0,39.95,16.87
嘉義市,西區,書院里,872,387,485,6,878,1889,0,46.48,20.49
嘉義市,西區,培元里,775,455,320,1,776,1615,0,48.05,28.17
嘉義市,西區,垂楊里,684,288,396,8,692,1915,0,36.14,15.04
嘉義市,西區,車店里,2342,1044,1298,15,2357,5748,0,41.01,18.16
嘉義市,西區,福民里,2117,953,1164,19,2136,5437,0,39.29,17.53
嘉義市,西區,湖內里,1760,672,1088,14,1774,4510,0,39.33,14.9
嘉義市,西區,美源里,1532,681,851,9,1541,3560,0,43.29,19.13
嘉義市,西區,育英里,776,320,456,4,780,1726,0,45.19,18.54
嘉義市,西區,致遠里,815,610,205,8,823,1739,0,47.33,35.08
嘉義市,西區,光路里,2151,984,1167,29,2180,5111,0,42.65,19.25
嘉義市,西區,翠岱里,653,495,158,4,657,1383,0,47.51,35.79
嘉義市,西區,自強里,698,320,378,5,703,1622,0,43.34,19.73
嘉義市,西區,永和里,775,336,439,5,780,1864,0,41.85,18.03
嘉義市,西區,新富里,734,237,497,5,739,1627,0,45.42,14.57
嘉義市,西區,文化里,1021,411,610,9,1030,2211,0,46.59,18.59
嘉義市,西區,西榮里,1004,382,622,7,1011,2209,0,45.77,17.29
嘉義市,西區,國華里,549,243,306,2,551,1253,0,43.97,19.39
嘉義市,西區,番社里,639,247,392,6,645,1355,0,47.6,18.23
嘉義市,西區,導明里,689,272,417,5,694,1512,0,45.9,17.99
嘉義市,西區,慶安里,633,250,383,8,641,1521,0,42.14,16.44
嘉義市,西區,後驛里,805,296,509,6,811,2042,0,39.72,14.5
嘉義市,西區,福安里,1701,721,980,16,1717,4195,0,40.93,17.19
嘉義市,西區,獅子里,1140,505,635,9,1149,2686,0,42.78,18.8
嘉義市,西區,紅瓦里,643,253,390,8,651,1570,0,41.46,16.11
嘉義市,西區,保福里,1364,590,774,7,1371,3637,0,37.7,16.22
嘉義市,西區,保生里,1837,772,1065,10,1847,4295,0,43.0,17.97
嘉義市,西區,北新里,507,191,316,4,511,1115,0,45.83,17.13
嘉義市,西區,合計,49825,21483,28342,394,50219,120881,145551,41.54,17.77
嘉義市,合計,合計,92236,41488,50748,696,92932,221038,264721,42.04,18.77
金門縣,金城鎮,東門里,956,861,95,10,966,4809,0,20.09,17.9
金門縣,金城鎮,西門里,2028,1840,188,12,2040,9671,0,21.09,19.03
金門縣,金城鎮,南門里,1066,946,120,14,1080,5344,0,20.21,17.7
金門縣,金城鎮,北門里,726,655,71,7,733,3979,0,18.42,16.46
金門縣,金城鎮,古城里,728,625,103,9,737,4023,0,18.32,15.54
金門縣,金城鎮,金水里,456,402,54,6,462,2226,0,20.75,18.06
金門縣,金城鎮,珠沙里,499,440,59,7,506,2885,0,17.54,15.25
金門縣,金城鎮,賢庵里,844,725,119,7,851,4730,0,17.99,15.33
金門縣,金城鎮,合計,7303,6494,809,72,7375,37667,42770,19.58,17.24
金門縣,金沙鎮,汶沙里,970,890,80,9,979,5076,0,19.29,17.53
金門縣,金沙鎮,三山里,336,308,28,7,343,1955,0,17.54,15.75
金門縣,金沙鎮,大洋里,214,196,18,6,220,1153,0,19.08,17.0
金門縣,金沙鎮,光前里,434,386,48,7,441,2348,0,18.78,16.44
金門縣,金沙鎮,何斗里,381,355,26,2,383,2045,0,18.73,17.36
金門縣,金沙鎮,西園里,262,249,13,3,265,1592,0,16.65,15.64
金門縣,金沙鎮,官嶼里,365,340,25,7,372,2210,0,16.83,15.38
金門縣,金沙鎮,浦山里,449,412,37,4,453,2345,0,19.32,17.57
金門縣,金沙鎮,合計,3411,3136,275,45,3456,18724,20622,18.46,16.75
金門縣,金湖鎮,新市里,845,766,79,9,854,3969,0,21.52,19.3
金門縣,金湖鎮,山外里,657,581,76,13,670,3328,0,20.13,17.46
金門縣,金湖鎮,正義里,514,455,59,12,526,2699,0,19.49,16.86
金門縣,金湖鎮,料羅里,422,363,59,7,429,2132,0,20.12,17.03
金門縣,金湖鎮,瓊林里,654,584,70,9,663,3259,0,20.34,17.92
金門縣,金湖鎮,新湖里,1533,1292,241,15,1548,8073,0,19.18,16.0
金門縣,金湖鎮,溪湖里,238,225,13,4,242,1560,0,15.51,14.42
金門縣,金湖鎮,蓮庵里,351,318,33,7,358,1704,0,21.01,18.66
金門縣,金湖鎮,合計,5214,4584,630,76,5290,26724,30316,19.79,17.15
金門縣,金寧鄉,古寧村,479,417,62,4,483,3363,0,14.36,12.4
金門縣,金寧鄉,安美村,821,701,120,16,837,5049,0,16.58,13.88
金門縣,金寧鄉,后盤村,304,269,35,1,305,1618,0,18.85,16.63
金門縣,金寧鄉,湖埔村,1517,1238,279,18,1535,7551,0,20.33,16.4
金門縣,金寧鄉,榜林村,928,811,117,11,939,5268,0,17.82,15.39
金門縣,金寧鄉,盤山村,1277,997,280,16,1293,6403,0,20.19,15.57
金門縣,金寧鄉,合計,5326,4433,893,66,5392,29252,32749,18.43,15.15
金門縣,烈嶼鄉,上岐村,456,423,33,9,465,2843,0,16.36,14.88
金門縣,烈嶼鄉,上林村,184,170,14,6,190,1428,0,13.31,11.9
金門縣,烈嶼鄉,西口村,343,303,40,8,351,2415,0,14.53,12.55
金門縣,烈嶼鄉,林湖村,611,561,50,5,616,3328,0,18.51,16.86
金門縣,烈嶼鄉,黃埔村,228,209,19,4,232,1642,0,14.13,12.73
金門縣,烈嶼鄉,合計,1822,1666,156,32,1854,11656,12646,15.91,14.29
金門縣,烏坵鄉,大坵村,19,16,3,0,19,270,0,7.04,5.93
金門縣,烏坵鄉,小坵村,18,14,4,0,18,299,0,6.02,4.68
金門縣,烏坵鄉,合計,37,30,7,0,37,569,661,6.5,5.27
金門縣,合計,合計,23113,20343,2770,291,23404,124592,139764,18.78,16.33
連江縣,南竿鄉,介壽村,641,568,73,11,652,1982,0,32.9,28.66
連江縣,南竿鄉,復興村、福沃村,467,407,60,6,473,1682,0,28.12,24.2
連江縣,南竿鄉,清水村、珠螺村,330,275,55,4,334,1223,0,27.31,22.49
連江縣,南竿鄉,仁愛村、津沙村、馬祖村、四維村,435,388,47,6,441,1618,0,27.26,23.98
連江縣,南竿鄉,合計,1873,1638,235,27,1900,6505,7644,29.21,25.18
連江縣,北竿鄉,塘岐村、后沃村,331,281,50,4,335,1310,0,25.57,21.45
連江縣,北竿鄉,橋仔村、芹壁村、坂里村、白沙村,284,245,39,5,289,1227,0,23.55,19.97
連江縣,北竿鄉,合計,615,526,89,9,624,2537,2846,24.6,20.73
連江縣,莒光鄉,青帆村、田沃村、西坵村,156,130,26,2,158,668,0,23.65,19.46
連江縣,莒光鄉,福正村、大坪村,140,122,18,1,141,695,0,20.29,17.55
連江縣,莒光鄉,合計,296,252,44,3,299,1363,1496,21.94,18.49
連江縣,東引鄉,中柳村、樂華村,294,260,34,1,295,1268,0,23.26,20.5
連江縣,東引鄉,合計,294,260,34,1,295,1268,1463,23.26,20.5
連江縣,合計,合計,3078,2676,402,40,3118,11673,13449,26.71,22.92
